square_index,rider_id,driver_idx,trip_start_timestamp,trip_duration,ride_miles,trip_end_timestamp,price_of_ride,rider_acceptance_prob,driver_acceptance_prob
13,827,73,0,8,4.22,8,18.93,0.89,0.91
13,808,73,104,15,7.71,119,30.74,0.87,0.9
7,794,13,160,9,4.29,169,19.83,0.89,0.91
7,885,13,182,6,2.86,188,14.88,0.9,0.91
12,809,54,187,19,9.67,206,37.43,0.85,0.89
8,995,37,241,2,0.9400000000000001,243,8.27,0.91,0.92
8,945,37,289,2,0.97,291,8.33,0.91,0.92
11,950,77,270,7,3.41,277,16.67,0.9,0.91
12,991,54,304,9,4.61,313,20.41,0.89,0.91
11,645,77,345,6,3.0,351,15.14,0.9,0.91
8,62,37,389,9,4.44,398,20.1,0.89,0.91
11,74,77,365,9,4.31,374,19.86,0.89,0.91
13,23,1,375,7,3.52,382,16.86,0.9,0.91
11,19,77,411,2,0.91,413,8.21,0.91,0.92
12,145,54,418,17,8.42,435,33.59,0.86,0.9
11,34,77,444,16,8.24,460,32.48,0.86,0.9
13,123,1,431,16,7.92,447,31.89,0.87,0.9
15,111,15,437,3,1.62,440,10.3,0.91,0.92
11,42,77,467,14,6.8,481,28.3,0.87,0.9
12,13,54,451,13,6.28,464,26.57,0.88,0.9
13,80,1,453,13,6.66,466,27.26,0.88,0.9
15,91,15,466,22,10.84,488,41.89,0.84,0.89
1,36,63,481,17,8.58,498,33.88,0.86,0.9
6,125,40,509,7,3.7,516,17.2,0.9,0.91
11,59,77,501,13,6.3,514,26.6,0.88,0.9
12,180,54,502,19,9.56,521,37.22,0.85,0.89
13,122,1,481,5,2.6,486,13.62,0.9,0.91
1,14,63,533,4,2.25,537,12.21,0.91,0.92
6,111,40,512,11,5.58,523,23.74,0.88,0.91
11,23,77,530,3,1.52,533,10.1,0.91,0.92
12,59,54,526,18,9.05,544,35.52,0.86,0.9
13,11,1,524,6,2.97,530,15.08,0.9,0.91
3,65,71,568,23,11.3,591,43.51,0.84,0.89
5,2,64,551,14,7.21,565,29.05,0.87,0.9
6,72,40,557,6,3.12,563,15.35,0.9,0.91
13,210,1,559,13,6.62,572,27.18,0.88,0.9
3,66,71,583,3,1.37,586,9.83,0.91,0.92
5,118,64,585,4,2.2,589,12.13,0.91,0.92
13,110,1,585,4,2.23,589,12.17,0.91,0.92
13,808,1,611,16,7.88,627,31.83,0.87,0.9
3,945,71,662,1,0.37,663,6.45,0.91,0.92
6,869,40,702,12,6.22,714,25.68,0.88,0.9
3,942,71,727,8,4.23,735,18.95,0.89,0.91
6,971,40,720,0,0.13,720,5.24,0.92,0.92
13,916,1,777,7,3.55,784,16.92,0.9,0.91
3,764,71,835,11,5.26,846,23.16,0.88,0.91
6,826,40,836,7,3.7,843,17.19,0.9,0.91
13,866,1,842,8,3.79,850,18.15,0.89,0.91
9,987,20,885,5,2.66,890,13.75,0.9,0.91
13,791,1,881,13,6.64,894,27.23,0.88,0.9
2,427,48,950,6,2.86,956,14.89,0.9,0.91
2,251,48,986,14,6.75,1000,28.21,0.87,0.9
6,272,40,984,6,3.21,990,15.53,0.9,0.91
13,328,1,984,17,8.67,1001,34.04,0.86,0.9
0,370,51,1018,19,9.49,1037,37.09,0.85,0.89
3,308,71,998,17,8.63,1015,33.96,0.86,0.9
6,835,40,994,9,4.7,1003,20.57,0.89,0.91
6,265,40,1038,11,5.6,1049,23.77,0.88,0.91
13,355,1,1024,17,8.53,1041,33.79,0.86,0.9
6,396,40,1053,13,6.39,1066,26.76,0.88,0.9
13,347,1,1064,12,6.05,1076,25.38,0.88,0.9
13,273,1,1084,13,6.58,1097,27.11,0.88,0.9
6,370,40,1128,10,4.76,1138,21.46,0.89,0.91
6,962,40,1197,5,2.73,1202,13.87,0.9,0.91
0,624,51,1204,3,1.5,1207,10.06,0.91,0.92
0,704,51,1245,14,6.79,1259,28.28,0.87,0.9
6,632,40,1255,4,1.95,1259,11.67,0.91,0.92
0,502,51,1271,14,7.06,1285,28.77,0.87,0.9
2,525,68,1268,5,2.63,1273,13.69,0.9,0.91
0,529,51,1305,11,5.47,1316,23.54,0.88,0.91
2,675,68,1319,11,5.67,1330,23.9,0.88,0.91
2,614,68,1331,6,2.94,1337,15.02,0.9,0.91
2,569,68,1352,7,3.59,1359,17.0,0.9,0.91
2,551,68,1383,16,7.98,1399,32.0,0.87,0.9
6,613,21,1426,10,5.15,1436,22.17,0.89,0.91
6,755,52,77,12,5.91,89,25.11,0.88,0.9
6,755,52,77,12,5.91,89,25.11,0.88,0.9
2,866,80,111,4,1.86,115,11.5,0.91,0.92
2,866,80,111,4,1.86,115,11.5,0.91,0.92
2,943,80,122,7,3.38,129,16.62,0.9,0.91
2,943,80,122,7,3.38,129,16.62,0.9,0.91
9,791,94,155,4,2.18,159,12.09,0.91,0.92
9,791,94,155,4,2.18,159,12.09,0.91,0.92
3,857,37,205,5,2.7,210,13.81,0.9,0.91
3,857,37,205,5,2.7,210,13.81,0.9,0.91
3,755,37,258,5,2.56,263,13.56,0.9,0.91
3,755,37,258,5,2.56,263,13.56,0.9,0.91
8,822,7,245,9,4.43,254,20.08,0.89,0.91
8,822,7,245,9,4.43,254,20.08,0.89,0.91
3,834,37,279,15,7.52,294,30.38,0.87,0.9
3,834,37,279,15,7.52,294,30.38,0.87,0.9
8,869,7,280,2,1.22,282,8.79,0.91,0.92
8,869,7,280,2,1.22,282,8.79,0.91,0.92
3,862,37,315,14,6.88,329,28.44,0.87,0.9
3,862,37,315,14,6.88,329,28.44,0.87,0.9
7,834,66,304,19,9.68,323,37.45,0.85,0.89
7,834,66,304,19,9.68,323,37.45,0.85,0.89
11,832,81,306,20,9.86,326,38.55,0.85,0.89
11,832,81,306,20,9.86,326,38.55,0.85,0.89
0,827,38,356,18,8.88,374,35.2,0.86,0.9
0,827,38,356,18,8.88,374,35.2,0.86,0.9
3,212,37,352,23,11.71,375,44.25,0.8300000000000001,0.89
3,212,37,352,23,11.71,375,44.25,0.8300000000000001,0.89
9,243,94,355,7,3.49,362,16.8,0.9,0.91
9,243,94,355,7,3.49,362,16.8,0.9,0.91
3,202,37,374,19,9.44,393,37.01,0.85,0.89
3,202,37,374,19,9.44,393,37.01,0.85,0.89
8,131,7,365,16,8.1,381,32.22,0.86,0.9
8,131,7,365,16,8.1,381,32.22,0.86,0.9
0,48,38,396,17,8.27,413,33.31,0.86,0.9
0,48,38,396,17,8.27,413,33.31,0.86,0.9
3,987,37,412,12,6.22,424,25.67,0.88,0.9
3,987,37,412,12,6.22,424,25.67,0.88,0.9
4,529,12,412,14,6.82,426,28.33,0.87,0.9
4,529,12,412,14,6.82,426,28.33,0.87,0.9
6,14,87,405,3,1.4,408,9.88,0.91,0.92
6,14,87,405,3,1.4,408,9.88,0.91,0.92
7,47,66,405,6,3.08,411,15.28,0.9,0.91
7,47,66,405,6,3.08,411,15.28,0.9,0.91
11,70,81,392,17,8.6,409,33.92,0.86,0.9
11,70,81,392,17,8.6,409,33.92,0.86,0.9
13,791,97,408,16,8.23,424,32.45,0.86,0.9
13,791,97,408,16,8.23,424,32.45,0.86,0.9
2,125,22,426,11,5.27,437,23.16,0.88,0.91
2,125,22,426,11,5.27,437,23.16,0.88,0.91
6,72,87,437,6,2.9,443,14.97,0.9,0.91
6,72,87,437,6,2.9,443,14.97,0.9,0.91
8,99,7,444,14,6.8,458,28.29,0.87,0.9
8,99,7,444,14,6.8,458,28.29,0.87,0.9
9,210,94,427,11,5.54,438,23.66,0.88,0.91
9,210,94,427,11,5.54,438,23.66,0.88,0.91
11,47,81,425,19,9.46,444,37.03,0.85,0.89
11,47,81,425,19,9.46,444,37.03,0.85,0.89
14,144,53,426,15,7.3,441,29.98,0.87,0.9
14,144,53,426,15,7.3,441,29.98,0.87,0.9
0,67,38,478,6,3.24,484,15.57,0.9,0.91
0,67,38,478,6,3.24,484,15.57,0.9,0.91
2,111,22,450,14,6.97,464,28.6,0.87,0.9
2,111,22,450,14,6.97,464,28.6,0.87,0.9
6,59,87,462,7,3.65,469,17.11,0.9,0.91
6,59,87,462,7,3.65,469,17.11,0.9,0.91
8,137,7,458,1,0.55,459,6.79,0.91,0.92
8,137,7,458,1,0.55,459,6.79,0.91,0.92
9,47,94,473,15,7.71,488,30.74,0.87,0.9
9,47,94,473,15,7.71,488,30.74,0.87,0.9
11,15,81,460,12,6.23,472,25.7,0.88,0.9
11,15,81,460,12,6.23,472,25.7,0.88,0.9
14,24,53,473,3,1.67,476,10.38,0.91,0.92
14,24,53,473,3,1.67,476,10.38,0.91,0.92
2,110,22,487,5,2.5,492,13.44,0.9,0.91
2,110,22,487,5,2.5,492,13.44,0.9,0.91
6,25,87,503,6,2.81,509,14.79,0.9,0.91
6,25,87,503,6,2.81,509,14.79,0.9,0.91
8,14,7,480,12,5.87,492,25.04,0.88,0.9
8,14,7,480,12,5.87,492,25.04,0.88,0.9
11,55,81,482,7,3.26,489,16.38,0.9,0.91
11,55,81,482,7,3.26,489,16.38,0.9,0.91
2,97,22,516,14,7.04,530,28.73,0.87,0.9
2,97,22,516,14,7.04,530,28.73,0.87,0.9
6,16,87,516,8,4.16,524,18.81,0.89,0.91
6,16,87,516,8,4.16,524,18.81,0.89,0.91
8,6,7,517,7,3.37,524,16.59,0.9,0.91
8,6,7,517,7,3.37,524,16.59,0.9,0.91
11,127,81,532,5,2.34,537,13.16,0.9,0.91
11,127,81,532,5,2.34,537,13.16,0.9,0.91
8,108,7,545,8,4.24,553,18.96,0.89,0.91
8,108,7,545,8,4.24,553,18.96,0.89,0.91
2,214,22,574,13,6.65,587,27.24,0.88,0.9
2,214,22,574,13,6.65,587,27.24,0.88,0.9
6,210,87,604,11,5.49,615,23.57,0.88,0.91
6,210,87,604,11,5.49,615,23.57,0.88,0.91
6,764,87,663,10,4.76,673,21.45,0.89,0.91
6,764,87,663,10,4.76,673,21.45,0.89,0.91
6,844,87,746,9,4.56,755,20.31,0.89,0.91
6,844,87,746,9,4.56,755,20.31,0.89,0.91
6,933,87,869,10,5.01,879,21.93,0.89,0.91
6,933,87,869,10,5.01,879,21.93,0.89,0.91
10,793,4,987,3,1.7,990,10.44,0.91,0.92
10,793,4,987,3,1.7,990,10.44,0.91,0.92
15,292,76,980,19,9.62,999,37.32,0.85,0.89
15,292,76,980,19,9.62,999,37.32,0.85,0.89
15,251,76,1016,15,7.5,1031,30.35,0.87,0.9
15,251,76,1016,15,7.5,1031,30.35,0.87,0.9
9,315,77,1044,5,2.35,1049,13.18,0.9,0.91
9,315,77,1044,5,2.35,1049,13.18,0.9,0.91
15,364,76,1035,4,2.03,1039,11.82,0.91,0.92
15,364,76,1035,4,2.03,1039,11.82,0.91,0.92
9,395,77,1075,7,3.48,1082,16.8,0.9,0.91
9,395,77,1075,7,3.48,1082,16.8,0.9,0.91
15,458,76,1052,17,8.44,1069,33.61,0.86,0.9
15,458,76,1052,17,8.44,1069,33.61,0.86,0.9
10,288,4,1103,11,5.32,1114,23.26,0.88,0.91
10,288,4,1103,11,5.32,1114,23.26,0.88,0.91
11,252,81,1091,12,5.95,1103,25.18,0.88,0.9
11,252,81,1091,12,5.95,1103,25.18,0.88,0.9
15,275,76,1099,22,11.17,1121,42.49,0.84,0.89
15,275,76,1099,22,11.17,1121,42.49,0.84,0.89
11,346,81,1121,14,7.11,1135,28.86,0.87,0.9
11,346,81,1121,14,7.11,1135,28.86,0.87,0.9
15,308,76,1128,3,1.6,1131,10.25,0.91,0.92
15,308,76,1128,3,1.6,1131,10.25,0.91,0.92
10,704,4,1156,6,2.89,1162,14.95,0.9,0.91
10,704,4,1156,6,2.89,1162,14.95,0.9,0.91
11,335,81,1151,8,4.19,1159,18.86,0.89,0.91
11,335,81,1151,8,4.19,1159,18.86,0.89,0.91
15,340,76,1162,13,6.59,1175,27.13,0.88,0.9
15,340,76,1162,13,6.59,1175,27.13,0.88,0.9
10,857,4,1178,6,2.96,1184,15.06,0.9,0.91
10,857,4,1178,6,2.96,1184,15.06,0.9,0.91
11,416,81,1180,2,1.25,1182,8.83,0.91,0.92
11,416,81,1180,2,1.25,1182,8.83,0.91,0.92
15,368,76,1185,13,6.59,1198,27.13,0.88,0.9
15,368,76,1185,13,6.59,1198,27.13,0.88,0.9
10,765,4,1212,9,4.44,1221,20.09,0.89,0.91
10,765,4,1212,9,4.44,1221,20.09,0.89,0.91
11,680,81,1204,9,4.63,1213,20.44,0.89,0.91
11,680,81,1204,9,4.63,1213,20.44,0.89,0.91
15,641,76,1209,10,5.18,1219,22.22,0.89,0.91
15,641,76,1209,10,5.18,1219,22.22,0.89,0.91
10,258,4,1238,16,8.15,1254,32.31,0.86,0.9
10,258,4,1238,16,8.15,1254,32.31,0.86,0.9
15,504,76,1243,12,6.0,1255,25.27,0.88,0.9
15,504,76,1243,12,6.0,1255,25.27,0.88,0.9
10,580,4,1272,9,4.75,1281,20.66,0.89,0.91
10,580,4,1272,9,4.75,1281,20.66,0.89,0.91
11,638,81,1262,15,7.41,1277,30.18,0.87,0.9
11,638,81,1262,15,7.41,1277,30.18,0.87,0.9
10,711,4,1308,10,5.01,1318,21.92,0.89,0.91
10,711,4,1308,10,5.01,1318,21.92,0.89,0.91
11,545,81,1296,19,9.52,1315,37.15,0.85,0.89
11,545,81,1296,19,9.52,1315,37.15,0.85,0.89
11,556,81,1332,14,7.05,1346,28.75,0.87,0.9
11,556,81,1332,14,7.05,1346,28.75,0.87,0.9
4,807,12,1377,9,4.57,1386,20.33,0.89,0.91
4,807,12,1377,9,4.57,1386,20.33,0.89,0.91
10,618,4,1351,12,5.76,1363,24.84,0.88,0.9
10,618,4,1351,12,5.76,1363,24.84,0.88,0.9
4,834,12,1404,1,0.58,1405,6.83,0.91,0.92
4,834,12,1404,1,0.58,1405,6.83,0.91,0.92
10,572,4,1387,5,2.36,1392,13.19,0.9,0.91
10,572,4,1387,5,2.36,1392,13.19,0.9,0.91
11,560,81,1394,16,8.13,1410,32.27,0.86,0.9
11,560,81,1394,16,8.13,1410,32.27,0.86,0.9
4,645,12,1432,17,8.36,1449,33.48,0.86,0.9
4,645,12,1432,17,8.36,1449,33.48,0.86,0.9
6,823,68,1412,6,2.84,1418,14.85,0.9,0.91
6,823,68,1412,6,2.84,1418,14.85,0.9,0.91
5,882,6,141,7,3.63,148,17.06,0.9,0.91
5,882,6,141,7,3.63,148,17.06,0.9,0.91
5,882,6,141,7,3.63,148,17.06,0.9,0.91
14,884,39,144,12,5.84,156,24.99,0.88,0.9
14,884,39,144,12,5.84,156,24.99,0.88,0.9
14,884,39,144,12,5.84,156,24.99,0.88,0.9
1,901,54,192,10,5.18,202,22.23,0.89,0.91
1,901,54,192,10,5.18,202,22.23,0.89,0.91
1,901,54,192,10,5.18,202,22.23,0.89,0.91
7,999,7,209,4,2.01,213,11.78,0.91,0.92
7,999,7,209,4,2.01,213,11.78,0.91,0.92
7,999,7,209,4,2.01,213,11.78,0.91,0.92
1,979,54,243,14,7.22,257,29.05,0.87,0.9
1,979,54,243,14,7.22,257,29.05,0.87,0.9
1,979,54,243,14,7.22,257,29.05,0.87,0.9
5,757,6,241,12,6.22,253,25.68,0.88,0.9
5,757,6,241,12,6.22,253,25.68,0.88,0.9
5,757,6,241,12,6.22,253,25.68,0.88,0.9
1,977,54,277,8,3.92,285,18.37,0.89,0.91
1,977,54,277,8,3.92,285,18.37,0.89,0.91
1,977,54,277,8,3.92,285,18.37,0.89,0.91
5,809,6,311,6,2.89,317,14.94,0.9,0.91
5,809,6,311,6,2.89,317,14.94,0.9,0.91
5,809,6,311,6,2.89,317,14.94,0.9,0.91
9,122,33,324,12,5.88,336,25.06,0.88,0.9
9,122,33,324,12,5.88,336,25.06,0.88,0.9
9,122,33,324,12,5.88,336,25.06,0.88,0.9
13,905,29,308,6,2.84,314,14.86,0.9,0.91
13,905,29,308,6,2.84,314,14.86,0.9,0.91
13,905,29,308,6,2.84,314,14.86,0.9,0.91
14,950,39,301,12,6.02,313,25.31,0.88,0.9
14,950,39,301,12,6.02,313,25.31,0.88,0.9
14,950,39,301,12,6.02,313,25.31,0.88,0.9
7,987,7,353,11,5.51,364,23.61,0.88,0.91
7,987,7,353,11,5.51,364,23.61,0.88,0.91
7,987,7,353,11,5.51,364,23.61,0.88,0.91
8,858,14,345,4,2.02,349,11.8,0.91,0.92
8,858,14,345,4,2.02,349,11.8,0.91,0.92
8,858,14,345,4,2.02,349,11.8,0.91,0.92
5,65,6,371,9,4.63,380,20.45,0.89,0.91
5,65,6,371,9,4.63,380,20.45,0.89,0.91
5,65,6,371,9,4.63,380,20.45,0.89,0.91
5,89,6,393,13,6.26,406,26.53,0.88,0.9
5,89,6,393,13,6.26,406,26.53,0.88,0.9
5,89,6,393,13,6.26,406,26.53,0.88,0.9
7,101,7,413,5,2.52,418,13.48,0.9,0.91
7,101,7,413,5,2.52,418,13.48,0.9,0.91
7,101,7,413,5,2.52,418,13.48,0.9,0.91
8,49,14,398,12,5.89,410,25.08,0.88,0.9
8,49,14,398,12,5.89,410,25.08,0.88,0.9
8,49,14,398,12,5.89,410,25.08,0.88,0.9
8,206,14,432,10,4.91,442,21.74,0.89,0.91
8,206,14,432,10,4.91,442,21.74,0.89,0.91
8,206,14,432,10,4.91,442,21.74,0.89,0.91
9,42,33,423,7,3.42,430,16.68,0.9,0.91
9,42,33,423,7,3.42,430,16.68,0.9,0.91
9,42,33,423,7,3.42,430,16.68,0.9,0.91
5,122,6,461,8,4.1,469,18.7,0.89,0.91
5,122,6,461,8,4.1,469,18.7,0.89,0.91
5,122,6,461,8,4.1,469,18.7,0.89,0.91
8,221,14,464,15,7.54,479,30.43,0.87,0.9
8,221,14,464,15,7.54,479,30.43,0.87,0.9
8,221,14,464,15,7.54,479,30.43,0.87,0.9
9,166,33,477,8,4.05,485,18.62,0.89,0.91
9,166,33,477,8,4.05,485,18.62,0.89,0.91
9,166,33,477,8,4.05,485,18.62,0.89,0.91
1,10,54,504,11,5.46,515,23.52,0.88,0.91
1,10,54,504,11,5.46,515,23.52,0.88,0.91
1,10,54,504,11,5.46,515,23.52,0.88,0.91
2,6,30,502,15,7.64,517,30.61,0.87,0.9
2,6,30,502,15,7.64,517,30.61,0.87,0.9
2,6,30,502,15,7.64,517,30.61,0.87,0.9
8,242,14,498,2,1.21,500,8.76,0.91,0.92
8,242,14,498,2,1.21,500,8.76,0.91,0.92
8,242,14,498,2,1.21,500,8.76,0.91,0.92
9,59,33,506,10,5.09,516,22.07,0.89,0.91
9,59,33,506,10,5.09,516,22.07,0.89,0.91
9,59,33,506,10,5.09,516,22.07,0.89,0.91
10,32,4,494,8,3.91,502,18.35,0.89,0.91
10,32,4,494,8,3.91,502,18.35,0.89,0.91
10,32,4,494,8,3.91,502,18.35,0.89,0.91
1,47,54,532,12,6.19,544,25.62,0.88,0.9
1,47,54,532,12,6.19,544,25.62,0.88,0.9
1,47,54,532,12,6.19,544,25.62,0.88,0.9
8,1,14,519,7,3.49,526,16.8,0.9,0.91
8,1,14,519,7,3.49,526,16.8,0.9,0.91
8,1,14,519,7,3.49,526,16.8,0.9,0.91
10,13,4,535,6,3.05,541,15.23,0.9,0.91
10,13,4,535,6,3.05,541,15.23,0.9,0.91
10,13,4,535,6,3.05,541,15.23,0.9,0.91
10,74,4,556,8,4.22,564,18.92,0.89,0.91
10,74,4,556,8,4.22,564,18.92,0.89,0.91
10,74,4,556,8,4.22,564,18.92,0.89,0.91
15,70,50,568,11,5.5,579,23.59,0.88,0.91
15,70,50,568,11,5.5,579,23.59,0.88,0.91
15,70,50,568,11,5.5,579,23.59,0.88,0.91
11,769,5,629,12,6.09,641,25.45,0.88,0.9
11,769,5,629,12,6.09,641,25.45,0.88,0.9
11,769,5,629,12,6.09,641,25.45,0.88,0.9
10,951,4,658,1,0.33,659,6.37,0.91,0.92
10,951,4,658,1,0.33,659,6.37,0.91,0.92
10,951,4,658,1,0.33,659,6.37,0.91,0.92
15,785,50,655,11,5.29,666,23.21,0.88,0.91
15,785,50,655,11,5.29,666,23.21,0.88,0.91
15,785,50,655,11,5.29,666,23.21,0.88,0.91
11,908,5,667,6,3.06,673,15.25,0.9,0.91
11,908,5,667,6,3.06,673,15.25,0.9,0.91
11,908,5,667,6,3.06,673,15.25,0.9,0.91
15,977,50,709,16,8.18,725,32.37,0.86,0.9
15,977,50,709,16,8.18,725,32.37,0.86,0.9
15,977,50,709,16,8.18,725,32.37,0.86,0.9
0,791,49,741,11,5.62,752,23.8,0.88,0.91
0,791,49,741,11,5.62,752,23.8,0.88,0.91
0,791,49,741,11,5.62,752,23.8,0.88,0.91
11,899,5,746,13,6.72,759,27.36,0.88,0.9
11,899,5,746,13,6.72,759,27.36,0.88,0.9
11,899,5,746,13,6.72,759,27.36,0.88,0.9
4,901,62,799,9,4.31,808,19.87,0.89,0.91
4,901,62,799,9,4.31,808,19.87,0.89,0.91
4,901,62,799,9,4.31,808,19.87,0.89,0.91
11,947,5,831,11,5.55,842,23.69,0.88,0.91
11,947,5,831,11,5.55,842,23.69,0.88,0.91
11,947,5,831,11,5.55,842,23.69,0.88,0.91
10,999,51,900,14,6.85,914,28.38,0.87,0.9
10,999,51,900,14,6.85,914,28.38,0.87,0.9
10,999,51,900,14,6.85,914,28.38,0.87,0.9
11,918,5,903,8,4.11,911,18.73,0.89,0.91
11,918,5,903,8,4.11,911,18.73,0.89,0.91
11,918,5,903,8,4.11,911,18.73,0.89,0.91
4,918,62,941,12,5.82,953,24.94,0.88,0.9
4,918,62,941,12,5.82,953,24.94,0.88,0.9
4,918,62,941,12,5.82,953,24.94,0.88,0.9
10,802,51,954,9,4.28,963,19.8,0.89,0.91
10,802,51,954,9,4.28,963,19.8,0.89,0.91
10,802,51,954,9,4.28,963,19.8,0.89,0.91
4,309,62,976,14,6.9,990,28.49,0.87,0.9
4,309,62,976,14,6.9,990,28.49,0.87,0.9
4,309,62,976,14,6.9,990,28.49,0.87,0.9
10,445,51,977,5,2.25,982,13.0,0.9,0.91
10,445,51,977,5,2.25,982,13.0,0.9,0.91
10,445,51,977,5,2.25,982,13.0,0.9,0.91
4,288,62,996,5,2.38,1001,13.23,0.9,0.91
4,288,62,996,5,2.38,1001,13.23,0.9,0.91
4,288,62,996,5,2.38,1001,13.23,0.9,0.91
10,274,51,991,11,5.55,1002,23.68,0.88,0.91
10,274,51,991,11,5.55,1002,23.68,0.88,0.91
10,274,51,991,11,5.55,1002,23.68,0.88,0.91
11,986,5,1019,4,1.8800000000000001,1023,11.55,0.91,0.92
11,986,5,1019,4,1.8800000000000001,1023,11.55,0.91,0.92
11,986,5,1019,4,1.8800000000000001,1023,11.55,0.91,0.92
0,364,58,1040,16,8.06,1056,32.15,0.86,0.9
0,364,58,1040,16,8.06,1056,32.15,0.86,0.9
0,364,58,1040,16,8.06,1056,32.15,0.86,0.9
4,298,62,1047,10,5.21,1057,22.28,0.89,0.91
4,298,62,1047,10,5.21,1057,22.28,0.89,0.91
4,298,62,1047,10,5.21,1057,22.28,0.89,0.91
6,272,77,1033,6,2.85,1039,14.87,0.9,0.91
6,272,77,1033,6,2.85,1039,14.87,0.9,0.91
6,272,77,1033,6,2.85,1039,14.87,0.9,0.91
11,319,5,1047,14,6.99,1061,28.65,0.87,0.9
11,319,5,1047,14,6.99,1061,28.65,0.87,0.9
11,319,5,1047,14,6.99,1061,28.65,0.87,0.9
13,251,57,1033,7,3.68,1040,17.16,0.9,0.91
13,251,57,1033,7,3.68,1040,17.16,0.9,0.91
13,251,57,1033,7,3.68,1040,17.16,0.9,0.91
0,306,58,1057,19,9.42,1076,36.96,0.85,0.89
0,306,58,1057,19,9.42,1076,36.96,0.85,0.89
0,306,58,1057,19,9.42,1076,36.96,0.85,0.89
4,265,62,1059,6,2.83,1065,14.83,0.9,0.91
4,265,62,1059,6,2.83,1065,14.83,0.9,0.91
4,265,62,1059,6,2.83,1065,14.83,0.9,0.91
11,252,5,1076,8,4.09,1084,18.69,0.89,0.91
11,252,5,1076,8,4.09,1084,18.69,0.89,0.91
11,252,5,1076,8,4.09,1084,18.69,0.89,0.91
13,312,57,1053,2,1.22,1055,8.78,0.91,0.92
13,312,57,1053,2,1.22,1055,8.78,0.91,0.92
13,312,57,1053,2,1.22,1055,8.78,0.91,0.92
0,254,58,1105,10,5.24,1115,22.33,0.89,0.91
0,254,58,1105,10,5.24,1115,22.33,0.89,0.91
0,254,58,1105,10,5.24,1115,22.33,0.89,0.91
6,864,77,1095,4,2.16,1099,12.05,0.91,0.92
6,864,77,1095,4,2.16,1099,12.05,0.91,0.92
6,864,77,1095,4,2.16,1099,12.05,0.91,0.92
13,379,57,1093,7,3.72,1100,17.24,0.9,0.91
13,379,57,1093,7,3.72,1100,17.24,0.9,0.91
13,379,57,1093,7,3.72,1100,17.24,0.9,0.91
14,262,47,1086,4,2.09,1090,11.93,0.91,0.92
14,262,47,1086,4,2.09,1090,11.93,0.91,0.92
14,262,47,1086,4,2.09,1090,11.93,0.91,0.92
0,442,58,1117,20,9.86,1137,38.54,0.85,0.89
0,442,58,1117,20,9.86,1137,38.54,0.85,0.89
0,442,58,1117,20,9.86,1137,38.54,0.85,0.89
6,262,77,1135,6,3.0,1141,15.14,0.9,0.91
6,262,77,1135,6,3.0,1141,15.14,0.9,0.91
6,262,77,1135,6,3.0,1141,15.14,0.9,0.91
13,278,57,1116,8,4.14,1124,18.78,0.89,0.91
13,278,57,1116,8,4.14,1124,18.78,0.89,0.91
13,278,57,1116,8,4.14,1124,18.78,0.89,0.91
14,326,47,1111,12,5.81,1123,24.94,0.88,0.9
14,326,47,1111,12,5.81,1123,24.94,0.88,0.9
14,326,47,1111,12,5.81,1123,24.94,0.88,0.9
0,454,58,1167,16,7.85,1183,31.77,0.87,0.9
0,454,58,1167,16,7.85,1183,31.77,0.87,0.9
0,454,58,1167,16,7.85,1183,31.77,0.87,0.9
6,431,77,1150,11,5.51,1161,23.62,0.88,0.91
6,431,77,1150,11,5.51,1161,23.62,0.88,0.91
6,431,77,1150,11,5.51,1161,23.62,0.88,0.91
12,371,11,1143,8,3.96,1151,18.45,0.89,0.91
12,371,11,1143,8,3.96,1151,18.45,0.89,0.91
12,371,11,1143,8,3.96,1151,18.45,0.89,0.91
13,482,57,1153,5,2.52,1158,13.49,0.9,0.91
13,482,57,1153,5,2.52,1158,13.49,0.9,0.91
13,482,57,1153,5,2.52,1158,13.49,0.9,0.91
0,266,58,1198,19,9.51,1217,37.13,0.85,0.89
0,266,58,1198,19,9.51,1217,37.13,0.85,0.89
0,266,58,1198,19,9.51,1217,37.13,0.85,0.89
6,823,77,1197,8,4.01,1205,18.54,0.89,0.91
6,823,77,1197,8,4.01,1205,18.54,0.89,0.91
6,823,77,1197,8,4.01,1205,18.54,0.89,0.91
13,547,57,1226,9,4.4,1235,20.03,0.89,0.91
13,547,57,1226,9,4.4,1235,20.03,0.89,0.91
13,547,57,1226,9,4.4,1235,20.03,0.89,0.91
0,903,58,1253,20,9.92,1273,38.65,0.85,0.89
0,903,58,1253,20,9.92,1273,38.65,0.85,0.89
0,903,58,1253,20,9.92,1273,38.65,0.85,0.89
5,643,82,1256,16,7.97,1272,31.99,0.87,0.9
5,643,82,1256,16,7.97,1272,31.99,0.87,0.9
5,643,82,1256,16,7.97,1272,31.99,0.87,0.9
13,549,57,1245,13,6.51,1258,26.99,0.88,0.9
13,549,57,1245,13,6.51,1258,26.99,0.88,0.9
13,549,57,1245,13,6.51,1258,26.99,0.88,0.9
0,534,58,1266,7,3.4,1273,16.64,0.9,0.91
0,534,58,1266,7,3.4,1273,16.64,0.9,0.91
0,534,58,1266,7,3.4,1273,16.64,0.9,0.91
5,500,82,1273,4,2.07,1277,11.88,0.91,0.92
5,500,82,1273,4,2.07,1277,11.88,0.91,0.92
5,500,82,1273,4,2.07,1277,11.88,0.91,0.92
12,528,11,1265,13,6.26,1278,26.53,0.88,0.9
12,528,11,1265,13,6.26,1278,26.53,0.88,0.9
12,528,11,1265,13,6.26,1278,26.53,0.88,0.9
0,529,58,1294,15,7.61,1309,30.54,0.87,0.9
0,529,58,1294,15,7.61,1309,30.54,0.87,0.9
0,529,58,1294,15,7.61,1309,30.54,0.87,0.9
12,519,11,1307,15,7.62,1322,30.57,0.87,0.9
12,519,11,1307,15,7.62,1322,30.57,0.87,0.9
12,519,11,1307,15,7.62,1322,30.57,0.87,0.9
5,537,82,1322,8,3.81,1330,18.18,0.89,0.91
5,537,82,1322,8,3.81,1330,18.18,0.89,0.91
5,537,82,1322,8,3.81,1330,18.18,0.89,0.91
12,624,11,1333,17,8.41,1350,33.57,0.86,0.9
12,624,11,1333,17,8.41,1350,33.57,0.86,0.9
12,624,11,1333,17,8.41,1350,33.57,0.86,0.9
5,588,82,1364,3,1.74,1367,10.51,0.91,0.92
5,588,82,1364,3,1.74,1367,10.51,0.91,0.92
5,588,82,1364,3,1.74,1367,10.51,0.91,0.92
10,645,13,1352,6,3.12,1358,15.36,0.9,0.91
10,645,13,1352,6,3.12,1358,15.36,0.9,0.91
10,645,13,1352,6,3.12,1358,15.36,0.9,0.91
12,660,11,1373,3,1.51,1376,10.1,0.91,0.92
12,660,11,1373,3,1.51,1376,10.1,0.91,0.92
12,660,11,1373,3,1.51,1376,10.1,0.91,0.92
10,679,13,1408,15,7.46,1423,30.28,0.87,0.9
10,679,13,1408,15,7.46,1423,30.28,0.87,0.9
10,679,13,1408,15,7.46,1423,30.28,0.87,0.9
12,563,11,1387,23,11.52,1410,43.91,0.84,0.89
12,563,11,1387,23,11.52,1410,43.91,0.84,0.89
12,563,11,1387,23,11.52,1410,43.91,0.84,0.89
5,745,82,1433,17,8.28,1450,33.33,0.86,0.9
5,745,82,1433,17,8.28,1450,33.33,0.86,0.9
5,745,82,1433,17,8.28,1450,33.33,0.86,0.9
12,617,11,1430,12,6.06,1442,25.39,0.88,0.9
12,617,11,1430,12,6.06,1442,25.39,0.88,0.9
12,617,11,1430,12,6.06,1442,25.39,0.88,0.9
4,989,6,134,11,5.56,145,23.69,0.88,0.91
4,989,6,134,11,5.56,145,23.69,0.88,0.91
4,989,6,134,11,5.56,145,23.69,0.88,0.91
4,989,6,134,11,5.56,145,23.69,0.88,0.91
13,858,60,121,14,7.22,135,29.05,0.87,0.9
13,858,60,121,14,7.22,135,29.05,0.87,0.9
13,858,60,121,14,7.22,135,29.05,0.87,0.9
13,858,60,121,14,7.22,135,29.05,0.87,0.9
13,973,60,170,7,3.28,177,16.42,0.9,0.91
13,973,60,170,7,3.28,177,16.42,0.9,0.91
13,973,60,170,7,3.28,177,16.42,0.9,0.91
13,973,60,170,7,3.28,177,16.42,0.9,0.91
1,918,48,220,3,1.25,223,9.62,0.91,0.92
1,918,48,220,3,1.25,223,9.62,0.91,0.92
1,918,48,220,3,1.25,223,9.62,0.91,0.92
1,918,48,220,3,1.25,223,9.62,0.91,0.92
4,796,6,237,18,9.16,255,35.71,0.86,0.9
4,796,6,237,18,9.16,255,35.71,0.86,0.9
4,796,6,237,18,9.16,255,35.71,0.86,0.9
4,796,6,237,18,9.16,255,35.71,0.86,0.9
13,878,60,236,18,8.87,254,35.18,0.86,0.9
13,878,60,236,18,8.87,254,35.18,0.86,0.9
13,878,60,236,18,8.87,254,35.18,0.86,0.9
13,878,60,236,18,8.87,254,35.18,0.86,0.9
2,844,56,252,4,2.07,256,11.88,0.91,0.92
2,844,56,252,4,2.07,256,11.88,0.91,0.92
2,844,56,252,4,2.07,256,11.88,0.91,0.92
2,844,56,252,4,2.07,256,11.88,0.91,0.92
6,814,64,257,8,3.92,265,18.37,0.89,0.91
6,814,64,257,8,3.92,265,18.37,0.89,0.91
6,814,64,257,8,3.92,265,18.37,0.89,0.91
6,814,64,257,8,3.92,265,18.37,0.89,0.91
2,892,56,276,20,9.86,296,38.54,0.85,0.89
2,892,56,276,20,9.86,296,38.54,0.85,0.89
2,892,56,276,20,9.86,296,38.54,0.85,0.89
2,892,56,276,20,9.86,296,38.54,0.85,0.89
6,847,64,273,0,0.17,273,5.3,0.92,0.92
6,847,64,273,0,0.17,273,5.3,0.92,0.92
6,847,64,273,0,0.17,273,5.3,0.92,0.92
6,847,64,273,0,0.17,273,5.3,0.92,0.92
6,998,64,300,5,2.54,305,13.52,0.9,0.91
6,998,64,300,5,2.54,305,13.52,0.9,0.91
6,998,64,300,5,2.54,305,13.52,0.9,0.91
6,998,64,300,5,2.54,305,13.52,0.9,0.91
8,70,97,326,8,3.94,334,18.4,0.89,0.91
8,70,97,326,8,3.94,334,18.4,0.89,0.91
8,70,97,326,8,3.94,334,18.4,0.89,0.91
8,70,97,326,8,3.94,334,18.4,0.89,0.91
1,866,48,331,6,2.87,337,14.91,0.9,0.91
1,866,48,331,6,2.87,337,14.91,0.9,0.91
1,866,48,331,6,2.87,337,14.91,0.9,0.91
1,866,48,331,6,2.87,337,14.91,0.9,0.91
5,147,54,346,11,5.32,357,23.26,0.88,0.91
5,147,54,346,11,5.32,357,23.26,0.88,0.91
5,147,54,346,11,5.32,357,23.26,0.88,0.91
5,147,54,346,11,5.32,357,23.26,0.88,0.91
6,817,64,358,10,4.88,368,21.69,0.89,0.91
6,817,64,358,10,4.88,368,21.69,0.89,0.91
6,817,64,358,10,4.88,368,21.69,0.89,0.91
6,817,64,358,10,4.88,368,21.69,0.89,0.91
8,74,97,342,16,7.92,358,31.89,0.87,0.9
8,74,97,342,16,7.92,358,31.89,0.87,0.9
8,74,97,342,16,7.92,358,31.89,0.87,0.9
8,74,97,342,16,7.92,358,31.89,0.87,0.9
1,918,48,383,11,5.6,394,23.77,0.88,0.91
1,918,48,383,11,5.6,394,23.77,0.88,0.91
1,918,48,383,11,5.6,394,23.77,0.88,0.91
1,918,48,383,11,5.6,394,23.77,0.88,0.91
4,48,6,374,13,6.34,387,26.67,0.88,0.9
4,48,6,374,13,6.34,387,26.67,0.88,0.9
4,48,6,374,13,6.34,387,26.67,0.88,0.9
4,48,6,374,13,6.34,387,26.67,0.88,0.9
5,96,54,366,10,4.76,376,21.46,0.89,0.91
5,96,54,366,10,4.76,376,21.46,0.89,0.91
5,96,54,366,10,4.76,376,21.46,0.89,0.91
5,96,54,366,10,4.76,376,21.46,0.89,0.91
6,13,64,386,10,5.07,396,22.04,0.89,0.91
6,13,64,386,10,5.07,396,22.04,0.89,0.91
6,13,64,386,10,5.07,396,22.04,0.89,0.91
6,13,64,386,10,5.07,396,22.04,0.89,0.91
8,89,97,379,7,3.49,386,16.82,0.9,0.91
8,89,97,379,7,3.49,386,16.82,0.9,0.91
8,89,97,379,7,3.49,386,16.82,0.9,0.91
8,89,97,379,7,3.49,386,16.82,0.9,0.91
13,169,60,380,9,4.48,389,20.18,0.89,0.91
13,169,60,380,9,4.48,389,20.18,0.89,0.91
13,169,60,380,9,4.48,389,20.18,0.89,0.91
13,169,60,380,9,4.48,389,20.18,0.89,0.91
1,227,48,413,8,4.24,421,18.96,0.89,0.91
1,227,48,413,8,4.24,421,18.96,0.89,0.91
1,227,48,413,8,4.24,421,18.96,0.89,0.91
1,227,48,413,8,4.24,421,18.96,0.89,0.91
4,210,6,391,6,3.05,397,15.24,0.9,0.91
4,210,6,391,6,3.05,397,15.24,0.9,0.91
4,210,6,391,6,3.05,397,15.24,0.9,0.91
4,210,6,391,6,3.05,397,15.24,0.9,0.91
5,62,54,418,4,1.94,422,11.65,0.91,0.92
5,62,54,418,4,1.94,422,11.65,0.91,0.92
5,62,54,418,4,1.94,422,11.65,0.91,0.92
5,62,54,418,4,1.94,422,11.65,0.91,0.92
6,800,64,394,6,3.2,400,15.51,0.9,0.91
6,800,64,394,6,3.2,400,15.51,0.9,0.91
6,800,64,394,6,3.2,400,15.51,0.9,0.91
6,800,64,394,6,3.2,400,15.51,0.9,0.91
1,573,48,440,3,1.71,443,10.45,0.91,0.92
1,573,48,440,3,1.71,443,10.45,0.91,0.92
1,573,48,440,3,1.71,443,10.45,0.91,0.92
1,573,48,440,3,1.71,443,10.45,0.91,0.92
4,192,6,449,13,6.38,462,26.76,0.88,0.9
4,192,6,449,13,6.38,462,26.76,0.88,0.9
4,192,6,449,13,6.38,462,26.76,0.88,0.9
4,192,6,449,13,6.38,462,26.76,0.88,0.9
5,101,54,437,3,1.7,440,10.43,0.91,0.92
5,101,54,437,3,1.7,440,10.43,0.91,0.92
5,101,54,437,3,1.7,440,10.43,0.91,0.92
5,101,54,437,3,1.7,440,10.43,0.91,0.92
8,23,97,438,18,9.15,456,35.69,0.86,0.9
8,23,97,438,18,9.15,456,35.69,0.86,0.9
8,23,97,438,18,9.15,456,35.69,0.86,0.9
8,23,97,438,18,9.15,456,35.69,0.86,0.9
9,21,24,425,11,5.71,436,23.97,0.88,0.91
9,21,24,425,11,5.71,436,23.97,0.88,0.91
9,21,24,425,11,5.71,436,23.97,0.88,0.91
9,21,24,425,11,5.71,436,23.97,0.88,0.91
10,49,51,448,10,5.16,458,22.2,0.89,0.91
10,49,51,448,10,5.16,458,22.2,0.89,0.91
10,49,51,448,10,5.16,458,22.2,0.89,0.91
10,49,51,448,10,5.16,458,22.2,0.89,0.91
13,23,60,428,5,2.47,433,13.4,0.9,0.91
13,23,60,428,5,2.47,433,13.4,0.9,0.91
13,23,60,428,5,2.47,433,13.4,0.9,0.91
13,23,60,428,5,2.47,433,13.4,0.9,0.91
1,99,48,477,5,2.42,482,13.3,0.9,0.91
1,99,48,477,5,2.42,482,13.3,0.9,0.91
1,99,48,477,5,2.42,482,13.3,0.9,0.91
1,99,48,477,5,2.42,482,13.3,0.9,0.91
4,195,6,472,15,7.69,487,30.7,0.87,0.9
4,195,6,472,15,7.69,487,30.7,0.87,0.9
4,195,6,472,15,7.69,487,30.7,0.87,0.9
4,195,6,472,15,7.69,487,30.7,0.87,0.9
5,59,54,450,15,7.67,465,30.66,0.87,0.9
5,59,54,450,15,7.67,465,30.66,0.87,0.9
5,59,54,450,15,7.67,465,30.66,0.87,0.9
5,59,54,450,15,7.67,465,30.66,0.87,0.9
8,46,97,475,15,7.27,490,29.93,0.87,0.9
8,46,97,475,15,7.27,490,29.93,0.87,0.9
8,46,97,475,15,7.27,490,29.93,0.87,0.9
8,46,97,475,15,7.27,490,29.93,0.87,0.9
9,32,24,468,6,2.96,474,15.07,0.9,0.91
9,32,24,468,6,2.96,474,15.07,0.9,0.91
9,32,24,468,6,2.96,474,15.07,0.9,0.91
9,32,24,468,6,2.96,474,15.07,0.9,0.91
10,54,51,460,12,5.91,472,25.11,0.88,0.9
10,54,51,460,12,5.91,472,25.11,0.88,0.9
10,54,51,460,12,5.91,472,25.11,0.88,0.9
10,54,51,460,12,5.91,472,25.11,0.88,0.9
13,6,60,458,8,3.91,466,18.35,0.89,0.91
13,6,60,458,8,3.91,466,18.35,0.89,0.91
13,6,60,458,8,3.91,466,18.35,0.89,0.91
13,6,60,458,8,3.91,466,18.35,0.89,0.91
1,238,48,490,11,5.49,501,23.57,0.88,0.91
1,238,48,490,11,5.49,501,23.57,0.88,0.91
1,238,48,490,11,5.49,501,23.57,0.88,0.91
1,238,48,490,11,5.49,501,23.57,0.88,0.91
4,0,6,483,20,9.77,503,38.39,0.85,0.89
4,0,6,483,20,9.77,503,38.39,0.85,0.89
4,0,6,483,20,9.77,503,38.39,0.85,0.89
4,0,6,483,20,9.77,503,38.39,0.85,0.89
5,36,54,505,14,6.99,519,28.64,0.87,0.9
5,36,54,505,14,6.99,519,28.64,0.87,0.9
5,36,54,505,14,6.99,519,28.64,0.87,0.9
5,36,54,505,14,6.99,519,28.64,0.87,0.9
8,101,97,488,9,4.61,497,20.42,0.89,0.91
8,101,97,488,9,4.61,497,20.42,0.89,0.91
8,101,97,488,9,4.61,497,20.42,0.89,0.91
8,101,97,488,9,4.61,497,20.42,0.89,0.91
13,531,60,482,2,1.19,484,8.73,0.91,0.92
13,531,60,482,2,1.19,484,8.73,0.91,0.92
13,531,60,482,2,1.19,484,8.73,0.91,0.92
13,531,60,482,2,1.19,484,8.73,0.91,0.92
15,161,31,496,14,6.82,510,28.33,0.87,0.9
15,161,31,496,14,6.82,510,28.33,0.87,0.9
15,161,31,496,14,6.82,510,28.33,0.87,0.9
15,161,31,496,14,6.82,510,28.33,0.87,0.9
1,47,48,527,10,5.21,537,22.28,0.89,0.91
1,47,48,527,10,5.21,537,22.28,0.89,0.91
1,47,48,527,10,5.21,537,22.28,0.89,0.91
1,47,48,527,10,5.21,537,22.28,0.89,0.91
4,24,6,535,9,4.47,544,20.15,0.89,0.91
4,24,6,535,9,4.47,544,20.15,0.89,0.91
4,24,6,535,9,4.47,544,20.15,0.89,0.91
4,24,6,535,9,4.47,544,20.15,0.89,0.91
5,204,54,535,13,6.34,548,26.67,0.88,0.9
5,204,54,535,13,6.34,548,26.67,0.88,0.9
5,204,54,535,13,6.34,548,26.67,0.88,0.9
5,204,54,535,13,6.34,548,26.67,0.88,0.9
13,59,60,510,9,4.28,519,19.8,0.89,0.91
13,59,60,510,9,4.28,519,19.8,0.89,0.91
13,59,60,510,9,4.28,519,19.8,0.89,0.91
13,59,60,510,9,4.28,519,19.8,0.89,0.91
15,36,31,530,18,8.78,548,35.02,0.86,0.9
15,36,31,530,18,8.78,548,35.02,0.86,0.9
15,36,31,530,18,8.78,548,35.02,0.86,0.9
15,36,31,530,18,8.78,548,35.02,0.86,0.9
0,207,1,555,13,6.42,568,26.83,0.88,0.9
0,207,1,555,13,6.42,568,26.83,0.88,0.9
0,207,1,555,13,6.42,568,26.83,0.88,0.9
0,207,1,555,13,6.42,568,26.83,0.88,0.9
1,987,48,551,4,2.22,555,12.16,0.91,0.92
1,987,48,551,4,2.22,555,12.16,0.91,0.92
1,987,48,551,4,2.22,555,12.16,0.91,0.92
1,987,48,551,4,2.22,555,12.16,0.91,0.92
4,20,6,554,12,6.24,566,25.71,0.88,0.9
4,20,6,554,12,6.24,566,25.71,0.88,0.9
4,20,6,554,12,6.24,566,25.71,0.88,0.9
4,20,6,554,12,6.24,566,25.71,0.88,0.9
8,165,97,554,9,4.36,563,19.95,0.89,0.91
8,165,97,554,9,4.36,563,19.95,0.89,0.91
8,165,97,554,9,4.36,563,19.95,0.89,0.91
8,165,97,554,9,4.36,563,19.95,0.89,0.91
11,34,44,551,7,3.61,558,17.03,0.9,0.91
11,34,44,551,7,3.61,558,17.03,0.9,0.91
11,34,44,551,7,3.61,558,17.03,0.9,0.91
11,34,44,551,7,3.61,558,17.03,0.9,0.91
0,911,1,594,2,1.08,596,8.53,0.91,0.92
0,911,1,594,2,1.08,596,8.53,0.91,0.92
0,911,1,594,2,1.08,596,8.53,0.91,0.92
0,911,1,594,2,1.08,596,8.53,0.91,0.92
8,66,97,576,7,3.26,583,16.39,0.9,0.91
8,66,97,576,7,3.26,583,16.39,0.9,0.91
8,66,97,576,7,3.26,583,16.39,0.9,0.91
8,66,97,576,7,3.26,583,16.39,0.9,0.91
1,50,48,625,11,5.63,636,23.82,0.88,0.91
1,50,48,625,11,5.63,636,23.82,0.88,0.91
1,50,48,625,11,5.63,636,23.82,0.88,0.91
1,50,48,625,11,5.63,636,23.82,0.88,0.91
4,181,6,606,18,8.85,624,35.16,0.86,0.9
4,181,6,606,18,8.85,624,35.16,0.86,0.9
4,181,6,606,18,8.85,624,35.16,0.86,0.9
4,181,6,606,18,8.85,624,35.16,0.86,0.9
11,791,44,612,11,5.69,623,23.94,0.88,0.91
11,791,44,612,11,5.69,623,23.94,0.88,0.91
11,791,44,612,11,5.69,623,23.94,0.88,0.91
11,791,44,612,11,5.69,623,23.94,0.88,0.91
13,822,60,613,14,7.19,627,29.0,0.87,0.9
13,822,60,613,14,7.19,627,29.0,0.87,0.9
13,822,60,613,14,7.19,627,29.0,0.87,0.9
13,822,60,613,14,7.19,627,29.0,0.87,0.9
4,857,6,689,9,4.6,698,20.39,0.89,0.91
4,857,6,689,9,4.6,698,20.39,0.89,0.91
4,857,6,689,9,4.6,698,20.39,0.89,0.91
4,857,6,689,9,4.6,698,20.39,0.89,0.91
11,964,44,662,18,8.77,680,35.01,0.86,0.9
11,964,44,662,18,8.77,680,35.01,0.86,0.9
11,964,44,662,18,8.77,680,35.01,0.86,0.9
11,964,44,662,18,8.77,680,35.01,0.86,0.9
0,977,1,713,4,2.2,717,12.13,0.91,0.92
0,977,1,713,4,2.2,717,12.13,0.91,0.92
0,977,1,713,4,2.2,717,12.13,0.91,0.92
0,977,1,713,4,2.2,717,12.13,0.91,0.92
14,911,15,824,4,2.18,828,12.08,0.91,0.92
14,911,15,824,4,2.18,828,12.08,0.91,0.92
14,911,15,824,4,2.18,828,12.08,0.91,0.92
14,911,15,824,4,2.18,828,12.08,0.91,0.92
1,947,48,873,6,3.2,879,15.51,0.9,0.91
1,947,48,873,6,3.2,879,15.51,0.9,0.91
1,947,48,873,6,3.2,879,15.51,0.9,0.91
1,947,48,873,6,3.2,879,15.51,0.9,0.91
1,466,48,928,9,4.69,937,20.56,0.89,0.91
1,466,48,928,9,4.69,937,20.56,0.89,0.91
1,466,48,928,9,4.69,937,20.56,0.89,0.91
1,466,48,928,9,4.69,937,20.56,0.89,0.91
1,753,48,955,13,6.45,968,26.87,0.88,0.9
1,753,48,955,13,6.45,968,26.87,0.88,0.9
1,753,48,955,13,6.45,968,26.87,0.88,0.9
1,753,48,955,13,6.45,968,26.87,0.88,0.9
14,308,25,997,16,8.09,1013,32.2,0.86,0.9
14,308,25,997,16,8.09,1013,32.2,0.86,0.9
14,308,25,997,16,8.09,1013,32.2,0.86,0.9
14,308,25,997,16,8.09,1013,32.2,0.86,0.9
14,275,25,1023,2,0.78,1025,7.98,0.91,0.92
14,275,25,1023,2,0.78,1025,7.98,0.91,0.92
14,275,25,1023,2,0.78,1025,7.98,0.91,0.92
14,275,25,1023,2,0.78,1025,7.98,0.91,0.92
1,370,48,1074,20,9.79,1094,38.42,0.85,0.89
1,370,48,1074,20,9.79,1094,38.42,0.85,0.89
1,370,48,1074,20,9.79,1094,38.42,0.85,0.89
1,370,48,1074,20,9.79,1094,38.42,0.85,0.89
14,318,25,1055,6,3.24,1061,15.58,0.9,0.91
14,318,25,1055,6,3.24,1061,15.58,0.9,0.91
14,318,25,1055,6,3.24,1061,15.58,0.9,0.91
14,318,25,1055,6,3.24,1061,15.58,0.9,0.91
3,364,28,1107,8,3.98,1115,18.48,0.89,0.91
3,364,28,1107,8,3.98,1115,18.48,0.89,0.91
3,364,28,1107,8,3.98,1115,18.48,0.89,0.91
3,364,28,1107,8,3.98,1115,18.48,0.89,0.91
3,308,28,1118,20,10.11,1138,39.0,0.85,0.89
3,308,28,1118,20,10.11,1138,39.0,0.85,0.89
3,308,28,1118,20,10.11,1138,39.0,0.85,0.89
3,308,28,1118,20,10.11,1138,39.0,0.85,0.89
3,341,28,1168,6,2.75,1174,14.69,0.9,0.91
3,341,28,1168,6,2.75,1174,14.69,0.9,0.91
3,341,28,1168,6,2.75,1174,14.69,0.9,0.91
3,341,28,1168,6,2.75,1174,14.69,0.9,0.91
3,356,28,1174,20,9.96,1194,38.74,0.85,0.89
3,356,28,1174,20,9.96,1194,38.74,0.85,0.89
3,356,28,1174,20,9.96,1194,38.74,0.85,0.89
3,356,28,1174,20,9.96,1194,38.74,0.85,0.89
3,646,28,1213,5,2.65,1218,13.73,0.9,0.91
3,646,28,1213,5,2.65,1218,13.73,0.9,0.91
3,646,28,1213,5,2.65,1218,13.73,0.9,0.91
3,646,28,1213,5,2.65,1218,13.73,0.9,0.91
7,314,47,1218,12,6.05,1230,25.37,0.88,0.9
7,314,47,1218,12,6.05,1230,25.37,0.88,0.9
7,314,47,1218,12,6.05,1230,25.37,0.88,0.9
7,314,47,1218,12,6.05,1230,25.37,0.88,0.9
3,618,28,1245,20,10.12,1265,39.02,0.85,0.89
3,618,28,1245,20,10.12,1265,39.02,0.85,0.89
3,618,28,1245,20,10.12,1265,39.02,0.85,0.89
3,618,28,1245,20,10.12,1265,39.02,0.85,0.89
7,667,47,1230,5,2.69,1235,13.8,0.9,0.91
7,667,47,1230,5,2.69,1235,13.8,0.9,0.91
7,667,47,1230,5,2.69,1235,13.8,0.9,0.91
7,667,47,1230,5,2.69,1235,13.8,0.9,0.91
11,610,4,1255,12,5.92,1267,25.13,0.88,0.9
11,610,4,1255,12,5.92,1267,25.13,0.88,0.9
11,610,4,1255,12,5.92,1267,25.13,0.88,0.9
11,610,4,1255,12,5.92,1267,25.13,0.88,0.9
7,629,47,1286,4,2.19,1290,12.11,0.91,0.92
7,629,47,1286,4,2.19,1290,12.11,0.91,0.92
7,629,47,1286,4,2.19,1290,12.11,0.91,0.92
7,629,47,1286,4,2.19,1290,12.11,0.91,0.92
7,502,47,1309,9,4.57,1318,20.35,0.89,0.91
7,502,47,1309,9,4.57,1318,20.35,0.89,0.91
7,502,47,1309,9,4.57,1318,20.35,0.89,0.91
7,502,47,1309,9,4.57,1318,20.35,0.89,0.91
13,531,35,1301,8,4.23,1309,18.94,0.89,0.91
13,531,35,1301,8,4.23,1309,18.94,0.89,0.91
13,531,35,1301,8,4.23,1309,18.94,0.89,0.91
13,531,35,1301,8,4.23,1309,18.94,0.89,0.91
13,638,35,1327,17,8.45,1344,33.63,0.86,0.9
13,638,35,1327,17,8.45,1344,33.63,0.86,0.9
13,638,35,1327,17,8.45,1344,33.63,0.86,0.9
13,638,35,1327,17,8.45,1344,33.63,0.86,0.9
13,536,35,1365,4,1.8900000000000001,1369,11.57,0.91,0.92
13,536,35,1365,4,1.8900000000000001,1369,11.57,0.91,0.92
13,536,35,1365,4,1.8900000000000001,1369,11.57,0.91,0.92
13,536,35,1365,4,1.8900000000000001,1369,11.57,0.91,0.92
13,626,35,1401,17,8.68,1418,34.06,0.86,0.9
13,626,35,1401,17,8.68,1418,34.06,0.86,0.9
13,626,35,1401,17,8.68,1418,34.06,0.86,0.9
13,626,35,1401,17,8.68,1418,34.06,0.86,0.9
15,153,32,339,10,4.92,349,21.76,0.89,0.91
15,153,32,339,10,4.92,349,21.76,0.89,0.91
15,153,32,339,10,4.92,349,21.76,0.89,0.91
15,153,32,339,10,4.92,349,21.76,0.89,0.91
15,153,32,339,10,4.92,349,21.76,0.89,0.91
13,844,85,363,6,3.14,369,15.39,0.9,0.91
13,844,85,363,6,3.14,369,15.39,0.9,0.91
13,844,85,363,6,3.14,369,15.39,0.9,0.91
13,844,85,363,6,3.14,369,15.39,0.9,0.91
13,844,85,363,6,3.14,369,15.39,0.9,0.91
13,181,85,406,9,4.28,415,19.8,0.89,0.91
13,181,85,406,9,4.28,415,19.8,0.89,0.91
13,181,85,406,9,4.28,415,19.8,0.89,0.91
13,181,85,406,9,4.28,415,19.8,0.89,0.91
13,181,85,406,9,4.28,415,19.8,0.89,0.91
15,48,32,392,15,7.26,407,29.91,0.87,0.9
15,48,32,392,15,7.26,407,29.91,0.87,0.9
15,48,32,392,15,7.26,407,29.91,0.87,0.9
15,48,32,392,15,7.26,407,29.91,0.87,0.9
15,48,32,392,15,7.26,407,29.91,0.87,0.9
1,1,25,421,14,6.76,435,28.22,0.87,0.9
1,1,25,421,14,6.76,435,28.22,0.87,0.9
1,1,25,421,14,6.76,435,28.22,0.87,0.9
1,1,25,421,14,6.76,435,28.22,0.87,0.9
1,1,25,421,14,6.76,435,28.22,0.87,0.9
3,64,33,433,4,2.24,437,12.2,0.91,0.92
3,64,33,433,4,2.24,437,12.2,0.91,0.92
3,64,33,433,4,2.24,437,12.2,0.91,0.92
3,64,33,433,4,2.24,437,12.2,0.91,0.92
3,64,33,433,4,2.24,437,12.2,0.91,0.92
7,173,53,442,19,9.67,461,37.41,0.85,0.89
7,173,53,442,19,9.67,461,37.41,0.85,0.89
7,173,53,442,19,9.67,461,37.41,0.85,0.89
7,173,53,442,19,9.67,461,37.41,0.85,0.89
7,173,53,442,19,9.67,461,37.41,0.85,0.89
13,117,85,438,4,1.98,442,11.73,0.91,0.92
13,117,85,438,4,1.98,442,11.73,0.91,0.92
13,117,85,438,4,1.98,442,11.73,0.91,0.92
13,117,85,438,4,1.98,442,11.73,0.91,0.92
13,117,85,438,4,1.98,442,11.73,0.91,0.92
14,171,68,443,3,1.62,446,10.29,0.91,0.92
14,171,68,443,3,1.62,446,10.29,0.91,0.92
14,171,68,443,3,1.62,446,10.29,0.91,0.92
14,171,68,443,3,1.62,446,10.29,0.91,0.92
14,171,68,443,3,1.62,446,10.29,0.91,0.92
1,45,25,478,5,2.25,483,13.0,0.9,0.91
1,45,25,478,5,2.25,483,13.0,0.9,0.91
1,45,25,478,5,2.25,483,13.0,0.9,0.91
1,45,25,478,5,2.25,483,13.0,0.9,0.91
1,45,25,478,5,2.25,483,13.0,0.9,0.91
3,239,33,474,12,6.01,486,25.3,0.88,0.9
3,239,33,474,12,6.01,486,25.3,0.88,0.9
3,239,33,474,12,6.01,486,25.3,0.88,0.9
3,239,33,474,12,6.01,486,25.3,0.88,0.9
3,239,33,474,12,6.01,486,25.3,0.88,0.9
7,53,53,454,17,8.71,471,34.1,0.86,0.9
7,53,53,454,17,8.71,471,34.1,0.86,0.9
7,53,53,454,17,8.71,471,34.1,0.86,0.9
7,53,53,454,17,8.71,471,34.1,0.86,0.9
7,53,53,454,17,8.71,471,34.1,0.86,0.9
13,229,85,468,15,7.6,483,30.53,0.87,0.9
13,229,85,468,15,7.6,483,30.53,0.87,0.9
13,229,85,468,15,7.6,483,30.53,0.87,0.9
13,229,85,468,15,7.6,483,30.53,0.87,0.9
13,229,85,468,15,7.6,483,30.53,0.87,0.9
14,80,68,470,19,9.38,489,36.9,0.85,0.89
14,80,68,470,19,9.38,489,36.9,0.85,0.89
14,80,68,470,19,9.38,489,36.9,0.85,0.89
14,80,68,470,19,9.38,489,36.9,0.85,0.89
14,80,68,470,19,9.38,489,36.9,0.85,0.89
1,214,25,482,6,3.21,488,15.52,0.9,0.91
1,214,25,482,6,3.21,488,15.52,0.9,0.91
1,214,25,482,6,3.21,488,15.52,0.9,0.91
1,214,25,482,6,3.21,488,15.52,0.9,0.91
1,214,25,482,6,3.21,488,15.52,0.9,0.91
6,24,75,498,10,5.06,508,22.01,0.89,0.91
6,24,75,498,10,5.06,508,22.01,0.89,0.91
6,24,75,498,10,5.06,508,22.01,0.89,0.91
6,24,75,498,10,5.06,508,22.01,0.89,0.91
6,24,75,498,10,5.06,508,22.01,0.89,0.91
7,59,53,494,5,2.73,499,13.87,0.9,0.91
7,59,53,494,5,2.73,499,13.87,0.9,0.91
7,59,53,494,5,2.73,499,13.87,0.9,0.91
7,59,53,494,5,2.73,499,13.87,0.9,0.91
7,59,53,494,5,2.73,499,13.87,0.9,0.91
10,47,79,488,11,5.36,499,23.33,0.88,0.91
10,47,79,488,11,5.36,499,23.33,0.88,0.91
10,47,79,488,11,5.36,499,23.33,0.88,0.91
10,47,79,488,11,5.36,499,23.33,0.88,0.91
10,47,79,488,11,5.36,499,23.33,0.88,0.91
13,54,85,509,15,7.39,524,30.14,0.87,0.9
13,54,85,509,15,7.39,524,30.14,0.87,0.9
13,54,85,509,15,7.39,524,30.14,0.87,0.9
13,54,85,509,15,7.39,524,30.14,0.87,0.9
13,54,85,509,15,7.39,524,30.14,0.87,0.9
14,122,68,492,10,5.05,502,21.99,0.89,0.91
14,122,68,492,10,5.05,502,21.99,0.89,0.91
14,122,68,492,10,5.05,502,21.99,0.89,0.91
14,122,68,492,10,5.05,502,21.99,0.89,0.91
14,122,68,492,10,5.05,502,21.99,0.89,0.91
1,171,25,514,9,4.62,523,20.44,0.89,0.91
1,171,25,514,9,4.62,523,20.44,0.89,0.91
1,171,25,514,9,4.62,523,20.44,0.89,0.91
1,171,25,514,9,4.62,523,20.44,0.89,0.91
1,171,25,514,9,4.62,523,20.44,0.89,0.91
6,904,75,521,7,3.29,528,16.44,0.9,0.91
6,904,75,521,7,3.29,528,16.44,0.9,0.91
6,904,75,521,7,3.29,528,16.44,0.9,0.91
6,904,75,521,7,3.29,528,16.44,0.9,0.91
6,904,75,521,7,3.29,528,16.44,0.9,0.91
7,219,53,525,8,4.0,533,18.51,0.89,0.91
7,219,53,525,8,4.0,533,18.51,0.89,0.91
7,219,53,525,8,4.0,533,18.51,0.89,0.91
7,219,53,525,8,4.0,533,18.51,0.89,0.91
7,219,53,525,8,4.0,533,18.51,0.89,0.91
10,46,79,526,8,4.1,534,18.71,0.89,0.91
10,46,79,526,8,4.1,534,18.71,0.89,0.91
10,46,79,526,8,4.1,534,18.71,0.89,0.91
10,46,79,526,8,4.1,534,18.71,0.89,0.91
10,46,79,526,8,4.1,534,18.71,0.89,0.91
13,90,85,515,6,2.95,521,15.06,0.9,0.91
13,90,85,515,6,2.95,521,15.06,0.9,0.91
13,90,85,515,6,2.95,521,15.06,0.9,0.91
13,90,85,515,6,2.95,521,15.06,0.9,0.91
13,90,85,515,6,2.95,521,15.06,0.9,0.91
14,182,68,516,14,6.77,530,28.24,0.87,0.9
14,182,68,516,14,6.77,530,28.24,0.87,0.9
14,182,68,516,14,6.77,530,28.24,0.87,0.9
14,182,68,516,14,6.77,530,28.24,0.87,0.9
14,182,68,516,14,6.77,530,28.24,0.87,0.9
1,51,25,547,11,5.64,558,23.85,0.88,0.91
1,51,25,547,11,5.64,558,23.85,0.88,0.91
1,51,25,547,11,5.64,558,23.85,0.88,0.91
1,51,25,547,11,5.64,558,23.85,0.88,0.91
1,51,25,547,11,5.64,558,23.85,0.88,0.91
7,19,53,561,16,7.83,577,31.74,0.87,0.9
7,19,53,561,16,7.83,577,31.74,0.87,0.9
7,19,53,561,16,7.83,577,31.74,0.87,0.9
7,19,53,561,16,7.83,577,31.74,0.87,0.9
7,19,53,561,16,7.83,577,31.74,0.87,0.9
9,232,18,545,8,3.82,553,18.19,0.89,0.91
9,232,18,545,8,3.82,553,18.19,0.89,0.91
9,232,18,545,8,3.82,553,18.19,0.89,0.91
9,232,18,545,8,3.82,553,18.19,0.89,0.91
9,232,18,545,8,3.82,553,18.19,0.89,0.91
1,212,25,594,5,2.68,599,13.78,0.9,0.91
1,212,25,594,5,2.68,599,13.78,0.9,0.91
1,212,25,594,5,2.68,599,13.78,0.9,0.91
1,212,25,594,5,2.68,599,13.78,0.9,0.91
1,212,25,594,5,2.68,599,13.78,0.9,0.91
6,242,75,578,7,3.38,585,16.61,0.9,0.91
6,242,75,578,7,3.38,585,16.61,0.9,0.91
6,242,75,578,7,3.38,585,16.61,0.9,0.91
6,242,75,578,7,3.38,585,16.61,0.9,0.91
6,242,75,578,7,3.38,585,16.61,0.9,0.91
7,56,53,582,10,4.85,592,21.63,0.89,0.91
7,56,53,582,10,4.85,592,21.63,0.89,0.91
7,56,53,582,10,4.85,592,21.63,0.89,0.91
7,56,53,582,10,4.85,592,21.63,0.89,0.91
7,56,53,582,10,4.85,592,21.63,0.89,0.91
1,808,25,620,6,2.97,626,15.08,0.9,0.91
1,808,25,620,6,2.97,626,15.08,0.9,0.91
1,808,25,620,6,2.97,626,15.08,0.9,0.91
1,808,25,620,6,2.97,626,15.08,0.9,0.91
1,808,25,620,6,2.97,626,15.08,0.9,0.91
6,772,75,608,12,5.94,620,25.18,0.88,0.9
6,772,75,608,12,5.94,620,25.18,0.88,0.9
6,772,75,608,12,5.94,620,25.18,0.88,0.9
6,772,75,608,12,5.94,620,25.18,0.88,0.9
6,772,75,608,12,5.94,620,25.18,0.88,0.9
6,832,75,632,6,3.24,638,15.58,0.9,0.91
6,832,75,632,6,3.24,638,15.58,0.9,0.91
6,832,75,632,6,3.24,638,15.58,0.9,0.91
6,832,75,632,6,3.24,638,15.58,0.9,0.91
6,832,75,632,6,3.24,638,15.58,0.9,0.91
1,844,25,689,15,7.41,704,30.18,0.87,0.9
1,844,25,689,15,7.41,704,30.18,0.87,0.9
1,844,25,689,15,7.41,704,30.18,0.87,0.9
1,844,25,689,15,7.41,704,30.18,0.87,0.9
1,844,25,689,15,7.41,704,30.18,0.87,0.9
8,809,41,700,8,3.88,708,18.3,0.89,0.91
8,809,41,700,8,3.88,708,18.3,0.89,0.91
8,809,41,700,8,3.88,708,18.3,0.89,0.91
8,809,41,700,8,3.88,708,18.3,0.89,0.91
8,809,41,700,8,3.88,708,18.3,0.89,0.91
0,861,61,761,10,4.99,771,21.89,0.89,0.91
0,861,61,761,10,4.99,771,21.89,0.89,0.91
0,861,61,761,10,4.99,771,21.89,0.89,0.91
0,861,61,761,10,4.99,771,21.89,0.89,0.91
0,861,61,761,10,4.99,771,21.89,0.89,0.91
8,988,41,751,17,8.6,768,33.92,0.86,0.9
8,988,41,751,17,8.6,768,33.92,0.86,0.9
8,988,41,751,17,8.6,768,33.92,0.86,0.9
8,988,41,751,17,8.6,768,33.92,0.86,0.9
8,988,41,751,17,8.6,768,33.92,0.86,0.9
9,802,17,787,9,4.72,796,20.62,0.89,0.91
9,802,17,787,9,4.72,796,20.62,0.89,0.91
9,802,17,787,9,4.72,796,20.62,0.89,0.91
9,802,17,787,9,4.72,796,20.62,0.89,0.91
9,802,17,787,9,4.72,796,20.62,0.89,0.91
2,773,26,848,12,6.13,860,25.52,0.88,0.9
2,773,26,848,12,6.13,860,25.52,0.88,0.9
2,773,26,848,12,6.13,860,25.52,0.88,0.9
2,773,26,848,12,6.13,860,25.52,0.88,0.9
2,773,26,848,12,6.13,860,25.52,0.88,0.9
9,919,17,840,7,3.46,847,16.75,0.9,0.91
9,919,17,840,7,3.46,847,16.75,0.9,0.91
9,919,17,840,7,3.46,847,16.75,0.9,0.91
9,919,17,840,7,3.46,847,16.75,0.9,0.91
9,919,17,840,7,3.46,847,16.75,0.9,0.91
0,368,61,1010,12,6.0,1022,25.28,0.88,0.9
0,368,61,1010,12,6.0,1022,25.28,0.88,0.9
0,368,61,1010,12,6.0,1022,25.28,0.88,0.9
0,368,61,1010,12,6.0,1022,25.28,0.88,0.9
0,368,61,1010,12,6.0,1022,25.28,0.88,0.9
4,457,88,1014,6,2.94,1020,15.02,0.9,0.91
4,457,88,1014,6,2.94,1020,15.02,0.9,0.91
4,457,88,1014,6,2.94,1020,15.02,0.9,0.91
4,457,88,1014,6,2.94,1020,15.02,0.9,0.91
4,457,88,1014,6,2.94,1020,15.02,0.9,0.91
6,911,40,1003,7,3.65,1010,17.1,0.9,0.91
6,911,40,1003,7,3.65,1010,17.1,0.9,0.91
6,911,40,1003,7,3.65,1010,17.1,0.9,0.91
6,911,40,1003,7,3.65,1010,17.1,0.9,0.91
6,911,40,1003,7,3.65,1010,17.1,0.9,0.91
0,335,61,1037,15,7.26,1052,29.92,0.87,0.9
0,335,61,1037,15,7.26,1052,29.92,0.87,0.9
0,335,61,1037,15,7.26,1052,29.92,0.87,0.9
0,335,61,1037,15,7.26,1052,29.92,0.87,0.9
0,335,61,1037,15,7.26,1052,29.92,0.87,0.9
4,421,88,1040,6,2.82,1046,14.81,0.9,0.91
4,421,88,1040,6,2.82,1046,14.81,0.9,0.91
4,421,88,1040,6,2.82,1046,14.81,0.9,0.91
4,421,88,1040,6,2.82,1046,14.81,0.9,0.91
4,421,88,1040,6,2.82,1046,14.81,0.9,0.91
6,324,40,1028,3,1.4,1031,9.89,0.91,0.92
6,324,40,1028,3,1.4,1031,9.89,0.91,0.92
6,324,40,1028,3,1.4,1031,9.89,0.91,0.92
6,324,40,1028,3,1.4,1031,9.89,0.91,0.92
6,324,40,1028,3,1.4,1031,9.89,0.91,0.92
12,308,63,1039,3,1.29,1042,9.69,0.91,0.92
12,308,63,1039,3,1.29,1042,9.69,0.91,0.92
12,308,63,1039,3,1.29,1042,9.69,0.91,0.92
12,308,63,1039,3,1.29,1042,9.69,0.91,0.92
12,308,63,1039,3,1.29,1042,9.69,0.91,0.92
0,346,61,1077,9,4.6,1086,20.39,0.89,0.91
0,346,61,1077,9,4.6,1086,20.39,0.89,0.91
0,346,61,1077,9,4.6,1086,20.39,0.89,0.91
0,346,61,1077,9,4.6,1086,20.39,0.89,0.91
0,346,61,1077,9,4.6,1086,20.39,0.89,0.91
4,325,88,1065,2,0.8,1067,8.02,0.91,0.92
4,325,88,1065,2,0.8,1067,8.02,0.91,0.92
4,325,88,1065,2,0.8,1067,8.02,0.91,0.92
4,325,88,1065,2,0.8,1067,8.02,0.91,0.92
4,325,88,1065,2,0.8,1067,8.02,0.91,0.92
6,332,40,1054,11,5.29,1065,23.21,0.88,0.91
6,332,40,1054,11,5.29,1065,23.21,0.88,0.91
6,332,40,1054,11,5.29,1065,23.21,0.88,0.91
6,332,40,1054,11,5.29,1065,23.21,0.88,0.91
6,332,40,1054,11,5.29,1065,23.21,0.88,0.91
12,433,63,1075,13,6.63,1088,27.2,0.88,0.9
12,433,63,1075,13,6.63,1088,27.2,0.88,0.9
12,433,63,1075,13,6.63,1088,27.2,0.88,0.9
12,433,63,1075,13,6.63,1088,27.2,0.88,0.9
12,433,63,1075,13,6.63,1088,27.2,0.88,0.9
0,352,61,1108,9,4.3,1117,19.84,0.89,0.91
0,352,61,1108,9,4.3,1117,19.84,0.89,0.91
0,352,61,1108,9,4.3,1117,19.84,0.89,0.91
0,352,61,1108,9,4.3,1117,19.84,0.89,0.91
0,352,61,1108,9,4.3,1117,19.84,0.89,0.91
4,284,88,1093,17,8.74,1110,34.17,0.86,0.9
4,284,88,1093,17,8.74,1110,34.17,0.86,0.9
4,284,88,1093,17,8.74,1110,34.17,0.86,0.9
4,284,88,1093,17,8.74,1110,34.17,0.86,0.9
4,284,88,1093,17,8.74,1110,34.17,0.86,0.9
6,327,40,1108,6,2.93,1114,15.01,0.9,0.91
6,327,40,1108,6,2.93,1114,15.01,0.9,0.91
6,327,40,1108,6,2.93,1114,15.01,0.9,0.91
6,327,40,1108,6,2.93,1114,15.01,0.9,0.91
6,327,40,1108,6,2.93,1114,15.01,0.9,0.91
12,335,63,1088,19,9.32,1107,36.78,0.85,0.89
12,335,63,1088,19,9.32,1107,36.78,0.85,0.89
12,335,63,1088,19,9.32,1107,36.78,0.85,0.89
12,335,63,1088,19,9.32,1107,36.78,0.85,0.89
12,335,63,1088,19,9.32,1107,36.78,0.85,0.89
0,313,61,1138,6,2.94,1144,15.03,0.9,0.91
0,313,61,1138,6,2.94,1144,15.03,0.9,0.91
0,313,61,1138,6,2.94,1144,15.03,0.9,0.91
0,313,61,1138,6,2.94,1144,15.03,0.9,0.91
0,313,61,1138,6,2.94,1144,15.03,0.9,0.91
4,254,88,1113,16,8.2,1129,32.4,0.86,0.9
4,254,88,1113,16,8.2,1129,32.4,0.86,0.9
4,254,88,1113,16,8.2,1129,32.4,0.86,0.9
4,254,88,1113,16,8.2,1129,32.4,0.86,0.9
4,254,88,1113,16,8.2,1129,32.4,0.86,0.9
6,364,40,1110,6,2.91,1116,14.98,0.9,0.91
6,364,40,1110,6,2.91,1116,14.98,0.9,0.91
6,364,40,1110,6,2.91,1116,14.98,0.9,0.91
6,364,40,1110,6,2.91,1116,14.98,0.9,0.91
6,364,40,1110,6,2.91,1116,14.98,0.9,0.91
12,433,63,1129,5,2.25,1134,13.0,0.9,0.91
12,433,63,1129,5,2.25,1134,13.0,0.9,0.91
12,433,63,1129,5,2.25,1134,13.0,0.9,0.91
12,433,63,1129,5,2.25,1134,13.0,0.9,0.91
12,433,63,1129,5,2.25,1134,13.0,0.9,0.91
6,444,40,1150,8,4.05,1158,18.61,0.89,0.91
6,444,40,1150,8,4.05,1158,18.61,0.89,0.91
6,444,40,1150,8,4.05,1158,18.61,0.89,0.91
6,444,40,1150,8,4.05,1158,18.61,0.89,0.91
6,444,40,1150,8,4.05,1158,18.61,0.89,0.91
12,499,63,1166,7,3.46,1173,16.76,0.9,0.91
12,499,63,1166,7,3.46,1173,16.76,0.9,0.91
12,499,63,1166,7,3.46,1173,16.76,0.9,0.91
12,499,63,1166,7,3.46,1173,16.76,0.9,0.91
12,499,63,1166,7,3.46,1173,16.76,0.9,0.91
4,617,88,1199,14,6.94,1213,28.56,0.87,0.9
4,617,88,1199,14,6.94,1213,28.56,0.87,0.9
4,617,88,1199,14,6.94,1213,28.56,0.87,0.9
4,617,88,1199,14,6.94,1213,28.56,0.87,0.9
4,617,88,1199,14,6.94,1213,28.56,0.87,0.9
10,822,14,1196,8,3.9,1204,18.34,0.89,0.91
10,822,14,1196,8,3.9,1204,18.34,0.89,0.91
10,822,14,1196,8,3.9,1204,18.34,0.89,0.91
10,822,14,1196,8,3.9,1204,18.34,0.89,0.91
10,822,14,1196,8,3.9,1204,18.34,0.89,0.91
12,525,63,1193,14,7.18,1207,29.0,0.87,0.9
12,525,63,1193,14,7.18,1207,29.0,0.87,0.9
12,525,63,1193,14,7.18,1207,29.0,0.87,0.9
12,525,63,1193,14,7.18,1207,29.0,0.87,0.9
12,525,63,1193,14,7.18,1207,29.0,0.87,0.9
4,624,88,1228,12,6.04,1240,25.35,0.88,0.9
4,624,88,1228,12,6.04,1240,25.35,0.88,0.9
4,624,88,1228,12,6.04,1240,25.35,0.88,0.9
4,624,88,1228,12,6.04,1240,25.35,0.88,0.9
4,624,88,1228,12,6.04,1240,25.35,0.88,0.9
4,630,88,1244,11,5.44,1255,23.47,0.88,0.91
4,630,88,1244,11,5.44,1255,23.47,0.88,0.91
4,630,88,1244,11,5.44,1255,23.47,0.88,0.91
4,630,88,1244,11,5.44,1255,23.47,0.88,0.91
4,630,88,1244,11,5.44,1255,23.47,0.88,0.91
6,573,40,1258,5,2.62,1263,13.68,0.9,0.91
6,573,40,1258,5,2.62,1263,13.68,0.9,0.91
6,573,40,1258,5,2.62,1263,13.68,0.9,0.91
6,573,40,1258,5,2.62,1263,13.68,0.9,0.91
6,573,40,1258,5,2.62,1263,13.68,0.9,0.91
12,918,63,1245,16,7.9,1261,31.86,0.87,0.9
12,918,63,1245,16,7.9,1261,31.86,0.87,0.9
12,918,63,1245,16,7.9,1261,31.86,0.87,0.9
12,918,63,1245,16,7.9,1261,31.86,0.87,0.9
12,918,63,1245,16,7.9,1261,31.86,0.87,0.9
4,657,88,1289,4,2.11,1293,11.96,0.91,0.92
4,657,88,1289,4,2.11,1293,11.96,0.91,0.92
4,657,88,1289,4,2.11,1293,11.96,0.91,0.92
4,657,88,1289,4,2.11,1293,11.96,0.91,0.92
4,657,88,1289,4,2.11,1293,11.96,0.91,0.92
4,573,88,1316,15,7.65,1331,30.62,0.87,0.9
4,573,88,1316,15,7.65,1331,30.62,0.87,0.9
4,573,88,1316,15,7.65,1331,30.62,0.87,0.9
4,573,88,1316,15,7.65,1331,30.62,0.87,0.9
4,573,88,1316,15,7.65,1331,30.62,0.87,0.9
6,523,40,1299,8,3.92,1307,18.37,0.89,0.91
6,523,40,1299,8,3.92,1307,18.37,0.89,0.91
6,523,40,1299,8,3.92,1307,18.37,0.89,0.91
6,523,40,1299,8,3.92,1307,18.37,0.89,0.91
6,523,40,1299,8,3.92,1307,18.37,0.89,0.91
12,555,63,1314,8,3.77,1322,18.09,0.89,0.91
12,555,63,1314,8,3.77,1322,18.09,0.89,0.91
12,555,63,1314,8,3.77,1322,18.09,0.89,0.91
12,555,63,1314,8,3.77,1322,18.09,0.89,0.91
12,555,63,1314,8,3.77,1322,18.09,0.89,0.91
4,504,88,1328,9,4.65,1337,20.49,0.89,0.91
4,504,88,1328,9,4.65,1337,20.49,0.89,0.91
4,504,88,1328,9,4.65,1337,20.49,0.89,0.91
4,504,88,1328,9,4.65,1337,20.49,0.89,0.91
4,504,88,1328,9,4.65,1337,20.49,0.89,0.91
6,503,40,1321,8,3.99,1329,18.5,0.89,0.91
6,503,40,1321,8,3.99,1329,18.5,0.89,0.91
6,503,40,1321,8,3.99,1329,18.5,0.89,0.91
6,503,40,1321,8,3.99,1329,18.5,0.89,0.91
6,503,40,1321,8,3.99,1329,18.5,0.89,0.91
12,536,63,1334,17,8.38,1351,33.51,0.86,0.9
12,536,63,1334,17,8.38,1351,33.51,0.86,0.9
12,536,63,1334,17,8.38,1351,33.51,0.86,0.9
12,536,63,1334,17,8.38,1351,33.51,0.86,0.9
12,536,63,1334,17,8.38,1351,33.51,0.86,0.9
4,642,88,1351,11,5.65,1362,23.86,0.88,0.91
4,642,88,1351,11,5.65,1362,23.86,0.88,0.91
4,642,88,1351,11,5.65,1362,23.86,0.88,0.91
4,642,88,1351,11,5.65,1362,23.86,0.88,0.91
4,642,88,1351,11,5.65,1362,23.86,0.88,0.91
6,594,40,1378,1,0.72,1379,7.1,0.91,0.92
6,594,40,1378,1,0.72,1379,7.1,0.91,0.92
6,594,40,1378,1,0.72,1379,7.1,0.91,0.92
6,594,40,1378,1,0.72,1379,7.1,0.91,0.92
6,594,40,1378,1,0.72,1379,7.1,0.91,0.92
12,594,63,1351,17,8.32,1368,33.41,0.86,0.9
12,594,63,1351,17,8.32,1368,33.41,0.86,0.9
12,594,63,1351,17,8.32,1368,33.41,0.86,0.9
12,594,63,1351,17,8.32,1368,33.41,0.86,0.9
12,594,63,1351,17,8.32,1368,33.41,0.86,0.9
6,564,40,1398,9,4.46,1407,20.13,0.89,0.91
6,564,40,1398,9,4.46,1407,20.13,0.89,0.91
6,564,40,1398,9,4.46,1407,20.13,0.89,0.91
6,564,40,1398,9,4.46,1407,20.13,0.89,0.91
6,564,40,1398,9,4.46,1407,20.13,0.89,0.91
2,576,26,1415,2,0.97,1417,8.33,0.91,0.92
2,576,26,1415,2,0.97,1417,8.33,0.91,0.92
2,576,26,1415,2,0.97,1417,8.33,0.91,0.92
2,576,26,1415,2,0.97,1417,8.33,0.91,0.92
2,576,26,1415,2,0.97,1417,8.33,0.91,0.92
4,551,88,1430,14,6.77,1444,28.23,0.87,0.9
4,551,88,1430,14,6.77,1444,28.23,0.87,0.9
4,551,88,1430,14,6.77,1444,28.23,0.87,0.9
4,551,88,1430,14,6.77,1444,28.23,0.87,0.9
4,551,88,1430,14,6.77,1444,28.23,0.87,0.9
6,523,40,1417,4,2.2,1421,12.12,0.91,0.92
6,523,40,1417,4,2.2,1421,12.12,0.91,0.92
6,523,40,1417,4,2.2,1421,12.12,0.91,0.92
6,523,40,1417,4,2.2,1421,12.12,0.91,0.92
6,523,40,1417,4,2.2,1421,12.12,0.91,0.92
14,781,37,99,18,9.06,117,35.53,0.86,0.9
14,781,37,99,18,9.06,117,35.53,0.86,0.9
14,781,37,99,18,9.06,117,35.53,0.86,0.9
14,781,37,99,18,9.06,117,35.53,0.86,0.9
14,781,37,99,18,9.06,117,35.53,0.86,0.9
14,781,37,99,18,9.06,117,35.53,0.86,0.9
14,797,37,149,16,7.89,165,31.83,0.87,0.9
14,797,37,149,16,7.89,165,31.83,0.87,0.9
14,797,37,149,16,7.89,165,31.83,0.87,0.9
14,797,37,149,16,7.89,165,31.83,0.87,0.9
14,797,37,149,16,7.89,165,31.83,0.87,0.9
14,797,37,149,16,7.89,165,31.83,0.87,0.9
1,971,30,193,6,2.82,199,14.81,0.9,0.91
1,971,30,193,6,2.82,199,14.81,0.9,0.91
1,971,30,193,6,2.82,199,14.81,0.9,0.91
1,971,30,193,6,2.82,199,14.81,0.9,0.91
1,971,30,193,6,2.82,199,14.81,0.9,0.91
1,971,30,193,6,2.82,199,14.81,0.9,0.91
14,979,37,184,2,0.8,186,8.02,0.91,0.92
14,979,37,184,2,0.8,186,8.02,0.91,0.92
14,979,37,184,2,0.8,186,8.02,0.91,0.92
14,979,37,184,2,0.8,186,8.02,0.91,0.92
14,979,37,184,2,0.8,186,8.02,0.91,0.92
14,979,37,184,2,0.8,186,8.02,0.91,0.92
1,797,30,228,12,6.11,240,25.48,0.88,0.9
1,797,30,228,12,6.11,240,25.48,0.88,0.9
1,797,30,228,12,6.11,240,25.48,0.88,0.9
1,797,30,228,12,6.11,240,25.48,0.88,0.9
1,797,30,228,12,6.11,240,25.48,0.88,0.9
1,797,30,228,12,6.11,240,25.48,0.88,0.9
9,819,17,240,13,6.43,253,26.84,0.88,0.9
9,819,17,240,13,6.43,253,26.84,0.88,0.9
9,819,17,240,13,6.43,253,26.84,0.88,0.9
9,819,17,240,13,6.43,253,26.84,0.88,0.9
9,819,17,240,13,6.43,253,26.84,0.88,0.9
9,819,17,240,13,6.43,253,26.84,0.88,0.9
14,835,37,277,12,5.83,289,24.97,0.88,0.9
14,835,37,277,12,5.83,289,24.97,0.88,0.9
14,835,37,277,12,5.83,289,24.97,0.88,0.9
14,835,37,277,12,5.83,289,24.97,0.88,0.9
14,835,37,277,12,5.83,289,24.97,0.88,0.9
14,835,37,277,12,5.83,289,24.97,0.88,0.9
1,134,30,326,17,8.34,343,33.44,0.86,0.9
1,134,30,326,17,8.34,343,33.44,0.86,0.9
1,134,30,326,17,8.34,343,33.44,0.86,0.9
1,134,30,326,17,8.34,343,33.44,0.86,0.9
1,134,30,326,17,8.34,343,33.44,0.86,0.9
1,134,30,326,17,8.34,343,33.44,0.86,0.9
14,855,37,310,13,6.32,323,26.65,0.88,0.9
14,855,37,310,13,6.32,323,26.65,0.88,0.9
14,855,37,310,13,6.32,323,26.65,0.88,0.9
14,855,37,310,13,6.32,323,26.65,0.88,0.9
14,855,37,310,13,6.32,323,26.65,0.88,0.9
14,855,37,310,13,6.32,323,26.65,0.88,0.9
1,59,30,331,3,1.74,334,10.5,0.91,0.92
1,59,30,331,3,1.74,334,10.5,0.91,0.92
1,59,30,331,3,1.74,334,10.5,0.91,0.92
1,59,30,331,3,1.74,334,10.5,0.91,0.92
1,59,30,331,3,1.74,334,10.5,0.91,0.92
1,59,30,331,3,1.74,334,10.5,0.91,0.92
1,72,30,360,16,8.02,376,32.08,0.87,0.9
1,72,30,360,16,8.02,376,32.08,0.87,0.9
1,72,30,360,16,8.02,376,32.08,0.87,0.9
1,72,30,360,16,8.02,376,32.08,0.87,0.9
1,72,30,360,16,8.02,376,32.08,0.87,0.9
1,72,30,360,16,8.02,376,32.08,0.87,0.9
13,11,95,360,10,5.12,370,22.11,0.89,0.91
13,11,95,360,10,5.12,370,22.11,0.89,0.91
13,11,95,360,10,5.12,370,22.11,0.89,0.91
13,11,95,360,10,5.12,370,22.11,0.89,0.91
13,11,95,360,10,5.12,370,22.11,0.89,0.91
13,11,95,360,10,5.12,370,22.11,0.89,0.91
14,138,37,373,11,5.56,384,23.7,0.88,0.91
14,138,37,373,11,5.56,384,23.7,0.88,0.91
14,138,37,373,11,5.56,384,23.7,0.88,0.91
14,138,37,373,11,5.56,384,23.7,0.88,0.91
14,138,37,373,11,5.56,384,23.7,0.88,0.91
14,138,37,373,11,5.56,384,23.7,0.88,0.91
1,878,30,418,6,3.13,424,15.37,0.9,0.91
1,878,30,418,6,3.13,424,15.37,0.9,0.91
1,878,30,418,6,3.13,424,15.37,0.9,0.91
1,878,30,418,6,3.13,424,15.37,0.9,0.91
1,878,30,418,6,3.13,424,15.37,0.9,0.91
1,878,30,418,6,3.13,424,15.37,0.9,0.91
9,42,17,418,6,3.19,424,15.49,0.9,0.91
9,42,17,418,6,3.19,424,15.49,0.9,0.91
9,42,17,418,6,3.19,424,15.49,0.9,0.91
9,42,17,418,6,3.19,424,15.49,0.9,0.91
9,42,17,418,6,3.19,424,15.49,0.9,0.91
9,42,17,418,6,3.19,424,15.49,0.9,0.91
13,764,95,417,3,1.5,420,10.07,0.91,0.92
13,764,95,417,3,1.5,420,10.07,0.91,0.92
13,764,95,417,3,1.5,420,10.07,0.91,0.92
13,764,95,417,3,1.5,420,10.07,0.91,0.92
13,764,95,417,3,1.5,420,10.07,0.91,0.92
13,764,95,417,3,1.5,420,10.07,0.91,0.92
5,227,38,445,1,0.33,446,6.38,0.91,0.92
5,227,38,445,1,0.33,446,6.38,0.91,0.92
5,227,38,445,1,0.33,446,6.38,0.91,0.92
5,227,38,445,1,0.33,446,6.38,0.91,0.92
5,227,38,445,1,0.33,446,6.38,0.91,0.92
5,227,38,445,1,0.33,446,6.38,0.91,0.92
9,59,17,431,6,2.98,437,15.11,0.9,0.91
9,59,17,431,6,2.98,437,15.11,0.9,0.91
9,59,17,431,6,2.98,437,15.11,0.9,0.91
9,59,17,431,6,2.98,437,15.11,0.9,0.91
9,59,17,431,6,2.98,437,15.11,0.9,0.91
9,59,17,431,6,2.98,437,15.11,0.9,0.91
12,23,16,440,16,8.23,456,32.46,0.86,0.9
12,23,16,440,16,8.23,456,32.46,0.86,0.9
12,23,16,440,16,8.23,456,32.46,0.86,0.9
12,23,16,440,16,8.23,456,32.46,0.86,0.9
12,23,16,440,16,8.23,456,32.46,0.86,0.9
12,23,16,440,16,8.23,456,32.46,0.86,0.9
14,118,37,422,6,3.16,428,15.44,0.9,0.91
14,118,37,422,6,3.16,428,15.44,0.9,0.91
14,118,37,422,6,3.16,428,15.44,0.9,0.91
14,118,37,422,6,3.16,428,15.44,0.9,0.91
14,118,37,422,6,3.16,428,15.44,0.9,0.91
14,118,37,422,6,3.16,428,15.44,0.9,0.91
15,19,12,439,15,7.72,454,30.75,0.87,0.9
15,19,12,439,15,7.72,454,30.75,0.87,0.9
15,19,12,439,15,7.72,454,30.75,0.87,0.9
15,19,12,439,15,7.72,454,30.75,0.87,0.9
15,19,12,439,15,7.72,454,30.75,0.87,0.9
15,19,12,439,15,7.72,454,30.75,0.87,0.9
5,92,38,475,11,5.31,486,23.25,0.88,0.91
5,92,38,475,11,5.31,486,23.25,0.88,0.91
5,92,38,475,11,5.31,486,23.25,0.88,0.91
5,92,38,475,11,5.31,486,23.25,0.88,0.91
5,92,38,475,11,5.31,486,23.25,0.88,0.91
5,92,38,475,11,5.31,486,23.25,0.88,0.91
9,20,17,450,11,5.68,461,23.91,0.88,0.91
9,20,17,450,11,5.68,461,23.91,0.88,0.91
9,20,17,450,11,5.68,461,23.91,0.88,0.91
9,20,17,450,11,5.68,461,23.91,0.88,0.91
9,20,17,450,11,5.68,461,23.91,0.88,0.91
9,20,17,450,11,5.68,461,23.91,0.88,0.91
12,90,16,456,10,5.01,466,21.92,0.89,0.91
12,90,16,456,10,5.01,466,21.92,0.89,0.91
12,90,16,456,10,5.01,466,21.92,0.89,0.91
12,90,16,456,10,5.01,466,21.92,0.89,0.91
12,90,16,456,10,5.01,466,21.92,0.89,0.91
12,90,16,456,10,5.01,466,21.92,0.89,0.91
14,15,37,465,6,2.92,471,15.0,0.9,0.91
14,15,37,465,6,2.92,471,15.0,0.9,0.91
14,15,37,465,6,2.92,471,15.0,0.9,0.91
14,15,37,465,6,2.92,471,15.0,0.9,0.91
14,15,37,465,6,2.92,471,15.0,0.9,0.91
14,15,37,465,6,2.92,471,15.0,0.9,0.91
15,132,12,467,21,10.35,488,40.22,0.84,0.89
15,132,12,467,21,10.35,488,40.22,0.84,0.89
15,132,12,467,21,10.35,488,40.22,0.84,0.89
15,132,12,467,21,10.35,488,40.22,0.84,0.89
15,132,12,467,21,10.35,488,40.22,0.84,0.89
15,132,12,467,21,10.35,488,40.22,0.84,0.89
3,179,22,508,13,6.44,521,26.87,0.88,0.9
3,179,22,508,13,6.44,521,26.87,0.88,0.9
3,179,22,508,13,6.44,521,26.87,0.88,0.9
3,179,22,508,13,6.44,521,26.87,0.88,0.9
3,179,22,508,13,6.44,521,26.87,0.88,0.9
3,179,22,508,13,6.44,521,26.87,0.88,0.9
5,918,38,492,4,1.75,496,11.31,0.91,0.92
5,918,38,492,4,1.75,496,11.31,0.91,0.92
5,918,38,492,4,1.75,496,11.31,0.91,0.92
5,918,38,492,4,1.75,496,11.31,0.91,0.92
5,918,38,492,4,1.75,496,11.31,0.91,0.92
5,918,38,492,4,1.75,496,11.31,0.91,0.92
10,36,72,505,2,1.15,507,8.66,0.91,0.92
10,36,72,505,2,1.15,507,8.66,0.91,0.92
10,36,72,505,2,1.15,507,8.66,0.91,0.92
10,36,72,505,2,1.15,507,8.66,0.91,0.92
10,36,72,505,2,1.15,507,8.66,0.91,0.92
10,36,72,505,2,1.15,507,8.66,0.91,0.92
14,1,37,493,14,6.9,507,28.48,0.87,0.9
14,1,37,493,14,6.9,507,28.48,0.87,0.9
14,1,37,493,14,6.9,507,28.48,0.87,0.9
14,1,37,493,14,6.9,507,28.48,0.87,0.9
14,1,37,493,14,6.9,507,28.48,0.87,0.9
14,1,37,493,14,6.9,507,28.48,0.87,0.9
5,144,38,535,9,4.6,544,20.4,0.89,0.91
5,144,38,535,9,4.6,544,20.4,0.89,0.91
5,144,38,535,9,4.6,544,20.4,0.89,0.91
5,144,38,535,9,4.6,544,20.4,0.89,0.91
5,144,38,535,9,4.6,544,20.4,0.89,0.91
5,144,38,535,9,4.6,544,20.4,0.89,0.91
8,34,26,533,9,4.72,542,20.61,0.89,0.91
8,34,26,533,9,4.72,542,20.61,0.89,0.91
8,34,26,533,9,4.72,542,20.61,0.89,0.91
8,34,26,533,9,4.72,542,20.61,0.89,0.91
8,34,26,533,9,4.72,542,20.61,0.89,0.91
8,34,26,533,9,4.72,542,20.61,0.89,0.91
10,64,72,529,12,5.76,541,24.84,0.88,0.9
10,64,72,529,12,5.76,541,24.84,0.88,0.9
10,64,72,529,12,5.76,541,24.84,0.88,0.9
10,64,72,529,12,5.76,541,24.84,0.88,0.9
10,64,72,529,12,5.76,541,24.84,0.88,0.9
10,64,72,529,12,5.76,541,24.84,0.88,0.9
14,40,37,512,15,7.52,527,30.38,0.87,0.9
14,40,37,512,15,7.52,527,30.38,0.87,0.9
14,40,37,512,15,7.52,527,30.38,0.87,0.9
14,40,37,512,15,7.52,527,30.38,0.87,0.9
14,40,37,512,15,7.52,527,30.38,0.87,0.9
14,40,37,512,15,7.52,527,30.38,0.87,0.9
2,20,66,564,9,4.62,573,20.43,0.89,0.91
2,20,66,564,9,4.62,573,20.43,0.89,0.91
2,20,66,564,9,4.62,573,20.43,0.89,0.91
2,20,66,564,9,4.62,573,20.43,0.89,0.91
2,20,66,564,9,4.62,573,20.43,0.89,0.91
2,20,66,564,9,4.62,573,20.43,0.89,0.91
8,0,26,563,11,5.47,574,23.54,0.88,0.91
8,0,26,563,11,5.47,574,23.54,0.88,0.91
8,0,26,563,11,5.47,574,23.54,0.88,0.91
8,0,26,563,11,5.47,574,23.54,0.88,0.91
8,0,26,563,11,5.47,574,23.54,0.88,0.91
8,0,26,563,11,5.47,574,23.54,0.88,0.91
10,2,72,554,8,4.08,562,18.67,0.89,0.91
10,2,72,554,8,4.08,562,18.67,0.89,0.91
10,2,72,554,8,4.08,562,18.67,0.89,0.91
10,2,72,554,8,4.08,562,18.67,0.89,0.91
10,2,72,554,8,4.08,562,18.67,0.89,0.91
10,2,72,554,8,4.08,562,18.67,0.89,0.91
11,49,33,559,15,7.72,574,30.74,0.87,0.9
11,49,33,559,15,7.72,574,30.74,0.87,0.9
11,49,33,559,15,7.72,574,30.74,0.87,0.9
11,49,33,559,15,7.72,574,30.74,0.87,0.9
11,49,33,559,15,7.72,574,30.74,0.87,0.9
11,49,33,559,15,7.72,574,30.74,0.87,0.9
14,226,37,544,11,5.3,555,23.22,0.88,0.91
14,226,37,544,11,5.3,555,23.22,0.88,0.91
14,226,37,544,11,5.3,555,23.22,0.88,0.91
14,226,37,544,11,5.3,555,23.22,0.88,0.91
14,226,37,544,11,5.3,555,23.22,0.88,0.91
14,226,37,544,11,5.3,555,23.22,0.88,0.91
5,0,38,590,12,5.96,602,25.21,0.88,0.9
5,0,38,590,12,5.96,602,25.21,0.88,0.9
5,0,38,590,12,5.96,602,25.21,0.88,0.9
5,0,38,590,12,5.96,602,25.21,0.88,0.9
5,0,38,590,12,5.96,602,25.21,0.88,0.9
5,0,38,590,12,5.96,602,25.21,0.88,0.9
7,223,70,580,16,7.75,596,31.59,0.87,0.9
7,223,70,580,16,7.75,596,31.59,0.87,0.9
7,223,70,580,16,7.75,596,31.59,0.87,0.9
7,223,70,580,16,7.75,596,31.59,0.87,0.9
7,223,70,580,16,7.75,596,31.59,0.87,0.9
7,223,70,580,16,7.75,596,31.59,0.87,0.9
8,99,26,590,17,8.3,607,33.36,0.86,0.9
8,99,26,590,17,8.3,607,33.36,0.86,0.9
8,99,26,590,17,8.3,607,33.36,0.86,0.9
8,99,26,590,17,8.3,607,33.36,0.86,0.9
8,99,26,590,17,8.3,607,33.36,0.86,0.9
8,99,26,590,17,8.3,607,33.36,0.86,0.9
10,181,72,594,3,1.62,597,10.29,0.91,0.92
10,181,72,594,3,1.62,597,10.29,0.91,0.92
10,181,72,594,3,1.62,597,10.29,0.91,0.92
10,181,72,594,3,1.62,597,10.29,0.91,0.92
10,181,72,594,3,1.62,597,10.29,0.91,0.92
10,181,72,594,3,1.62,597,10.29,0.91,0.92
14,45,37,574,8,4.13,582,18.75,0.89,0.91
14,45,37,574,8,4.13,582,18.75,0.89,0.91
14,45,37,574,8,4.13,582,18.75,0.89,0.91
14,45,37,574,8,4.13,582,18.75,0.89,0.91
14,45,37,574,8,4.13,582,18.75,0.89,0.91
14,45,37,574,8,4.13,582,18.75,0.89,0.91
5,96,38,624,5,2.4,629,13.27,0.9,0.91
5,96,38,624,5,2.4,629,13.27,0.9,0.91
5,96,38,624,5,2.4,629,13.27,0.9,0.91
5,96,38,624,5,2.4,629,13.27,0.9,0.91
5,96,38,624,5,2.4,629,13.27,0.9,0.91
5,96,38,624,5,2.4,629,13.27,0.9,0.91
7,864,70,609,2,1.07,611,8.51,0.91,0.92
7,864,70,609,2,1.07,611,8.51,0.91,0.92
7,864,70,609,2,1.07,611,8.51,0.91,0.92
7,864,70,609,2,1.07,611,8.51,0.91,0.92
7,864,70,609,2,1.07,611,8.51,0.91,0.92
7,864,70,609,2,1.07,611,8.51,0.91,0.92
11,162,33,624,4,1.78,628,11.37,0.91,0.92
11,162,33,624,4,1.78,628,11.37,0.91,0.92
11,162,33,624,4,1.78,628,11.37,0.91,0.92
11,162,33,624,4,1.78,628,11.37,0.91,0.92
11,162,33,624,4,1.78,628,11.37,0.91,0.92
11,162,33,624,4,1.78,628,11.37,0.91,0.92
5,771,38,661,6,2.96,667,15.06,0.9,0.91
5,771,38,661,6,2.96,667,15.06,0.9,0.91
5,771,38,661,6,2.96,667,15.06,0.9,0.91
5,771,38,661,6,2.96,667,15.06,0.9,0.91
5,771,38,661,6,2.96,667,15.06,0.9,0.91
5,771,38,661,6,2.96,667,15.06,0.9,0.91
8,203,26,663,11,5.41,674,23.43,0.88,0.91
8,203,26,663,11,5.41,674,23.43,0.88,0.91
8,203,26,663,11,5.41,674,23.43,0.88,0.91
8,203,26,663,11,5.41,674,23.43,0.88,0.91
8,203,26,663,11,5.41,674,23.43,0.88,0.91
8,203,26,663,11,5.41,674,23.43,0.88,0.91
10,900,72,667,13,6.71,680,27.36,0.88,0.9
10,900,72,667,13,6.71,680,27.36,0.88,0.9
10,900,72,667,13,6.71,680,27.36,0.88,0.9
10,900,72,667,13,6.71,680,27.36,0.88,0.9
10,900,72,667,13,6.71,680,27.36,0.88,0.9
10,900,72,667,13,6.71,680,27.36,0.88,0.9
10,807,72,708,6,2.92,714,14.99,0.9,0.91
10,807,72,708,6,2.92,714,14.99,0.9,0.91
10,807,72,708,6,2.92,714,14.99,0.9,0.91
10,807,72,708,6,2.92,714,14.99,0.9,0.91
10,807,72,708,6,2.92,714,14.99,0.9,0.91
10,807,72,708,6,2.92,714,14.99,0.9,0.91
1,809,30,726,22,10.77,748,41.76,0.84,0.89
1,809,30,726,22,10.77,748,41.76,0.84,0.89
1,809,30,726,22,10.77,748,41.76,0.84,0.89
1,809,30,726,22,10.77,748,41.76,0.84,0.89
1,809,30,726,22,10.77,748,41.76,0.84,0.89
1,809,30,726,22,10.77,748,41.76,0.84,0.89
8,992,26,783,5,2.45,788,13.36,0.9,0.91
8,992,26,783,5,2.45,788,13.36,0.9,0.91
8,992,26,783,5,2.45,788,13.36,0.9,0.91
8,992,26,783,5,2.45,788,13.36,0.9,0.91
8,992,26,783,5,2.45,788,13.36,0.9,0.91
8,992,26,783,5,2.45,788,13.36,0.9,0.91
8,899,26,832,11,5.35,843,23.32,0.88,0.91
8,899,26,832,11,5.35,843,23.32,0.88,0.91
8,899,26,832,11,5.35,843,23.32,0.88,0.91
8,899,26,832,11,5.35,843,23.32,0.88,0.91
8,899,26,832,11,5.35,843,23.32,0.88,0.91
8,899,26,832,11,5.35,843,23.32,0.88,0.91
15,866,12,888,13,6.42,901,26.83,0.88,0.9
15,866,12,888,13,6.42,901,26.83,0.88,0.9
15,866,12,888,13,6.42,901,26.83,0.88,0.9
15,866,12,888,13,6.42,901,26.83,0.88,0.9
15,866,12,888,13,6.42,901,26.83,0.88,0.9
15,866,12,888,13,6.42,901,26.83,0.88,0.9
0,978,43,914,6,3.07,920,15.27,0.9,0.91
0,978,43,914,6,3.07,920,15.27,0.9,0.91
0,978,43,914,6,3.07,920,15.27,0.9,0.91
0,978,43,914,6,3.07,920,15.27,0.9,0.91
0,978,43,914,6,3.07,920,15.27,0.9,0.91
0,978,43,914,6,3.07,920,15.27,0.9,0.91
15,904,12,932,6,2.98,938,15.1,0.9,0.91
15,904,12,932,6,2.98,938,15.1,0.9,0.91
15,904,12,932,6,2.98,938,15.1,0.9,0.91
15,904,12,932,6,2.98,938,15.1,0.9,0.91
15,904,12,932,6,2.98,938,15.1,0.9,0.91
15,904,12,932,6,2.98,938,15.1,0.9,0.91
1,382,30,970,9,4.34,979,19.92,0.89,0.91
1,382,30,970,9,4.34,979,19.92,0.89,0.91
1,382,30,970,9,4.34,979,19.92,0.89,0.91
1,382,30,970,9,4.34,979,19.92,0.89,0.91
1,382,30,970,9,4.34,979,19.92,0.89,0.91
1,382,30,970,9,4.34,979,19.92,0.89,0.91
0,317,43,1000,2,1.13,1002,8.61,0.91,0.92
0,317,43,1000,2,1.13,1002,8.61,0.91,0.92
0,317,43,1000,2,1.13,1002,8.61,0.91,0.92
0,317,43,1000,2,1.13,1002,8.61,0.91,0.92
0,317,43,1000,2,1.13,1002,8.61,0.91,0.92
0,317,43,1000,2,1.13,1002,8.61,0.91,0.92
1,441,30,999,6,2.8,1005,14.77,0.9,0.91
1,441,30,999,6,2.8,1005,14.77,0.9,0.91
1,441,30,999,6,2.8,1005,14.77,0.9,0.91
1,441,30,999,6,2.8,1005,14.77,0.9,0.91
1,441,30,999,6,2.8,1005,14.77,0.9,0.91
1,441,30,999,6,2.8,1005,14.77,0.9,0.91
11,292,77,1012,8,3.88,1020,18.31,0.89,0.91
11,292,77,1012,8,3.88,1020,18.31,0.89,0.91
11,292,77,1012,8,3.88,1020,18.31,0.89,0.91
11,292,77,1012,8,3.88,1020,18.31,0.89,0.91
11,292,77,1012,8,3.88,1020,18.31,0.89,0.91
11,292,77,1012,8,3.88,1020,18.31,0.89,0.91
7,764,52,1024,9,4.71,1033,20.58,0.89,0.91
7,764,52,1024,9,4.71,1033,20.58,0.89,0.91
7,764,52,1024,9,4.71,1033,20.58,0.89,0.91
7,764,52,1024,9,4.71,1033,20.58,0.89,0.91
7,764,52,1024,9,4.71,1033,20.58,0.89,0.91
7,764,52,1024,9,4.71,1033,20.58,0.89,0.91
11,356,77,1039,9,4.42,1048,20.07,0.89,0.91
11,356,77,1039,9,4.42,1048,20.07,0.89,0.91
11,356,77,1039,9,4.42,1048,20.07,0.89,0.91
11,356,77,1039,9,4.42,1048,20.07,0.89,0.91
11,356,77,1039,9,4.42,1048,20.07,0.89,0.91
11,356,77,1039,9,4.42,1048,20.07,0.89,0.91
2,272,54,1068,13,6.4,1081,26.8,0.88,0.9
2,272,54,1068,13,6.4,1081,26.8,0.88,0.9
2,272,54,1068,13,6.4,1081,26.8,0.88,0.9
2,272,54,1068,13,6.4,1081,26.8,0.88,0.9
2,272,54,1068,13,6.4,1081,26.8,0.88,0.9
2,272,54,1068,13,6.4,1081,26.8,0.88,0.9
7,338,52,1051,5,2.25,1056,13.0,0.9,0.91
7,338,52,1051,5,2.25,1056,13.0,0.9,0.91
7,338,52,1051,5,2.25,1056,13.0,0.9,0.91
7,338,52,1051,5,2.25,1056,13.0,0.9,0.91
7,338,52,1051,5,2.25,1056,13.0,0.9,0.91
7,338,52,1051,5,2.25,1056,13.0,0.9,0.91
11,271,77,1067,15,7.27,1082,29.93,0.87,0.9
11,271,77,1067,15,7.27,1082,29.93,0.87,0.9
11,271,77,1067,15,7.27,1082,29.93,0.87,0.9
11,271,77,1067,15,7.27,1082,29.93,0.87,0.9
11,271,77,1067,15,7.27,1082,29.93,0.87,0.9
11,271,77,1067,15,7.27,1082,29.93,0.87,0.9
2,324,54,1087,1,0.72,1088,7.08,0.91,0.92
2,324,54,1087,1,0.72,1088,7.08,0.91,0.92
2,324,54,1087,1,0.72,1088,7.08,0.91,0.92
2,324,54,1087,1,0.72,1088,7.08,0.91,0.92
2,324,54,1087,1,0.72,1088,7.08,0.91,0.92
2,324,54,1087,1,0.72,1088,7.08,0.91,0.92
7,405,52,1109,10,5.15,1119,22.17,0.89,0.91
7,405,52,1109,10,5.15,1119,22.17,0.89,0.91
7,405,52,1109,10,5.15,1119,22.17,0.89,0.91
7,405,52,1109,10,5.15,1119,22.17,0.89,0.91
7,405,52,1109,10,5.15,1119,22.17,0.89,0.91
7,405,52,1109,10,5.15,1119,22.17,0.89,0.91
11,304,77,1089,16,7.8,1105,31.68,0.87,0.9
11,304,77,1089,16,7.8,1105,31.68,0.87,0.9
11,304,77,1089,16,7.8,1105,31.68,0.87,0.9
11,304,77,1089,16,7.8,1105,31.68,0.87,0.9
11,304,77,1089,16,7.8,1105,31.68,0.87,0.9
11,304,77,1089,16,7.8,1105,31.68,0.87,0.9
2,324,54,1119,10,4.93,1129,21.77,0.89,0.91
2,324,54,1119,10,4.93,1129,21.77,0.89,0.91
2,324,54,1119,10,4.93,1129,21.77,0.89,0.91
2,324,54,1119,10,4.93,1129,21.77,0.89,0.91
2,324,54,1119,10,4.93,1129,21.77,0.89,0.91
2,324,54,1119,10,4.93,1129,21.77,0.89,0.91
7,294,52,1136,7,3.27,1143,16.41,0.9,0.91
7,294,52,1136,7,3.27,1143,16.41,0.9,0.91
7,294,52,1136,7,3.27,1143,16.41,0.9,0.91
7,294,52,1136,7,3.27,1143,16.41,0.9,0.91
7,294,52,1136,7,3.27,1143,16.41,0.9,0.91
7,294,52,1136,7,3.27,1143,16.41,0.9,0.91
11,459,77,1114,3,1.52,1117,10.1,0.91,0.92
11,459,77,1114,3,1.52,1117,10.1,0.91,0.92
11,459,77,1114,3,1.52,1117,10.1,0.91,0.92
11,459,77,1114,3,1.52,1117,10.1,0.91,0.92
11,459,77,1114,3,1.52,1117,10.1,0.91,0.92
11,459,77,1114,3,1.52,1117,10.1,0.91,0.92
7,259,52,1155,12,6.18,1167,25.6,0.88,0.9
7,259,52,1155,12,6.18,1167,25.6,0.88,0.9
7,259,52,1155,12,6.18,1167,25.6,0.88,0.9
7,259,52,1155,12,6.18,1167,25.6,0.88,0.9
7,259,52,1155,12,6.18,1167,25.6,0.88,0.9
7,259,52,1155,12,6.18,1167,25.6,0.88,0.9
11,477,77,1149,9,4.26,1158,19.77,0.89,0.91
11,477,77,1149,9,4.26,1158,19.77,0.89,0.91
11,477,77,1149,9,4.26,1158,19.77,0.89,0.91
11,477,77,1149,9,4.26,1158,19.77,0.89,0.91
11,477,77,1149,9,4.26,1158,19.77,0.89,0.91
11,477,77,1149,9,4.26,1158,19.77,0.89,0.91
11,293,77,1185,16,8.08,1201,32.18,0.86,0.9
11,293,77,1185,16,8.08,1201,32.18,0.86,0.9
11,293,77,1185,16,8.08,1201,32.18,0.86,0.9
11,293,77,1185,16,8.08,1201,32.18,0.86,0.9
11,293,77,1185,16,8.08,1201,32.18,0.86,0.9
11,293,77,1185,16,8.08,1201,32.18,0.86,0.9
7,351,52,1201,15,7.57,1216,30.48,0.87,0.9
7,351,52,1201,15,7.57,1216,30.48,0.87,0.9
7,351,52,1201,15,7.57,1216,30.48,0.87,0.9
7,351,52,1201,15,7.57,1216,30.48,0.87,0.9
7,351,52,1201,15,7.57,1216,30.48,0.87,0.9
7,351,52,1201,15,7.57,1216,30.48,0.87,0.9
7,613,52,1255,17,8.51,1272,33.74,0.86,0.9
7,613,52,1255,17,8.51,1272,33.74,0.86,0.9
7,613,52,1255,17,8.51,1272,33.74,0.86,0.9
7,613,52,1255,17,8.51,1272,33.74,0.86,0.9
7,613,52,1255,17,8.51,1272,33.74,0.86,0.9
7,613,52,1255,17,8.51,1272,33.74,0.86,0.9
11,646,77,1246,22,11.13,1268,42.42,0.84,0.89
11,646,77,1246,22,11.13,1268,42.42,0.84,0.89
11,646,77,1246,22,11.13,1268,42.42,0.84,0.89
11,646,77,1246,22,11.13,1268,42.42,0.84,0.89
11,646,77,1246,22,11.13,1268,42.42,0.84,0.89
11,646,77,1246,22,11.13,1268,42.42,0.84,0.89
7,602,52,1267,6,3.09,1273,15.31,0.9,0.91
7,602,52,1267,6,3.09,1273,15.31,0.9,0.91
7,602,52,1267,6,3.09,1273,15.31,0.9,0.91
7,602,52,1267,6,3.09,1273,15.31,0.9,0.91
7,602,52,1267,6,3.09,1273,15.31,0.9,0.91
7,602,52,1267,6,3.09,1273,15.31,0.9,0.91
7,682,52,1299,7,3.41,1306,16.68,0.9,0.91
7,682,52,1299,7,3.41,1306,16.68,0.9,0.91
7,682,52,1299,7,3.41,1306,16.68,0.9,0.91
7,682,52,1299,7,3.41,1306,16.68,0.9,0.91
7,682,52,1299,7,3.41,1306,16.68,0.9,0.91
7,682,52,1299,7,3.41,1306,16.68,0.9,0.91
7,614,52,1349,5,2.58,1354,13.59,0.9,0.91
7,614,52,1349,5,2.58,1354,13.59,0.9,0.91
7,614,52,1349,5,2.58,1354,13.59,0.9,0.91
7,614,52,1349,5,2.58,1354,13.59,0.9,0.91
7,614,52,1349,5,2.58,1354,13.59,0.9,0.91
7,614,52,1349,5,2.58,1354,13.59,0.9,0.91
7,554,52,1367,8,4.19,1375,18.86,0.89,0.91
7,554,52,1367,8,4.19,1375,18.86,0.89,0.91
7,554,52,1367,8,4.19,1375,18.86,0.89,0.91
7,554,52,1367,8,4.19,1375,18.86,0.89,0.91
7,554,52,1367,8,4.19,1375,18.86,0.89,0.91
7,554,52,1367,8,4.19,1375,18.86,0.89,0.91
12,816,79,49,8,3.88,57,18.3,0.89,0.91
12,816,79,49,8,3.88,57,18.3,0.89,0.91
12,816,79,49,8,3.88,57,18.3,0.89,0.91
12,816,79,49,8,3.88,57,18.3,0.89,0.91
12,816,79,49,8,3.88,57,18.3,0.89,0.91
12,816,79,49,8,3.88,57,18.3,0.89,0.91
12,816,79,49,8,3.88,57,18.3,0.89,0.91
13,788,59,113,8,4.08,121,18.67,0.89,0.91
13,788,59,113,8,4.08,121,18.67,0.89,0.91
13,788,59,113,8,4.08,121,18.67,0.89,0.91
13,788,59,113,8,4.08,121,18.67,0.89,0.91
13,788,59,113,8,4.08,121,18.67,0.89,0.91
13,788,59,113,8,4.08,121,18.67,0.89,0.91
13,788,59,113,8,4.08,121,18.67,0.89,0.91
1,805,33,140,14,6.87,154,28.42,0.87,0.9
1,805,33,140,14,6.87,154,28.42,0.87,0.9
1,805,33,140,14,6.87,154,28.42,0.87,0.9
1,805,33,140,14,6.87,154,28.42,0.87,0.9
1,805,33,140,14,6.87,154,28.42,0.87,0.9
1,805,33,140,14,6.87,154,28.42,0.87,0.9
1,805,33,140,14,6.87,154,28.42,0.87,0.9
1,755,33,152,1,0.6000000000000001,153,6.86,0.91,0.92
1,755,33,152,1,0.6000000000000001,153,6.86,0.91,0.92
1,755,33,152,1,0.6000000000000001,153,6.86,0.91,0.92
1,755,33,152,1,0.6000000000000001,153,6.86,0.91,0.92
1,755,33,152,1,0.6000000000000001,153,6.86,0.91,0.92
1,755,33,152,1,0.6000000000000001,153,6.86,0.91,0.92
1,755,33,152,1,0.6000000000000001,153,6.86,0.91,0.92
13,764,59,155,14,6.94,169,28.55,0.87,0.9
13,764,59,155,14,6.94,169,28.55,0.87,0.9
13,764,59,155,14,6.94,169,28.55,0.87,0.9
13,764,59,155,14,6.94,169,28.55,0.87,0.9
13,764,59,155,14,6.94,169,28.55,0.87,0.9
13,764,59,155,14,6.94,169,28.55,0.87,0.9
13,764,59,155,14,6.94,169,28.55,0.87,0.9
1,918,33,195,19,9.75,214,37.56,0.85,0.89
1,918,33,195,19,9.75,214,37.56,0.85,0.89
1,918,33,195,19,9.75,214,37.56,0.85,0.89
1,918,33,195,19,9.75,214,37.56,0.85,0.89
1,918,33,195,19,9.75,214,37.56,0.85,0.89
1,918,33,195,19,9.75,214,37.56,0.85,0.89
1,918,33,195,19,9.75,214,37.56,0.85,0.89
7,783,38,190,12,5.76,202,24.85,0.88,0.9
7,783,38,190,12,5.76,202,24.85,0.88,0.9
7,783,38,190,12,5.76,202,24.85,0.88,0.9
7,783,38,190,12,5.76,202,24.85,0.88,0.9
7,783,38,190,12,5.76,202,24.85,0.88,0.9
7,783,38,190,12,5.76,202,24.85,0.88,0.9
7,783,38,190,12,5.76,202,24.85,0.88,0.9
1,963,33,222,4,1.84,226,11.46,0.91,0.92
1,963,33,222,4,1.84,226,11.46,0.91,0.92
1,963,33,222,4,1.84,226,11.46,0.91,0.92
1,963,33,222,4,1.84,226,11.46,0.91,0.92
1,963,33,222,4,1.84,226,11.46,0.91,0.92
1,963,33,222,4,1.84,226,11.46,0.91,0.92
1,963,33,222,4,1.84,226,11.46,0.91,0.92
13,757,59,249,7,3.34,256,16.55,0.9,0.91
13,757,59,249,7,3.34,256,16.55,0.9,0.91
13,757,59,249,7,3.34,256,16.55,0.9,0.91
13,757,59,249,7,3.34,256,16.55,0.9,0.91
13,757,59,249,7,3.34,256,16.55,0.9,0.91
13,757,59,249,7,3.34,256,16.55,0.9,0.91
13,757,59,249,7,3.34,256,16.55,0.9,0.91
7,965,38,295,17,8.47,312,33.68,0.86,0.9
7,965,38,295,17,8.47,312,33.68,0.86,0.9
7,965,38,295,17,8.47,312,33.68,0.86,0.9
7,965,38,295,17,8.47,312,33.68,0.86,0.9
7,965,38,295,17,8.47,312,33.68,0.86,0.9
7,965,38,295,17,8.47,312,33.68,0.86,0.9
7,965,38,295,17,8.47,312,33.68,0.86,0.9
1,163,33,324,13,6.59,337,27.14,0.88,0.9
1,163,33,324,13,6.59,337,27.14,0.88,0.9
1,163,33,324,13,6.59,337,27.14,0.88,0.9
1,163,33,324,13,6.59,337,27.14,0.88,0.9
1,163,33,324,13,6.59,337,27.14,0.88,0.9
1,163,33,324,13,6.59,337,27.14,0.88,0.9
1,163,33,324,13,6.59,337,27.14,0.88,0.9
10,918,31,328,13,6.27,341,26.55,0.88,0.9
10,918,31,328,13,6.27,341,26.55,0.88,0.9
10,918,31,328,13,6.27,341,26.55,0.88,0.9
10,918,31,328,13,6.27,341,26.55,0.88,0.9
10,918,31,328,13,6.27,341,26.55,0.88,0.9
10,918,31,328,13,6.27,341,26.55,0.88,0.9
10,918,31,328,13,6.27,341,26.55,0.88,0.9
13,887,59,317,10,4.78,327,21.5,0.89,0.91
13,887,59,317,10,4.78,327,21.5,0.89,0.91
13,887,59,317,10,4.78,327,21.5,0.89,0.91
13,887,59,317,10,4.78,327,21.5,0.89,0.91
13,887,59,317,10,4.78,327,21.5,0.89,0.91
13,887,59,317,10,4.78,327,21.5,0.89,0.91
13,887,59,317,10,4.78,327,21.5,0.89,0.91
1,46,33,353,18,9.2,371,35.78,0.86,0.89
1,46,33,353,18,9.2,371,35.78,0.86,0.89
1,46,33,353,18,9.2,371,35.78,0.86,0.89
1,46,33,353,18,9.2,371,35.78,0.86,0.89
1,46,33,353,18,9.2,371,35.78,0.86,0.89
1,46,33,353,18,9.2,371,35.78,0.86,0.89
1,46,33,353,18,9.2,371,35.78,0.86,0.89
0,222,9,377,16,7.84,393,31.75,0.87,0.9
0,222,9,377,16,7.84,393,31.75,0.87,0.9
0,222,9,377,16,7.84,393,31.75,0.87,0.9
0,222,9,377,16,7.84,393,31.75,0.87,0.9
0,222,9,377,16,7.84,393,31.75,0.87,0.9
0,222,9,377,16,7.84,393,31.75,0.87,0.9
0,222,9,377,16,7.84,393,31.75,0.87,0.9
1,760,33,361,13,6.32,374,26.65,0.88,0.9
1,760,33,361,13,6.32,374,26.65,0.88,0.9
1,760,33,361,13,6.32,374,26.65,0.88,0.9
1,760,33,361,13,6.32,374,26.65,0.88,0.9
1,760,33,361,13,6.32,374,26.65,0.88,0.9
1,760,33,361,13,6.32,374,26.65,0.88,0.9
1,760,33,361,13,6.32,374,26.65,0.88,0.9
7,809,38,362,6,2.99,368,15.13,0.9,0.91
7,809,38,362,6,2.99,368,15.13,0.9,0.91
7,809,38,362,6,2.99,368,15.13,0.9,0.91
7,809,38,362,6,2.99,368,15.13,0.9,0.91
7,809,38,362,6,2.99,368,15.13,0.9,0.91
7,809,38,362,6,2.99,368,15.13,0.9,0.91
7,809,38,362,6,2.99,368,15.13,0.9,0.91
10,791,31,365,8,3.88,373,18.31,0.89,0.91
10,791,31,365,8,3.88,373,18.31,0.89,0.91
10,791,31,365,8,3.88,373,18.31,0.89,0.91
10,791,31,365,8,3.88,373,18.31,0.89,0.91
10,791,31,365,8,3.88,373,18.31,0.89,0.91
10,791,31,365,8,3.88,373,18.31,0.89,0.91
10,791,31,365,8,3.88,373,18.31,0.89,0.91
0,147,9,396,9,4.28,405,19.81,0.89,0.91
0,147,9,396,9,4.28,405,19.81,0.89,0.91
0,147,9,396,9,4.28,405,19.81,0.89,0.91
0,147,9,396,9,4.28,405,19.81,0.89,0.91
0,147,9,396,9,4.28,405,19.81,0.89,0.91
0,147,9,396,9,4.28,405,19.81,0.89,0.91
0,147,9,396,9,4.28,405,19.81,0.89,0.91
1,980,33,410,22,10.75,432,41.73,0.84,0.89
1,980,33,410,22,10.75,432,41.73,0.84,0.89
1,980,33,410,22,10.75,432,41.73,0.84,0.89
1,980,33,410,22,10.75,432,41.73,0.84,0.89
1,980,33,410,22,10.75,432,41.73,0.84,0.89
1,980,33,410,22,10.75,432,41.73,0.84,0.89
1,980,33,410,22,10.75,432,41.73,0.84,0.89
7,127,38,413,14,6.96,427,28.59,0.87,0.9
7,127,38,413,14,6.96,427,28.59,0.87,0.9
7,127,38,413,14,6.96,427,28.59,0.87,0.9
7,127,38,413,14,6.96,427,28.59,0.87,0.9
7,127,38,413,14,6.96,427,28.59,0.87,0.9
7,127,38,413,14,6.96,427,28.59,0.87,0.9
7,127,38,413,14,6.96,427,28.59,0.87,0.9
10,98,31,394,7,3.59,401,17.0,0.9,0.91
10,98,31,394,7,3.59,401,17.0,0.9,0.91
10,98,31,394,7,3.59,401,17.0,0.9,0.91
10,98,31,394,7,3.59,401,17.0,0.9,0.91
10,98,31,394,7,3.59,401,17.0,0.9,0.91
10,98,31,394,7,3.59,401,17.0,0.9,0.91
10,98,31,394,7,3.59,401,17.0,0.9,0.91
13,19,59,414,15,7.73,429,30.77,0.87,0.9
13,19,59,414,15,7.73,429,30.77,0.87,0.9
13,19,59,414,15,7.73,429,30.77,0.87,0.9
13,19,59,414,15,7.73,429,30.77,0.87,0.9
13,19,59,414,15,7.73,429,30.77,0.87,0.9
13,19,59,414,15,7.73,429,30.77,0.87,0.9
13,19,59,414,15,7.73,429,30.77,0.87,0.9
0,9,9,427,6,3.24,433,15.58,0.9,0.91
0,9,9,427,6,3.24,433,15.58,0.9,0.91
0,9,9,427,6,3.24,433,15.58,0.9,0.91
0,9,9,427,6,3.24,433,15.58,0.9,0.91
0,9,9,427,6,3.24,433,15.58,0.9,0.91
0,9,9,427,6,3.24,433,15.58,0.9,0.91
0,9,9,427,6,3.24,433,15.58,0.9,0.91
1,46,33,433,4,1.8,437,11.39,0.91,0.92
1,46,33,433,4,1.8,437,11.39,0.91,0.92
1,46,33,433,4,1.8,437,11.39,0.91,0.92
1,46,33,433,4,1.8,437,11.39,0.91,0.92
1,46,33,433,4,1.8,437,11.39,0.91,0.92
1,46,33,433,4,1.8,437,11.39,0.91,0.92
1,46,33,433,4,1.8,437,11.39,0.91,0.92
3,112,10,442,6,3.15,448,15.42,0.9,0.91
3,112,10,442,6,3.15,448,15.42,0.9,0.91
3,112,10,442,6,3.15,448,15.42,0.9,0.91
3,112,10,442,6,3.15,448,15.42,0.9,0.91
3,112,10,442,6,3.15,448,15.42,0.9,0.91
3,112,10,442,6,3.15,448,15.42,0.9,0.91
3,112,10,442,6,3.15,448,15.42,0.9,0.91
4,905,73,444,14,7.14,458,28.91,0.87,0.9
4,905,73,444,14,7.14,458,28.91,0.87,0.9
4,905,73,444,14,7.14,458,28.91,0.87,0.9
4,905,73,444,14,7.14,458,28.91,0.87,0.9
4,905,73,444,14,7.14,458,28.91,0.87,0.9
4,905,73,444,14,7.14,458,28.91,0.87,0.9
4,905,73,444,14,7.14,458,28.91,0.87,0.9
6,892,47,438,10,5.16,448,22.19,0.89,0.91
6,892,47,438,10,5.16,448,22.19,0.89,0.91
6,892,47,438,10,5.16,448,22.19,0.89,0.91
6,892,47,438,10,5.16,448,22.19,0.89,0.91
6,892,47,438,10,5.16,448,22.19,0.89,0.91
6,892,47,438,10,5.16,448,22.19,0.89,0.91
6,892,47,438,10,5.16,448,22.19,0.89,0.91
7,122,38,436,9,4.48,445,20.18,0.89,0.91
7,122,38,436,9,4.48,445,20.18,0.89,0.91
7,122,38,436,9,4.48,445,20.18,0.89,0.91
7,122,38,436,9,4.48,445,20.18,0.89,0.91
7,122,38,436,9,4.48,445,20.18,0.89,0.91
7,122,38,436,9,4.48,445,20.18,0.89,0.91
7,122,38,436,9,4.48,445,20.18,0.89,0.91
10,53,31,435,5,2.75,440,13.9,0.9,0.91
10,53,31,435,5,2.75,440,13.9,0.9,0.91
10,53,31,435,5,2.75,440,13.9,0.9,0.91
10,53,31,435,5,2.75,440,13.9,0.9,0.91
10,53,31,435,5,2.75,440,13.9,0.9,0.91
10,53,31,435,5,2.75,440,13.9,0.9,0.91
10,53,31,435,5,2.75,440,13.9,0.9,0.91
13,46,59,439,12,5.91,451,25.11,0.88,0.9
13,46,59,439,12,5.91,451,25.11,0.88,0.9
13,46,59,439,12,5.91,451,25.11,0.88,0.9
13,46,59,439,12,5.91,451,25.11,0.88,0.9
13,46,59,439,12,5.91,451,25.11,0.88,0.9
13,46,59,439,12,5.91,451,25.11,0.88,0.9
13,46,59,439,12,5.91,451,25.11,0.88,0.9
14,247,76,433,6,2.88,439,14.93,0.9,0.91
14,247,76,433,6,2.88,439,14.93,0.9,0.91
14,247,76,433,6,2.88,439,14.93,0.9,0.91
14,247,76,433,6,2.88,439,14.93,0.9,0.91
14,247,76,433,6,2.88,439,14.93,0.9,0.91
14,247,76,433,6,2.88,439,14.93,0.9,0.91
14,247,76,433,6,2.88,439,14.93,0.9,0.91
0,42,9,467,8,4.06,475,18.63,0.89,0.91
0,42,9,467,8,4.06,475,18.63,0.89,0.91
0,42,9,467,8,4.06,475,18.63,0.89,0.91
0,42,9,467,8,4.06,475,18.63,0.89,0.91
0,42,9,467,8,4.06,475,18.63,0.89,0.91
0,42,9,467,8,4.06,475,18.63,0.89,0.91
0,42,9,467,8,4.06,475,18.63,0.89,0.91
1,8,33,450,7,3.32,457,16.51,0.9,0.91
1,8,33,450,7,3.32,457,16.51,0.9,0.91
1,8,33,450,7,3.32,457,16.51,0.9,0.91
1,8,33,450,7,3.32,457,16.51,0.9,0.91
1,8,33,450,7,3.32,457,16.51,0.9,0.91
1,8,33,450,7,3.32,457,16.51,0.9,0.91
1,8,33,450,7,3.32,457,16.51,0.9,0.91
3,122,10,466,8,3.99,474,18.51,0.89,0.91
3,122,10,466,8,3.99,474,18.51,0.89,0.91
3,122,10,466,8,3.99,474,18.51,0.89,0.91
3,122,10,466,8,3.99,474,18.51,0.89,0.91
3,122,10,466,8,3.99,474,18.51,0.89,0.91
3,122,10,466,8,3.99,474,18.51,0.89,0.91
3,122,10,466,8,3.99,474,18.51,0.89,0.91
4,13,73,461,12,6.07,473,25.4,0.88,0.9
4,13,73,461,12,6.07,473,25.4,0.88,0.9
4,13,73,461,12,6.07,473,25.4,0.88,0.9
4,13,73,461,12,6.07,473,25.4,0.88,0.9
4,13,73,461,12,6.07,473,25.4,0.88,0.9
4,13,73,461,12,6.07,473,25.4,0.88,0.9
4,13,73,461,12,6.07,473,25.4,0.88,0.9
6,119,47,456,13,6.48,469,26.94,0.88,0.9
6,119,47,456,13,6.48,469,26.94,0.88,0.9
6,119,47,456,13,6.48,469,26.94,0.88,0.9
6,119,47,456,13,6.48,469,26.94,0.88,0.9
6,119,47,456,13,6.48,469,26.94,0.88,0.9
6,119,47,456,13,6.48,469,26.94,0.88,0.9
6,119,47,456,13,6.48,469,26.94,0.88,0.9
7,28,38,478,10,4.95,488,21.81,0.89,0.91
7,28,38,478,10,4.95,488,21.81,0.89,0.91
7,28,38,478,10,4.95,488,21.81,0.89,0.91
7,28,38,478,10,4.95,488,21.81,0.89,0.91
7,28,38,478,10,4.95,488,21.81,0.89,0.91
7,28,38,478,10,4.95,488,21.81,0.89,0.91
7,28,38,478,10,4.95,488,21.81,0.89,0.91
10,99,31,465,5,2.33,470,13.14,0.9,0.91
10,99,31,465,5,2.33,470,13.14,0.9,0.91
10,99,31,465,5,2.33,470,13.14,0.9,0.91
10,99,31,465,5,2.33,470,13.14,0.9,0.91
10,99,31,465,5,2.33,470,13.14,0.9,0.91
10,99,31,465,5,2.33,470,13.14,0.9,0.91
10,99,31,465,5,2.33,470,13.14,0.9,0.91
13,11,59,462,2,1.06,464,8.49,0.91,0.92
13,11,59,462,2,1.06,464,8.49,0.91,0.92
13,11,59,462,2,1.06,464,8.49,0.91,0.92
13,11,59,462,2,1.06,464,8.49,0.91,0.92
13,11,59,462,2,1.06,464,8.49,0.91,0.92
13,11,59,462,2,1.06,464,8.49,0.91,0.92
13,11,59,462,2,1.06,464,8.49,0.91,0.92
14,159,76,465,10,4.88,475,21.69,0.89,0.91
14,159,76,465,10,4.88,475,21.69,0.89,0.91
14,159,76,465,10,4.88,475,21.69,0.89,0.91
14,159,76,465,10,4.88,475,21.69,0.89,0.91
14,159,76,465,10,4.88,475,21.69,0.89,0.91
14,159,76,465,10,4.88,475,21.69,0.89,0.91
14,159,76,465,10,4.88,475,21.69,0.89,0.91
1,103,33,494,3,1.48,497,10.03,0.91,0.92
1,103,33,494,3,1.48,497,10.03,0.91,0.92
1,103,33,494,3,1.48,497,10.03,0.91,0.92
1,103,33,494,3,1.48,497,10.03,0.91,0.92
1,103,33,494,3,1.48,497,10.03,0.91,0.92
1,103,33,494,3,1.48,497,10.03,0.91,0.92
1,103,33,494,3,1.48,497,10.03,0.91,0.92
4,32,73,487,7,3.29,494,16.44,0.9,0.91
4,32,73,487,7,3.29,494,16.44,0.9,0.91
4,32,73,487,7,3.29,494,16.44,0.9,0.91
4,32,73,487,7,3.29,494,16.44,0.9,0.91
4,32,73,487,7,3.29,494,16.44,0.9,0.91
4,32,73,487,7,3.29,494,16.44,0.9,0.91
4,32,73,487,7,3.29,494,16.44,0.9,0.91
7,154,38,505,8,4.14,513,18.77,0.89,0.91
7,154,38,505,8,4.14,513,18.77,0.89,0.91
7,154,38,505,8,4.14,513,18.77,0.89,0.91
7,154,38,505,8,4.14,513,18.77,0.89,0.91
7,154,38,505,8,4.14,513,18.77,0.89,0.91
7,154,38,505,8,4.14,513,18.77,0.89,0.91
7,154,38,505,8,4.14,513,18.77,0.89,0.91
10,140,31,490,12,5.77,502,24.85,0.88,0.9
10,140,31,490,12,5.77,502,24.85,0.88,0.9
10,140,31,490,12,5.77,502,24.85,0.88,0.9
10,140,31,490,12,5.77,502,24.85,0.88,0.9
10,140,31,490,12,5.77,502,24.85,0.88,0.9
10,140,31,490,12,5.77,502,24.85,0.88,0.9
10,140,31,490,12,5.77,502,24.85,0.88,0.9
13,19,59,496,14,6.89,510,28.47,0.87,0.9
13,19,59,496,14,6.89,510,28.47,0.87,0.9
13,19,59,496,14,6.89,510,28.47,0.87,0.9
13,19,59,496,14,6.89,510,28.47,0.87,0.9
13,19,59,496,14,6.89,510,28.47,0.87,0.9
13,19,59,496,14,6.89,510,28.47,0.87,0.9
13,19,59,496,14,6.89,510,28.47,0.87,0.9
14,214,76,490,5,2.44,495,13.33,0.9,0.91
14,214,76,490,5,2.44,495,13.33,0.9,0.91
14,214,76,490,5,2.44,495,13.33,0.9,0.91
14,214,76,490,5,2.44,495,13.33,0.9,0.91
14,214,76,490,5,2.44,495,13.33,0.9,0.91
14,214,76,490,5,2.44,495,13.33,0.9,0.91
14,214,76,490,5,2.44,495,13.33,0.9,0.91
1,35,33,520,7,3.46,527,16.75,0.9,0.91
1,35,33,520,7,3.46,527,16.75,0.9,0.91
1,35,33,520,7,3.46,527,16.75,0.9,0.91
1,35,33,520,7,3.46,527,16.75,0.9,0.91
1,35,33,520,7,3.46,527,16.75,0.9,0.91
1,35,33,520,7,3.46,527,16.75,0.9,0.91
1,35,33,520,7,3.46,527,16.75,0.9,0.91
4,775,73,512,8,3.93,520,18.39,0.89,0.91
4,775,73,512,8,3.93,520,18.39,0.89,0.91
4,775,73,512,8,3.93,520,18.39,0.89,0.91
4,775,73,512,8,3.93,520,18.39,0.89,0.91
4,775,73,512,8,3.93,520,18.39,0.89,0.91
4,775,73,512,8,3.93,520,18.39,0.89,0.91
4,775,73,512,8,3.93,520,18.39,0.89,0.91
6,63,47,534,0,0.14,534,5.25,0.92,0.92
6,63,47,534,0,0.14,534,5.25,0.92,0.92
6,63,47,534,0,0.14,534,5.25,0.92,0.92
6,63,47,534,0,0.14,534,5.25,0.92,0.92
6,63,47,534,0,0.14,534,5.25,0.92,0.92
6,63,47,534,0,0.14,534,5.25,0.92,0.92
6,63,47,534,0,0.14,534,5.25,0.92,0.92
7,6,38,527,13,6.69,540,27.32,0.88,0.9
7,6,38,527,13,6.69,540,27.32,0.88,0.9
7,6,38,527,13,6.69,540,27.32,0.88,0.9
7,6,38,527,13,6.69,540,27.32,0.88,0.9
7,6,38,527,13,6.69,540,27.32,0.88,0.9
7,6,38,527,13,6.69,540,27.32,0.88,0.9
7,6,38,527,13,6.69,540,27.32,0.88,0.9
10,238,31,528,15,7.57,543,30.48,0.87,0.9
10,238,31,528,15,7.57,543,30.48,0.87,0.9
10,238,31,528,15,7.57,543,30.48,0.87,0.9
10,238,31,528,15,7.57,543,30.48,0.87,0.9
10,238,31,528,15,7.57,543,30.48,0.87,0.9
10,238,31,528,15,7.57,543,30.48,0.87,0.9
10,238,31,528,15,7.57,543,30.48,0.87,0.9
13,150,59,537,9,4.31,546,19.87,0.89,0.91
13,150,59,537,9,4.31,546,19.87,0.89,0.91
13,150,59,537,9,4.31,546,19.87,0.89,0.91
13,150,59,537,9,4.31,546,19.87,0.89,0.91
13,150,59,537,9,4.31,546,19.87,0.89,0.91
13,150,59,537,9,4.31,546,19.87,0.89,0.91
13,150,59,537,9,4.31,546,19.87,0.89,0.91
14,99,76,527,15,7.51,542,30.36,0.87,0.9
14,99,76,527,15,7.51,542,30.36,0.87,0.9
14,99,76,527,15,7.51,542,30.36,0.87,0.9
14,99,76,527,15,7.51,542,30.36,0.87,0.9
14,99,76,527,15,7.51,542,30.36,0.87,0.9
14,99,76,527,15,7.51,542,30.36,0.87,0.9
14,99,76,527,15,7.51,542,30.36,0.87,0.9
1,99,33,555,14,7.19,569,29.01,0.87,0.9
1,99,33,555,14,7.19,569,29.01,0.87,0.9
1,99,33,555,14,7.19,569,29.01,0.87,0.9
1,99,33,555,14,7.19,569,29.01,0.87,0.9
1,99,33,555,14,7.19,569,29.01,0.87,0.9
1,99,33,555,14,7.19,569,29.01,0.87,0.9
1,99,33,555,14,7.19,569,29.01,0.87,0.9
2,235,72,569,11,5.44,580,23.47,0.88,0.91
2,235,72,569,11,5.44,580,23.47,0.88,0.91
2,235,72,569,11,5.44,580,23.47,0.88,0.91
2,235,72,569,11,5.44,580,23.47,0.88,0.91
2,235,72,569,11,5.44,580,23.47,0.88,0.91
2,235,72,569,11,5.44,580,23.47,0.88,0.91
2,235,72,569,11,5.44,580,23.47,0.88,0.91
4,59,73,548,8,3.99,556,18.5,0.89,0.91
4,59,73,548,8,3.99,556,18.5,0.89,0.91
4,59,73,548,8,3.99,556,18.5,0.89,0.91
4,59,73,548,8,3.99,556,18.5,0.89,0.91
4,59,73,548,8,3.99,556,18.5,0.89,0.91
4,59,73,548,8,3.99,556,18.5,0.89,0.91
4,59,73,548,8,3.99,556,18.5,0.89,0.91
5,177,49,555,3,1.4,558,9.88,0.91,0.92
5,177,49,555,3,1.4,558,9.88,0.91,0.92
5,177,49,555,3,1.4,558,9.88,0.91,0.92
5,177,49,555,3,1.4,558,9.88,0.91,0.92
5,177,49,555,3,1.4,558,9.88,0.91,0.92
5,177,49,555,3,1.4,558,9.88,0.91,0.92
5,177,49,555,3,1.4,558,9.88,0.91,0.92
7,34,38,551,15,7.73,566,30.77,0.87,0.9
7,34,38,551,15,7.73,566,30.77,0.87,0.9
7,34,38,551,15,7.73,566,30.77,0.87,0.9
7,34,38,551,15,7.73,566,30.77,0.87,0.9
7,34,38,551,15,7.73,566,30.77,0.87,0.9
7,34,38,551,15,7.73,566,30.77,0.87,0.9
7,34,38,551,15,7.73,566,30.77,0.87,0.9
11,212,54,542,8,4.17,550,18.83,0.89,0.91
11,212,54,542,8,4.17,550,18.83,0.89,0.91
11,212,54,542,8,4.17,550,18.83,0.89,0.91
11,212,54,542,8,4.17,550,18.83,0.89,0.91
11,212,54,542,8,4.17,550,18.83,0.89,0.91
11,212,54,542,8,4.17,550,18.83,0.89,0.91
11,212,54,542,8,4.17,550,18.83,0.89,0.91
1,117,33,571,8,3.94,579,18.41,0.89,0.91
1,117,33,571,8,3.94,579,18.41,0.89,0.91
1,117,33,571,8,3.94,579,18.41,0.89,0.91
1,117,33,571,8,3.94,579,18.41,0.89,0.91
1,117,33,571,8,3.94,579,18.41,0.89,0.91
1,117,33,571,8,3.94,579,18.41,0.89,0.91
1,117,33,571,8,3.94,579,18.41,0.89,0.91
5,127,49,579,9,4.3,588,19.84,0.89,0.91
5,127,49,579,9,4.3,588,19.84,0.89,0.91
5,127,49,579,9,4.3,588,19.84,0.89,0.91
5,127,49,579,9,4.3,588,19.84,0.89,0.91
5,127,49,579,9,4.3,588,19.84,0.89,0.91
5,127,49,579,9,4.3,588,19.84,0.89,0.91
5,127,49,579,9,4.3,588,19.84,0.89,0.91
7,171,38,581,16,7.81,597,31.69,0.87,0.9
7,171,38,581,16,7.81,597,31.69,0.87,0.9
7,171,38,581,16,7.81,597,31.69,0.87,0.9
7,171,38,581,16,7.81,597,31.69,0.87,0.9
7,171,38,581,16,7.81,597,31.69,0.87,0.9
7,171,38,581,16,7.81,597,31.69,0.87,0.9
7,171,38,581,16,7.81,597,31.69,0.87,0.9
10,246,31,589,5,2.3,594,13.09,0.9,0.91
10,246,31,589,5,2.3,594,13.09,0.9,0.91
10,246,31,589,5,2.3,594,13.09,0.9,0.91
10,246,31,589,5,2.3,594,13.09,0.9,0.91
10,246,31,589,5,2.3,594,13.09,0.9,0.91
10,246,31,589,5,2.3,594,13.09,0.9,0.91
10,246,31,589,5,2.3,594,13.09,0.9,0.91
11,82,54,596,5,2.68,601,13.79,0.9,0.91
11,82,54,596,5,2.68,601,13.79,0.9,0.91
11,82,54,596,5,2.68,601,13.79,0.9,0.91
11,82,54,596,5,2.68,601,13.79,0.9,0.91
11,82,54,596,5,2.68,601,13.79,0.9,0.91
11,82,54,596,5,2.68,601,13.79,0.9,0.91
11,82,54,596,5,2.68,601,13.79,0.9,0.91
2,912,72,628,12,6.04,640,25.36,0.88,0.9
2,912,72,628,12,6.04,640,25.36,0.88,0.9
2,912,72,628,12,6.04,640,25.36,0.88,0.9
2,912,72,628,12,6.04,640,25.36,0.88,0.9
2,912,72,628,12,6.04,640,25.36,0.88,0.9
2,912,72,628,12,6.04,640,25.36,0.88,0.9
2,912,72,628,12,6.04,640,25.36,0.88,0.9
7,778,38,619,4,2.01,623,11.78,0.91,0.92
7,778,38,619,4,2.01,623,11.78,0.91,0.92
7,778,38,619,4,2.01,623,11.78,0.91,0.92
7,778,38,619,4,2.01,623,11.78,0.91,0.92
7,778,38,619,4,2.01,623,11.78,0.91,0.92
7,778,38,619,4,2.01,623,11.78,0.91,0.92
7,778,38,619,4,2.01,623,11.78,0.91,0.92
1,998,33,658,6,3.03,664,15.19,0.9,0.91
1,998,33,658,6,3.03,664,15.19,0.9,0.91
1,998,33,658,6,3.03,664,15.19,0.9,0.91
1,998,33,658,6,3.03,664,15.19,0.9,0.91
1,998,33,658,6,3.03,664,15.19,0.9,0.91
1,998,33,658,6,3.03,664,15.19,0.9,0.91
1,998,33,658,6,3.03,664,15.19,0.9,0.91
4,810,73,645,5,2.49,650,13.43,0.9,0.91
4,810,73,645,5,2.49,650,13.43,0.9,0.91
4,810,73,645,5,2.49,650,13.43,0.9,0.91
4,810,73,645,5,2.49,650,13.43,0.9,0.91
4,810,73,645,5,2.49,650,13.43,0.9,0.91
4,810,73,645,5,2.49,650,13.43,0.9,0.91
4,810,73,645,5,2.49,650,13.43,0.9,0.91
7,808,38,711,2,1.04,713,8.45,0.91,0.92
7,808,38,711,2,1.04,713,8.45,0.91,0.92
7,808,38,711,2,1.04,713,8.45,0.91,0.92
7,808,38,711,2,1.04,713,8.45,0.91,0.92
7,808,38,711,2,1.04,713,8.45,0.91,0.92
7,808,38,711,2,1.04,713,8.45,0.91,0.92
7,808,38,711,2,1.04,713,8.45,0.91,0.92
10,834,31,718,7,3.56,725,16.94,0.9,0.91
10,834,31,718,7,3.56,725,16.94,0.9,0.91
10,834,31,718,7,3.56,725,16.94,0.9,0.91
10,834,31,718,7,3.56,725,16.94,0.9,0.91
10,834,31,718,7,3.56,725,16.94,0.9,0.91
10,834,31,718,7,3.56,725,16.94,0.9,0.91
10,834,31,718,7,3.56,725,16.94,0.9,0.91
4,791,73,780,12,6.09,792,25.45,0.88,0.9
4,791,73,780,12,6.09,792,25.45,0.88,0.9
4,791,73,780,12,6.09,792,25.45,0.88,0.9
4,791,73,780,12,6.09,792,25.45,0.88,0.9
4,791,73,780,12,6.09,792,25.45,0.88,0.9
4,791,73,780,12,6.09,792,25.45,0.88,0.9
4,791,73,780,12,6.09,792,25.45,0.88,0.9
1,782,33,827,14,6.76,841,28.22,0.87,0.9
1,782,33,827,14,6.76,841,28.22,0.87,0.9
1,782,33,827,14,6.76,841,28.22,0.87,0.9
1,782,33,827,14,6.76,841,28.22,0.87,0.9
1,782,33,827,14,6.76,841,28.22,0.87,0.9
1,782,33,827,14,6.76,841,28.22,0.87,0.9
1,782,33,827,14,6.76,841,28.22,0.87,0.9
4,884,73,827,15,7.46,842,30.29,0.87,0.9
4,884,73,827,15,7.46,842,30.29,0.87,0.9
4,884,73,827,15,7.46,842,30.29,0.87,0.9
4,884,73,827,15,7.46,842,30.29,0.87,0.9
4,884,73,827,15,7.46,842,30.29,0.87,0.9
4,884,73,827,15,7.46,842,30.29,0.87,0.9
4,884,73,827,15,7.46,842,30.29,0.87,0.9
1,794,33,873,16,7.86,889,31.79,0.87,0.9
1,794,33,873,16,7.86,889,31.79,0.87,0.9
1,794,33,873,16,7.86,889,31.79,0.87,0.9
1,794,33,873,16,7.86,889,31.79,0.87,0.9
1,794,33,873,16,7.86,889,31.79,0.87,0.9
1,794,33,873,16,7.86,889,31.79,0.87,0.9
1,794,33,873,16,7.86,889,31.79,0.87,0.9
5,370,49,897,9,4.73,906,20.62,0.89,0.91
5,370,49,897,9,4.73,906,20.62,0.89,0.91
5,370,49,897,9,4.73,906,20.62,0.89,0.91
5,370,49,897,9,4.73,906,20.62,0.89,0.91
5,370,49,897,9,4.73,906,20.62,0.89,0.91
5,370,49,897,9,4.73,906,20.62,0.89,0.91
5,370,49,897,9,4.73,906,20.62,0.89,0.91
4,986,73,929,19,9.64,948,37.36,0.85,0.89
4,986,73,929,19,9.64,948,37.36,0.85,0.89
4,986,73,929,19,9.64,948,37.36,0.85,0.89
4,986,73,929,19,9.64,948,37.36,0.85,0.89
4,986,73,929,19,9.64,948,37.36,0.85,0.89
4,986,73,929,19,9.64,948,37.36,0.85,0.89
4,986,73,929,19,9.64,948,37.36,0.85,0.89
4,800,73,954,14,6.8,968,28.3,0.87,0.9
4,800,73,954,14,6.8,968,28.3,0.87,0.9
4,800,73,954,14,6.8,968,28.3,0.87,0.9
4,800,73,954,14,6.8,968,28.3,0.87,0.9
4,800,73,954,14,6.8,968,28.3,0.87,0.9
4,800,73,954,14,6.8,968,28.3,0.87,0.9
4,800,73,954,14,6.8,968,28.3,0.87,0.9
6,844,22,930,8,4.17,938,18.83,0.89,0.91
6,844,22,930,8,4.17,938,18.83,0.89,0.91
6,844,22,930,8,4.17,938,18.83,0.89,0.91
6,844,22,930,8,4.17,938,18.83,0.89,0.91
6,844,22,930,8,4.17,938,18.83,0.89,0.91
6,844,22,930,8,4.17,938,18.83,0.89,0.91
6,844,22,930,8,4.17,938,18.83,0.89,0.91
10,851,86,934,10,5.13,944,22.14,0.89,0.91
10,851,86,934,10,5.13,944,22.14,0.89,0.91
10,851,86,934,10,5.13,944,22.14,0.89,0.91
10,851,86,934,10,5.13,944,22.14,0.89,0.91
10,851,86,934,10,5.13,944,22.14,0.89,0.91
10,851,86,934,10,5.13,944,22.14,0.89,0.91
10,851,86,934,10,5.13,944,22.14,0.89,0.91
4,340,73,999,15,7.36,1014,30.09,0.87,0.9
4,340,73,999,15,7.36,1014,30.09,0.87,0.9
4,340,73,999,15,7.36,1014,30.09,0.87,0.9
4,340,73,999,15,7.36,1014,30.09,0.87,0.9
4,340,73,999,15,7.36,1014,30.09,0.87,0.9
4,340,73,999,15,7.36,1014,30.09,0.87,0.9
4,340,73,999,15,7.36,1014,30.09,0.87,0.9
6,374,22,1011,10,5.14,1021,22.15,0.89,0.91
6,374,22,1011,10,5.14,1021,22.15,0.89,0.91
6,374,22,1011,10,5.14,1021,22.15,0.89,0.91
6,374,22,1011,10,5.14,1021,22.15,0.89,0.91
6,374,22,1011,10,5.14,1021,22.15,0.89,0.91
6,374,22,1011,10,5.14,1021,22.15,0.89,0.91
6,374,22,1011,10,5.14,1021,22.15,0.89,0.91
12,463,80,1001,13,6.38,1014,26.76,0.88,0.9
12,463,80,1001,13,6.38,1014,26.76,0.88,0.9
12,463,80,1001,13,6.38,1014,26.76,0.88,0.9
12,463,80,1001,13,6.38,1014,26.76,0.88,0.9
12,463,80,1001,13,6.38,1014,26.76,0.88,0.9
12,463,80,1001,13,6.38,1014,26.76,0.88,0.9
12,463,80,1001,13,6.38,1014,26.76,0.88,0.9
4,406,73,1034,4,1.95,1038,11.67,0.91,0.92
4,406,73,1034,4,1.95,1038,11.67,0.91,0.92
4,406,73,1034,4,1.95,1038,11.67,0.91,0.92
4,406,73,1034,4,1.95,1038,11.67,0.91,0.92
4,406,73,1034,4,1.95,1038,11.67,0.91,0.92
4,406,73,1034,4,1.95,1038,11.67,0.91,0.92
4,406,73,1034,4,1.95,1038,11.67,0.91,0.92
10,413,86,1043,9,4.46,1052,20.14,0.89,0.91
10,413,86,1043,9,4.46,1052,20.14,0.89,0.91
10,413,86,1043,9,4.46,1052,20.14,0.89,0.91
10,413,86,1043,9,4.46,1052,20.14,0.89,0.91
10,413,86,1043,9,4.46,1052,20.14,0.89,0.91
10,413,86,1043,9,4.46,1052,20.14,0.89,0.91
10,413,86,1043,9,4.46,1052,20.14,0.89,0.91
12,368,80,1037,1,0.65,1038,6.96,0.91,0.92
12,368,80,1037,1,0.65,1038,6.96,0.91,0.92
12,368,80,1037,1,0.65,1038,6.96,0.91,0.92
12,368,80,1037,1,0.65,1038,6.96,0.91,0.92
12,368,80,1037,1,0.65,1038,6.96,0.91,0.92
12,368,80,1037,1,0.65,1038,6.96,0.91,0.92
12,368,80,1037,1,0.65,1038,6.96,0.91,0.92
4,396,73,1054,14,6.85,1068,28.39,0.87,0.9
4,396,73,1054,14,6.85,1068,28.39,0.87,0.9
4,396,73,1054,14,6.85,1068,28.39,0.87,0.9
4,396,73,1054,14,6.85,1068,28.39,0.87,0.9
4,396,73,1054,14,6.85,1068,28.39,0.87,0.9
4,396,73,1054,14,6.85,1068,28.39,0.87,0.9
4,396,73,1054,14,6.85,1068,28.39,0.87,0.9
6,278,22,1067,13,6.6,1080,27.15,0.88,0.9
6,278,22,1067,13,6.6,1080,27.15,0.88,0.9
6,278,22,1067,13,6.6,1080,27.15,0.88,0.9
6,278,22,1067,13,6.6,1080,27.15,0.88,0.9
6,278,22,1067,13,6.6,1080,27.15,0.88,0.9
6,278,22,1067,13,6.6,1080,27.15,0.88,0.9
6,278,22,1067,13,6.6,1080,27.15,0.88,0.9
10,272,86,1077,5,2.39,1082,13.24,0.9,0.91
10,272,86,1077,5,2.39,1082,13.24,0.9,0.91
10,272,86,1077,5,2.39,1082,13.24,0.9,0.91
10,272,86,1077,5,2.39,1082,13.24,0.9,0.91
10,272,86,1077,5,2.39,1082,13.24,0.9,0.91
10,272,86,1077,5,2.39,1082,13.24,0.9,0.91
10,272,86,1077,5,2.39,1082,13.24,0.9,0.91
12,306,80,1061,18,9.11,1079,35.63,0.86,0.9
12,306,80,1061,18,9.11,1079,35.63,0.86,0.9
12,306,80,1061,18,9.11,1079,35.63,0.86,0.9
12,306,80,1061,18,9.11,1079,35.63,0.86,0.9
12,306,80,1061,18,9.11,1079,35.63,0.86,0.9
12,306,80,1061,18,9.11,1079,35.63,0.86,0.9
12,306,80,1061,18,9.11,1079,35.63,0.86,0.9
6,342,22,1099,4,2.21,1103,12.15,0.91,0.92
6,342,22,1099,4,2.21,1103,12.15,0.91,0.92
6,342,22,1099,4,2.21,1103,12.15,0.91,0.92
6,342,22,1099,4,2.21,1103,12.15,0.91,0.92
6,342,22,1099,4,2.21,1103,12.15,0.91,0.92
6,342,22,1099,4,2.21,1103,12.15,0.91,0.92
6,342,22,1099,4,2.21,1103,12.15,0.91,0.92
12,295,80,1094,15,7.43,1109,30.22,0.87,0.9
12,295,80,1094,15,7.43,1109,30.22,0.87,0.9
12,295,80,1094,15,7.43,1109,30.22,0.87,0.9
12,295,80,1094,15,7.43,1109,30.22,0.87,0.9
12,295,80,1094,15,7.43,1109,30.22,0.87,0.9
12,295,80,1094,15,7.43,1109,30.22,0.87,0.9
12,295,80,1094,15,7.43,1109,30.22,0.87,0.9
6,299,22,1128,12,6.01,1140,25.29,0.88,0.9
6,299,22,1128,12,6.01,1140,25.29,0.88,0.9
6,299,22,1128,12,6.01,1140,25.29,0.88,0.9
6,299,22,1128,12,6.01,1140,25.29,0.88,0.9
6,299,22,1128,12,6.01,1140,25.29,0.88,0.9
6,299,22,1128,12,6.01,1140,25.29,0.88,0.9
6,299,22,1128,12,6.01,1140,25.29,0.88,0.9
12,280,80,1119,14,7.1,1133,28.84,0.87,0.9
12,280,80,1119,14,7.1,1133,28.84,0.87,0.9
12,280,80,1119,14,7.1,1133,28.84,0.87,0.9
12,280,80,1119,14,7.1,1133,28.84,0.87,0.9
12,280,80,1119,14,7.1,1133,28.84,0.87,0.9
12,280,80,1119,14,7.1,1133,28.84,0.87,0.9
12,280,80,1119,14,7.1,1133,28.84,0.87,0.9
9,299,18,1145,5,2.27,1150,13.02,0.9,0.91
9,299,18,1145,5,2.27,1150,13.02,0.9,0.91
9,299,18,1145,5,2.27,1150,13.02,0.9,0.91
9,299,18,1145,5,2.27,1150,13.02,0.9,0.91
9,299,18,1145,5,2.27,1150,13.02,0.9,0.91
9,299,18,1145,5,2.27,1150,13.02,0.9,0.91
9,299,18,1145,5,2.27,1150,13.02,0.9,0.91
12,406,80,1166,20,9.75,1186,38.35,0.85,0.89
12,406,80,1166,20,9.75,1186,38.35,0.85,0.89
12,406,80,1166,20,9.75,1186,38.35,0.85,0.89
12,406,80,1166,20,9.75,1186,38.35,0.85,0.89
12,406,80,1166,20,9.75,1186,38.35,0.85,0.89
12,406,80,1166,20,9.75,1186,38.35,0.85,0.89
12,406,80,1166,20,9.75,1186,38.35,0.85,0.89
9,987,18,1173,6,2.79,1179,14.75,0.9,0.91
9,987,18,1173,6,2.79,1179,14.75,0.9,0.91
9,987,18,1173,6,2.79,1179,14.75,0.9,0.91
9,987,18,1173,6,2.79,1179,14.75,0.9,0.91
9,987,18,1173,6,2.79,1179,14.75,0.9,0.91
9,987,18,1173,6,2.79,1179,14.75,0.9,0.91
9,987,18,1173,6,2.79,1179,14.75,0.9,0.91
12,537,80,1198,9,4.29,1207,19.83,0.89,0.91
12,537,80,1198,9,4.29,1207,19.83,0.89,0.91
12,537,80,1198,9,4.29,1207,19.83,0.89,0.91
12,537,80,1198,9,4.29,1207,19.83,0.89,0.91
12,537,80,1198,9,4.29,1207,19.83,0.89,0.91
12,537,80,1198,9,4.29,1207,19.83,0.89,0.91
12,537,80,1198,9,4.29,1207,19.83,0.89,0.91
9,543,18,1214,8,3.81,1222,18.17,0.89,0.91
9,543,18,1214,8,3.81,1222,18.17,0.89,0.91
9,543,18,1214,8,3.81,1222,18.17,0.89,0.91
9,543,18,1214,8,3.81,1222,18.17,0.89,0.91
9,543,18,1214,8,3.81,1222,18.17,0.89,0.91
9,543,18,1214,8,3.81,1222,18.17,0.89,0.91
9,543,18,1214,8,3.81,1222,18.17,0.89,0.91
12,469,80,1209,14,6.79,1223,28.28,0.87,0.9
12,469,80,1209,14,6.79,1223,28.28,0.87,0.9
12,469,80,1209,14,6.79,1223,28.28,0.87,0.9
12,469,80,1209,14,6.79,1223,28.28,0.87,0.9
12,469,80,1209,14,6.79,1223,28.28,0.87,0.9
12,469,80,1209,14,6.79,1223,28.28,0.87,0.9
12,469,80,1209,14,6.79,1223,28.28,0.87,0.9
4,502,11,1258,4,1.83,1262,11.46,0.91,0.92
4,502,11,1258,4,1.83,1262,11.46,0.91,0.92
4,502,11,1258,4,1.83,1262,11.46,0.91,0.92
4,502,11,1258,4,1.83,1262,11.46,0.91,0.92
4,502,11,1258,4,1.83,1262,11.46,0.91,0.92
4,502,11,1258,4,1.83,1262,11.46,0.91,0.92
4,502,11,1258,4,1.83,1262,11.46,0.91,0.92
12,572,80,1250,14,7.07,1264,28.78,0.87,0.9
12,572,80,1250,14,7.07,1264,28.78,0.87,0.9
12,572,80,1250,14,7.07,1264,28.78,0.87,0.9
12,572,80,1250,14,7.07,1264,28.78,0.87,0.9
12,572,80,1250,14,7.07,1264,28.78,0.87,0.9
12,572,80,1250,14,7.07,1264,28.78,0.87,0.9
12,572,80,1250,14,7.07,1264,28.78,0.87,0.9
4,564,11,1283,20,9.8,1303,38.44,0.85,0.89
4,564,11,1283,20,9.8,1303,38.44,0.85,0.89
4,564,11,1283,20,9.8,1303,38.44,0.85,0.89
4,564,11,1283,20,9.8,1303,38.44,0.85,0.89
4,564,11,1283,20,9.8,1303,38.44,0.85,0.89
4,564,11,1283,20,9.8,1303,38.44,0.85,0.89
4,564,11,1283,20,9.8,1303,38.44,0.85,0.89
9,624,18,1267,6,3.05,1273,15.23,0.9,0.91
9,624,18,1267,6,3.05,1273,15.23,0.9,0.91
9,624,18,1267,6,3.05,1273,15.23,0.9,0.91
9,624,18,1267,6,3.05,1273,15.23,0.9,0.91
9,624,18,1267,6,3.05,1273,15.23,0.9,0.91
9,624,18,1267,6,3.05,1273,15.23,0.9,0.91
9,624,18,1267,6,3.05,1273,15.23,0.9,0.91
12,525,80,1270,14,6.83,1284,28.35,0.87,0.9
12,525,80,1270,14,6.83,1284,28.35,0.87,0.9
12,525,80,1270,14,6.83,1284,28.35,0.87,0.9
12,525,80,1270,14,6.83,1284,28.35,0.87,0.9
12,525,80,1270,14,6.83,1284,28.35,0.87,0.9
12,525,80,1270,14,6.83,1284,28.35,0.87,0.9
12,525,80,1270,14,6.83,1284,28.35,0.87,0.9
4,555,11,1307,19,9.55,1326,37.21,0.85,0.89
4,555,11,1307,19,9.55,1326,37.21,0.85,0.89
4,555,11,1307,19,9.55,1326,37.21,0.85,0.89
4,555,11,1307,19,9.55,1326,37.21,0.85,0.89
4,555,11,1307,19,9.55,1326,37.21,0.85,0.89
4,555,11,1307,19,9.55,1326,37.21,0.85,0.89
4,555,11,1307,19,9.55,1326,37.21,0.85,0.89
9,588,18,1293,8,3.97,1301,18.47,0.89,0.91
9,588,18,1293,8,3.97,1301,18.47,0.89,0.91
9,588,18,1293,8,3.97,1301,18.47,0.89,0.91
9,588,18,1293,8,3.97,1301,18.47,0.89,0.91
9,588,18,1293,8,3.97,1301,18.47,0.89,0.91
9,588,18,1293,8,3.97,1301,18.47,0.89,0.91
9,588,18,1293,8,3.97,1301,18.47,0.89,0.91
12,502,80,1305,9,4.33,1314,19.91,0.89,0.91
12,502,80,1305,9,4.33,1314,19.91,0.89,0.91
12,502,80,1305,9,4.33,1314,19.91,0.89,0.91
12,502,80,1305,9,4.33,1314,19.91,0.89,0.91
12,502,80,1305,9,4.33,1314,19.91,0.89,0.91
12,502,80,1305,9,4.33,1314,19.91,0.89,0.91
12,502,80,1305,9,4.33,1314,19.91,0.89,0.91
4,639,11,1344,13,6.36,1357,26.72,0.88,0.9
4,639,11,1344,13,6.36,1357,26.72,0.88,0.9
4,639,11,1344,13,6.36,1357,26.72,0.88,0.9
4,639,11,1344,13,6.36,1357,26.72,0.88,0.9
4,639,11,1344,13,6.36,1357,26.72,0.88,0.9
4,639,11,1344,13,6.36,1357,26.72,0.88,0.9
4,639,11,1344,13,6.36,1357,26.72,0.88,0.9
9,573,18,1332,4,2.19,1336,12.1,0.91,0.92
9,573,18,1332,4,2.19,1336,12.1,0.91,0.92
9,573,18,1332,4,2.19,1336,12.1,0.91,0.92
9,573,18,1332,4,2.19,1336,12.1,0.91,0.92
9,573,18,1332,4,2.19,1336,12.1,0.91,0.92
9,573,18,1332,4,2.19,1336,12.1,0.91,0.92
9,573,18,1332,4,2.19,1336,12.1,0.91,0.92
12,711,80,1341,10,5.01,1351,21.91,0.89,0.91
12,711,80,1341,10,5.01,1351,21.91,0.89,0.91
12,711,80,1341,10,5.01,1351,21.91,0.89,0.91
12,711,80,1341,10,5.01,1351,21.91,0.89,0.91
12,711,80,1341,10,5.01,1351,21.91,0.89,0.91
12,711,80,1341,10,5.01,1351,21.91,0.89,0.91
12,711,80,1341,10,5.01,1351,21.91,0.89,0.91
4,749,11,1356,12,6.16,1368,25.57,0.88,0.9
4,749,11,1356,12,6.16,1368,25.57,0.88,0.9
4,749,11,1356,12,6.16,1368,25.57,0.88,0.9
4,749,11,1356,12,6.16,1368,25.57,0.88,0.9
4,749,11,1356,12,6.16,1368,25.57,0.88,0.9
4,749,11,1356,12,6.16,1368,25.57,0.88,0.9
4,749,11,1356,12,6.16,1368,25.57,0.88,0.9
12,516,80,1369,10,5.07,1379,22.03,0.89,0.91
12,516,80,1369,10,5.07,1379,22.03,0.89,0.91
12,516,80,1369,10,5.07,1379,22.03,0.89,0.91
12,516,80,1369,10,5.07,1379,22.03,0.89,0.91
12,516,80,1369,10,5.07,1379,22.03,0.89,0.91
12,516,80,1369,10,5.07,1379,22.03,0.89,0.91
12,516,80,1369,10,5.07,1379,22.03,0.89,0.91
9,746,18,1395,8,3.99,1403,18.5,0.89,0.91
9,746,18,1395,8,3.99,1403,18.5,0.89,0.91
9,746,18,1395,8,3.99,1403,18.5,0.89,0.91
9,746,18,1395,8,3.99,1403,18.5,0.89,0.91
9,746,18,1395,8,3.99,1403,18.5,0.89,0.91
9,746,18,1395,8,3.99,1403,18.5,0.89,0.91
9,746,18,1395,8,3.99,1403,18.5,0.89,0.91
12,927,80,1384,7,3.32,1391,16.5,0.9,0.91
12,927,80,1384,7,3.32,1391,16.5,0.9,0.91
12,927,80,1384,7,3.32,1391,16.5,0.9,0.91
12,927,80,1384,7,3.32,1391,16.5,0.9,0.91
12,927,80,1384,7,3.32,1391,16.5,0.9,0.91
12,927,80,1384,7,3.32,1391,16.5,0.9,0.91
12,927,80,1384,7,3.32,1391,16.5,0.9,0.91
9,520,18,1430,15,7.34,1445,30.06,0.87,0.9
9,520,18,1430,15,7.34,1445,30.06,0.87,0.9
9,520,18,1430,15,7.34,1445,30.06,0.87,0.9
9,520,18,1430,15,7.34,1445,30.06,0.87,0.9
9,520,18,1430,15,7.34,1445,30.06,0.87,0.9
9,520,18,1430,15,7.34,1445,30.06,0.87,0.9
9,520,18,1430,15,7.34,1445,30.06,0.87,0.9
