square_index,rider_id,driver_idx,trip_start_timestamp,trip_duration,ride_miles,trip_end_timestamp,price_of_ride,rider_acceptance_prob,driver_acceptance_prob
6,63,19,389,18,8.79,407,35.04,0.47000000000000003,0.52
10,172,50,431,13,6.28,444,26.56,0.5,0.53
0,13,48,478,5,2.37,483,13.21,0.53,0.55
11,7,56,451,18,8.76,469,34.98,0.48,0.52
12,133,54,466,13,6.33,479,26.65,0.5,0.53
0,143,48,480,6,3.25,486,15.59,0.52,0.54
1,30,23,510,5,2.47,515,13.39,0.53,0.55
14,4,63,525,9,4.25,534,19.76,0.51,0.54
0,182,48,545,16,8.13,561,32.28,0.48,0.52
1,187,23,547,6,2.91,553,14.97,0.53,0.54
7,42,78,558,10,4.92,568,21.75,0.51,0.54
14,103,63,551,9,4.67,560,20.52,0.51,0.54
0,762,47,901,6,3.03,907,15.19,0.52,0.54
13,434,16,984,12,6.04,996,25.35,0.5,0.53
13,435,16,1041,10,5.18,1051,22.23,0.51,0.53
7,756,29,1114,12,6.12,1126,25.5,0.5,0.53
10,317,24,1149,13,6.25,1162,26.52,0.5,0.53
2,303,6,1176,13,6.52,1189,27.0,0.49,0.53
10,711,24,1207,11,5.34,1218,23.3,0.5,0.53
0,876,47,1248,14,7.17,1262,28.97,0.49,0.53
3,860,60,1237,12,5.96,1249,25.21,0.5,0.53
5,658,76,1243,5,2.46,1248,13.37,0.53,0.55
10,719,24,1254,12,6.07,1266,25.4,0.5,0.53
10,527,24,1267,6,3.18,1273,15.47,0.52,0.54
5,570,76,1313,12,5.84,1325,24.98,0.5,0.53
0,658,47,1323,12,5.97,1335,25.23,0.5,0.53
2,618,6,1325,7,3.32,1332,16.51,0.52,0.54
0,630,47,1357,15,7.45,1372,30.25,0.49,0.52
0,714,47,1380,9,4.58,1389,20.36,0.51,0.54
2,606,6,1389,10,5.24,1399,22.33,0.51,0.53
2,745,6,1426,8,4.14,1434,18.77,0.52,0.54
10,790,24,1428,12,5.81,1440,24.93,0.5,0.53
2,966,4,105,14,7.01,119,28.68,0.49,0.53
2,966,4,105,14,7.01,119,28.68,0.49,0.53
10,824,23,301,6,2.93,307,15.01,0.52,0.54
10,824,23,301,6,2.93,307,15.01,0.52,0.54
4,18,53,387,14,7.02,401,28.7,0.49,0.53
4,18,53,387,14,7.02,401,28.7,0.49,0.53
10,111,23,398,5,2.33,403,13.14,0.53,0.55
10,111,23,398,5,2.33,403,13.14,0.53,0.55
13,928,14,391,4,2.07,395,11.88,0.53,0.55
13,928,14,391,4,2.07,395,11.88,0.53,0.55
4,701,53,424,12,6.23,436,25.7,0.5,0.53
4,701,53,424,12,6.23,436,25.7,0.5,0.53
10,210,23,466,12,5.84,478,24.99,0.5,0.53
10,210,23,466,12,5.84,478,24.99,0.5,0.53
4,60,53,502,3,1.45,505,9.98,0.54,0.55
4,60,53,502,3,1.45,505,9.98,0.54,0.55
6,967,98,492,12,6.18,504,25.61,0.5,0.53
6,967,98,492,12,6.18,504,25.61,0.5,0.53
14,75,64,491,18,8.84,509,35.14,0.47000000000000003,0.52
14,75,64,491,18,8.84,509,35.14,0.47000000000000003,0.52
15,184,5,501,9,4.38,510,19.99,0.51,0.54
15,184,5,501,9,4.38,510,19.99,0.51,0.54
4,35,53,521,2,1.23,523,8.79,0.54,0.55
4,35,53,521,2,1.23,523,8.79,0.54,0.55
6,62,98,523,5,2.52,528,13.48,0.53,0.55
6,62,98,523,5,2.52,528,13.48,0.53,0.55
14,101,64,526,13,6.34,539,26.67,0.5,0.53
14,101,64,526,13,6.34,539,26.67,0.5,0.53
15,93,5,532,15,7.31,547,30.0,0.49,0.52
15,93,5,532,15,7.31,547,30.0,0.49,0.52
6,95,98,542,13,6.42,555,26.82,0.5,0.53
6,95,98,542,13,6.42,555,26.82,0.5,0.53
8,82,49,555,12,6.12,567,25.5,0.5,0.53
8,82,49,555,12,6.12,567,25.5,0.5,0.53
5,920,8,600,9,4.67,609,20.52,0.51,0.54
5,920,8,600,9,4.67,609,20.52,0.51,0.54
12,768,0,714,7,3.59,721,16.99,0.52,0.54
12,768,0,714,7,3.59,721,16.99,0.52,0.54
14,941,64,706,3,1.29,709,9.69,0.54,0.55
14,941,64,706,3,1.29,709,9.69,0.54,0.55
11,919,74,791,8,4.15,799,18.79,0.52,0.54
11,919,74,791,8,4.15,799,18.79,0.52,0.54
8,845,49,888,11,5.28,899,23.19,0.5,0.53
8,845,49,888,11,5.28,899,23.19,0.5,0.53
8,355,49,979,12,6.07,991,25.41,0.5,0.53
8,355,49,979,12,6.07,991,25.41,0.5,0.53
10,831,51,971,5,2.67,976,13.76,0.53,0.55
10,831,51,971,5,2.67,976,13.76,0.53,0.55
8,872,49,1007,9,4.28,1016,19.82,0.51,0.54
8,872,49,1007,9,4.28,1016,19.82,0.51,0.54
10,895,51,998,9,4.7,1007,20.58,0.51,0.54
10,895,51,998,9,4.7,1007,20.58,0.51,0.54
11,342,74,1006,15,7.45,1021,30.26,0.49,0.52
11,342,74,1006,15,7.45,1021,30.26,0.49,0.52
14,272,56,1046,9,4.36,1055,19.95,0.51,0.54
14,272,56,1046,9,4.36,1055,19.95,0.51,0.54
8,481,49,1076,8,3.92,1084,18.37,0.52,0.54
8,481,49,1076,8,3.92,1084,18.37,0.52,0.54
11,390,74,1069,2,0.76,1071,7.95,0.54,0.55
11,390,74,1069,2,0.76,1071,7.95,0.54,0.55
14,377,56,1076,9,4.59,1085,20.37,0.51,0.54
14,377,56,1076,9,4.59,1085,20.37,0.51,0.54
7,377,50,1106,11,5.35,1117,23.31,0.5,0.53
7,377,50,1106,11,5.35,1117,23.31,0.5,0.53
8,288,49,1134,6,2.9,1140,14.96,0.53,0.54
8,288,49,1134,6,2.9,1140,14.96,0.53,0.54
14,604,56,1402,10,5.24,1412,22.34,0.51,0.53
14,604,56,1402,10,5.24,1412,22.34,0.51,0.53
6,885,88,6,5,2.25,11,13.0,0.53,0.55
6,885,88,6,5,2.25,11,13.0,0.53,0.55
6,885,88,6,5,2.25,11,13.0,0.53,0.55
3,897,2,137,10,4.83,147,21.59,0.51,0.54
3,897,2,137,10,4.83,147,21.59,0.51,0.54
3,897,2,137,10,4.83,147,21.59,0.51,0.54
6,875,88,179,4,2.23,183,12.19,0.53,0.55
6,875,88,179,4,2.23,183,12.19,0.53,0.55
6,875,88,179,4,2.23,183,12.19,0.53,0.55
13,991,14,301,16,8.17,317,32.34,0.48,0.52
13,991,14,301,16,8.17,317,32.34,0.48,0.52
13,991,14,301,16,8.17,317,32.34,0.48,0.52
9,56,32,402,7,3.74,409,17.27,0.52,0.54
9,56,32,402,7,3.74,409,17.27,0.52,0.54
9,56,32,402,7,3.74,409,17.27,0.52,0.54
13,21,14,418,8,3.78,426,18.12,0.52,0.54
13,21,14,418,8,3.78,426,18.12,0.52,0.54
13,21,14,418,8,3.78,426,18.12,0.52,0.54
3,172,2,442,9,4.39,451,20.01,0.51,0.54
3,172,2,442,9,4.39,451,20.01,0.51,0.54
3,172,2,442,9,4.39,451,20.01,0.51,0.54
9,90,32,426,10,5.01,436,21.91,0.51,0.54
9,90,32,426,10,5.01,436,21.91,0.51,0.54
9,90,32,426,10,5.01,436,21.91,0.51,0.54
11,171,60,431,7,3.62,438,17.05,0.52,0.54
11,171,60,431,7,3.62,438,17.05,0.52,0.54
11,171,60,431,7,3.62,438,17.05,0.52,0.54
13,32,14,425,7,3.4,432,16.64,0.52,0.54
13,32,14,425,7,3.4,432,16.64,0.52,0.54
13,32,14,425,7,3.4,432,16.64,0.52,0.54
14,1,52,423,18,9.21,441,35.8,0.47000000000000003,0.52
14,1,52,423,18,9.21,441,35.8,0.47000000000000003,0.52
14,1,52,423,18,9.21,441,35.8,0.47000000000000003,0.52
11,2,60,479,16,8.12,495,32.25,0.48,0.52
11,2,60,479,16,8.12,495,32.25,0.48,0.52
11,2,60,479,16,8.12,495,32.25,0.48,0.52
13,103,14,476,3,1.26,479,9.63,0.54,0.55
13,103,14,476,3,1.26,479,9.63,0.54,0.55
13,103,14,476,3,1.26,479,9.63,0.54,0.55
14,837,52,478,5,2.48,483,13.41,0.53,0.55
14,837,52,478,5,2.48,483,13.41,0.53,0.55
14,837,52,478,5,2.48,483,13.41,0.53,0.55
9,960,32,501,5,2.26,506,13.01,0.53,0.55
9,960,32,501,5,2.26,506,13.01,0.53,0.55
9,960,32,501,5,2.26,506,13.01,0.53,0.55
11,18,60,502,3,1.57,505,10.2,0.54,0.55
11,18,60,502,3,1.57,505,10.2,0.54,0.55
11,18,60,502,3,1.57,505,10.2,0.54,0.55
3,187,2,537,17,8.67,554,34.03,0.48,0.52
3,187,2,537,17,8.67,554,34.03,0.48,0.52
3,187,2,537,17,8.67,554,34.03,0.48,0.52
9,84,32,530,16,7.92,546,31.89,0.48,0.52
9,84,32,530,16,7.92,546,31.89,0.48,0.52
9,84,32,530,16,7.92,546,31.89,0.48,0.52
11,225,60,525,8,3.83,533,18.21,0.52,0.54
11,225,60,525,8,3.83,533,18.21,0.52,0.54
11,225,60,525,8,3.83,533,18.21,0.52,0.54
2,948,28,546,15,7.68,561,30.67,0.49,0.52
2,948,28,546,15,7.68,561,30.67,0.49,0.52
2,948,28,546,15,7.68,561,30.67,0.49,0.52
8,7,87,541,11,5.57,552,23.72,0.5,0.53
8,7,87,541,11,5.57,552,23.72,0.5,0.53
8,7,87,541,11,5.57,552,23.72,0.5,0.53
9,81,32,547,12,6.09,559,25.44,0.5,0.53
9,81,32,547,12,6.09,559,25.44,0.5,0.53
9,81,32,547,12,6.09,559,25.44,0.5,0.53
13,107,14,558,7,3.72,565,17.24,0.52,0.54
13,107,14,558,7,3.72,565,17.24,0.52,0.54
13,107,14,558,7,3.72,565,17.24,0.52,0.54
2,986,28,590,15,7.5,605,30.34,0.49,0.52
2,986,28,590,15,7.5,605,30.34,0.49,0.52
2,986,28,590,15,7.5,605,30.34,0.49,0.52
3,240,2,574,10,5.11,584,22.1,0.51,0.53
3,240,2,574,10,5.11,584,22.1,0.51,0.53
3,240,2,574,10,5.11,584,22.1,0.51,0.53
8,192,87,579,11,5.73,590,24.01,0.5,0.53
8,192,87,579,11,5.73,590,24.01,0.5,0.53
8,192,87,579,11,5.73,590,24.01,0.5,0.53
9,142,32,595,7,3.63,602,17.07,0.52,0.54
9,142,32,595,7,3.63,602,17.07,0.52,0.54
9,142,32,595,7,3.63,602,17.07,0.52,0.54
7,18,35,604,11,5.29,615,23.21,0.5,0.53
7,18,35,604,11,5.29,615,23.21,0.5,0.53
7,18,35,604,11,5.29,615,23.21,0.5,0.53
1,977,91,708,6,2.87,714,14.9,0.53,0.54
1,977,91,708,6,2.87,714,14.9,0.53,0.54
1,977,91,708,6,2.87,714,14.9,0.53,0.54
12,880,70,743,15,7.59,758,30.51,0.49,0.52
12,880,70,743,15,7.59,758,30.51,0.49,0.52
12,880,70,743,15,7.59,758,30.51,0.49,0.52
2,948,28,813,3,1.35,816,9.8,0.54,0.55
2,948,28,813,3,1.35,816,9.8,0.54,0.55
2,948,28,813,3,1.35,816,9.8,0.54,0.55
14,388,74,940,12,6.11,952,25.47,0.5,0.53
14,388,74,940,12,6.11,952,25.47,0.5,0.53
14,388,74,940,12,6.11,952,25.47,0.5,0.53
1,307,10,1018,10,5.12,1028,22.12,0.51,0.53
1,307,10,1018,10,5.12,1028,22.12,0.51,0.53
1,307,10,1018,10,5.12,1028,22.12,0.51,0.53
14,466,74,1010,5,2.59,1015,13.61,0.53,0.55
14,466,74,1010,5,2.59,1015,13.61,0.53,0.55
14,466,74,1010,5,2.59,1015,13.61,0.53,0.55
8,299,29,1025,8,3.9,1033,18.33,0.52,0.54
8,299,29,1025,8,3.9,1033,18.33,0.52,0.54
8,299,29,1025,8,3.9,1033,18.33,0.52,0.54
4,382,44,1075,3,1.6300000000000001,1078,10.31,0.54,0.55
4,382,44,1075,3,1.6300000000000001,1078,10.31,0.54,0.55
4,382,44,1075,3,1.6300000000000001,1078,10.31,0.54,0.55
8,299,29,1084,10,5.08,1094,22.05,0.51,0.53
8,299,29,1084,10,5.08,1094,22.05,0.51,0.53
8,299,29,1084,10,5.08,1094,22.05,0.51,0.53
13,280,72,1086,9,4.59,1095,20.37,0.51,0.54
13,280,72,1086,9,4.59,1095,20.37,0.51,0.54
13,280,72,1086,9,4.59,1095,20.37,0.51,0.54
5,403,20,1115,10,4.82,1125,21.58,0.51,0.54
5,403,20,1115,10,4.82,1125,21.58,0.51,0.54
5,403,20,1115,10,4.82,1125,21.58,0.51,0.54
12,381,34,1125,2,1.05,1127,8.47,0.54,0.55
12,381,34,1125,2,1.05,1127,8.47,0.54,0.55
12,381,34,1125,2,1.05,1127,8.47,0.54,0.55
5,281,20,1142,5,2.35,1147,13.17,0.53,0.55
5,281,20,1142,5,2.35,1147,13.17,0.53,0.55
5,281,20,1142,5,2.35,1147,13.17,0.53,0.55
12,324,34,1167,12,6.11,1179,25.49,0.5,0.53
12,324,34,1167,12,6.11,1179,25.49,0.5,0.53
12,324,34,1167,12,6.11,1179,25.49,0.5,0.53
13,402,72,1147,16,8.07,1163,32.16,0.48,0.52
13,402,72,1147,16,8.07,1163,32.16,0.48,0.52
13,402,72,1147,16,8.07,1163,32.16,0.48,0.52
5,690,20,1180,10,4.98,1190,21.86,0.51,0.54
5,690,20,1180,10,4.98,1190,21.86,0.51,0.54
5,690,20,1180,10,4.98,1190,21.86,0.51,0.54
12,524,34,1230,8,4.21,1238,18.9,0.52,0.54
12,524,34,1230,8,4.21,1238,18.9,0.52,0.54
12,524,34,1230,8,4.21,1238,18.9,0.52,0.54
12,535,34,1279,10,4.75,1289,21.45,0.51,0.54
12,535,34,1279,10,4.75,1289,21.45,0.51,0.54
12,535,34,1279,10,4.75,1289,21.45,0.51,0.54
12,655,34,1293,17,8.72,1310,34.14,0.48,0.52
12,655,34,1293,17,8.72,1310,34.14,0.48,0.52
12,655,34,1293,17,8.72,1310,34.14,0.48,0.52
12,610,34,1335,18,9.18,1353,35.75,0.47000000000000003,0.52
12,610,34,1335,18,9.18,1353,35.75,0.47000000000000003,0.52
12,610,34,1335,18,9.18,1353,35.75,0.47000000000000003,0.52
14,752,1,296,12,5.83,308,24.97,0.5,0.53
14,752,1,296,12,5.83,308,24.97,0.5,0.53
14,752,1,296,12,5.83,308,24.97,0.5,0.53
14,752,1,296,12,5.83,308,24.97,0.5,0.53
5,241,24,346,9,4.29,355,19.83,0.51,0.54
5,241,24,346,9,4.29,355,19.83,0.51,0.54
5,241,24,346,9,4.29,355,19.83,0.51,0.54
5,241,24,346,9,4.29,355,19.83,0.51,0.54
5,134,24,415,10,4.93,425,21.78,0.51,0.54
5,134,24,415,10,4.93,425,21.78,0.51,0.54
5,134,24,415,10,4.93,425,21.78,0.51,0.54
5,134,24,415,10,4.93,425,21.78,0.51,0.54
15,177,48,408,22,10.76,430,41.74,0.46,0.51
15,177,48,408,22,10.76,430,41.74,0.46,0.51
15,177,48,408,22,10.76,430,41.74,0.46,0.51
15,177,48,408,22,10.76,430,41.74,0.46,0.51
2,161,38,421,12,6.2,433,25.65,0.5,0.53
2,161,38,421,12,6.2,433,25.65,0.5,0.53
2,161,38,421,12,6.2,433,25.65,0.5,0.53
2,161,38,421,12,6.2,433,25.65,0.5,0.53
8,22,67,431,11,5.41,442,23.43,0.5,0.53
8,22,67,431,11,5.41,442,23.43,0.5,0.53
8,22,67,431,11,5.41,442,23.43,0.5,0.53
8,22,67,431,11,5.41,442,23.43,0.5,0.53
11,49,81,447,10,5.09,457,22.07,0.51,0.53
11,49,81,447,10,5.09,457,22.07,0.51,0.53
11,49,81,447,10,5.09,457,22.07,0.51,0.53
11,49,81,447,10,5.09,457,22.07,0.51,0.53
13,35,21,428,11,5.56,439,23.71,0.5,0.53
13,35,21,428,11,5.56,439,23.71,0.5,0.53
13,35,21,428,11,5.56,439,23.71,0.5,0.53
13,35,21,428,11,5.56,439,23.71,0.5,0.53
14,78,1,434,2,1.02,436,8.42,0.54,0.55
14,78,1,434,2,1.02,436,8.42,0.54,0.55
14,78,1,434,2,1.02,436,8.42,0.54,0.55
14,78,1,434,2,1.02,436,8.42,0.54,0.55
2,110,38,459,10,5.23,469,22.32,0.51,0.53
2,110,38,459,10,5.23,469,22.32,0.51,0.53
2,110,38,459,10,5.23,469,22.32,0.51,0.53
2,110,38,459,10,5.23,469,22.32,0.51,0.53
3,142,47,478,3,1.53,481,10.12,0.54,0.55
3,142,47,478,3,1.53,481,10.12,0.54,0.55
3,142,47,478,3,1.53,481,10.12,0.54,0.55
3,142,47,478,3,1.53,481,10.12,0.54,0.55
11,14,81,478,9,4.61,487,20.41,0.51,0.54
11,14,81,478,9,4.61,487,20.41,0.51,0.54
11,14,81,478,9,4.61,487,20.41,0.51,0.54
11,14,81,478,9,4.61,487,20.41,0.51,0.54
15,142,48,468,18,8.79,486,35.03,0.47000000000000003,0.52
15,142,48,468,18,8.79,486,35.03,0.47000000000000003,0.52
15,142,48,468,18,8.79,486,35.03,0.47000000000000003,0.52
15,142,48,468,18,8.79,486,35.03,0.47000000000000003,0.52
0,183,39,503,10,4.94,513,21.8,0.51,0.54
0,183,39,503,10,4.94,513,21.8,0.51,0.54
0,183,39,503,10,4.94,513,21.8,0.51,0.54
0,183,39,503,10,4.94,513,21.8,0.51,0.54
4,54,83,502,6,2.95,508,15.05,0.52,0.54
4,54,83,502,6,2.95,508,15.05,0.52,0.54
4,54,83,502,6,2.95,508,15.05,0.52,0.54
4,54,83,502,6,2.95,508,15.05,0.52,0.54
6,63,93,494,11,5.44,505,23.49,0.5,0.53
6,63,93,494,11,5.44,505,23.49,0.5,0.53
6,63,93,494,11,5.44,505,23.49,0.5,0.53
6,63,93,494,11,5.44,505,23.49,0.5,0.53
10,240,2,487,9,4.64,496,20.46,0.51,0.54
10,240,2,487,9,4.64,496,20.46,0.51,0.54
10,240,2,487,9,4.64,496,20.46,0.51,0.54
10,240,2,487,9,4.64,496,20.46,0.51,0.54
13,115,21,495,22,11.19,517,42.53,0.46,0.51
13,115,21,495,22,11.19,517,42.53,0.46,0.51
13,115,21,495,22,11.19,517,42.53,0.46,0.51
13,115,21,495,22,11.19,517,42.53,0.46,0.51
14,184,1,482,7,3.27,489,16.41,0.52,0.54
14,184,1,482,7,3.27,489,16.41,0.52,0.54
14,184,1,482,7,3.27,489,16.41,0.52,0.54
14,184,1,482,7,3.27,489,16.41,0.52,0.54
3,13,47,512,17,8.73,529,34.14,0.48,0.52
3,13,47,512,17,8.73,529,34.14,0.48,0.52
3,13,47,512,17,8.73,529,34.14,0.48,0.52
3,13,47,512,17,8.73,529,34.14,0.48,0.52
4,109,83,518,6,3.19,524,15.49,0.52,0.54
4,109,83,518,6,3.19,524,15.49,0.52,0.54
4,109,83,518,6,3.19,524,15.49,0.52,0.54
4,109,83,518,6,3.19,524,15.49,0.52,0.54
13,117,21,522,5,2.26,527,13.0,0.53,0.55
13,117,21,522,5,2.26,527,13.0,0.53,0.55
13,117,21,522,5,2.26,527,13.0,0.53,0.55
13,117,21,522,5,2.26,527,13.0,0.53,0.55
15,13,48,525,19,9.57,544,37.24,0.47000000000000003,0.52
15,13,48,525,19,9.57,544,37.24,0.47000000000000003,0.52
15,13,48,525,19,9.57,544,37.24,0.47000000000000003,0.52
15,13,48,525,19,9.57,544,37.24,0.47000000000000003,0.52
4,135,83,547,2,1.07,549,8.51,0.54,0.55
4,135,83,547,2,1.07,549,8.51,0.54,0.55
4,135,83,547,2,1.07,549,8.51,0.54,0.55
4,135,83,547,2,1.07,549,8.51,0.54,0.55
6,197,93,549,5,2.47,554,13.4,0.53,0.55
6,197,93,549,5,2.47,554,13.4,0.53,0.55
6,197,93,549,5,2.47,554,13.4,0.53,0.55
6,197,93,549,5,2.47,554,13.4,0.53,0.55
3,210,47,609,4,1.97,613,11.71,0.53,0.55
3,210,47,609,4,1.97,613,11.71,0.53,0.55
3,210,47,609,4,1.97,613,11.71,0.53,0.55
3,210,47,609,4,1.97,613,11.71,0.53,0.55
3,4,47,654,11,5.34,665,23.3,0.5,0.53
3,4,47,654,11,5.34,665,23.3,0.5,0.53
3,4,47,654,11,5.34,665,23.3,0.5,0.53
3,4,47,654,11,5.34,665,23.3,0.5,0.53
4,959,83,645,8,3.95,653,18.42,0.52,0.54
4,959,83,645,8,3.95,653,18.42,0.52,0.54
4,959,83,645,8,3.95,653,18.42,0.52,0.54
4,959,83,645,8,3.95,653,18.42,0.52,0.54
9,830,59,689,6,2.88,695,14.93,0.53,0.54
9,830,59,689,6,2.88,695,14.93,0.53,0.54
9,830,59,689,6,2.88,695,14.93,0.53,0.54
9,830,59,689,6,2.88,695,14.93,0.53,0.54
14,767,1,712,17,8.6,729,33.91,0.48,0.52
14,767,1,712,17,8.6,729,33.91,0.48,0.52
14,767,1,712,17,8.6,729,33.91,0.48,0.52
14,767,1,712,17,8.6,729,33.91,0.48,0.52
0,759,39,835,14,7.05,849,28.75,0.49,0.53
0,759,39,835,14,7.05,849,28.75,0.49,0.53
0,759,39,835,14,7.05,849,28.75,0.49,0.53
0,759,39,835,14,7.05,849,28.75,0.49,0.53
6,821,86,825,7,3.7,832,17.2,0.52,0.54
6,821,86,825,7,3.7,832,17.2,0.52,0.54
6,821,86,825,7,3.7,832,17.2,0.52,0.54
6,821,86,825,7,3.7,832,17.2,0.52,0.54
0,266,39,998,23,11.38,1021,43.65,0.45,0.51
0,266,39,998,23,11.38,1021,43.65,0.45,0.51
0,266,39,998,23,11.38,1021,43.65,0.45,0.51
0,266,39,998,23,11.38,1021,43.65,0.45,0.51
0,434,39,1049,13,6.75,1062,27.42,0.49,0.53
0,434,39,1049,13,6.75,1062,27.42,0.49,0.53
0,434,39,1049,13,6.75,1062,27.42,0.49,0.53
0,434,39,1049,13,6.75,1062,27.42,0.49,0.53
0,315,39,1063,4,2.13,1067,12.0,0.53,0.55
0,315,39,1063,4,2.13,1067,12.0,0.53,0.55
0,315,39,1063,4,2.13,1067,12.0,0.53,0.55
0,315,39,1063,4,2.13,1067,12.0,0.53,0.55
0,316,39,1121,3,1.6,1124,10.26,0.54,0.55
0,316,39,1121,3,1.6,1124,10.26,0.54,0.55
0,316,39,1121,3,1.6,1124,10.26,0.54,0.55
0,316,39,1121,3,1.6,1124,10.26,0.54,0.55
0,559,39,1193,8,4.09,1201,18.69,0.52,0.54
0,559,39,1193,8,4.09,1201,18.69,0.52,0.54
0,559,39,1193,8,4.09,1201,18.69,0.52,0.54
0,559,39,1193,8,4.09,1201,18.69,0.52,0.54
0,621,39,1227,12,6.09,1239,25.45,0.5,0.53
0,621,39,1227,12,6.09,1239,25.45,0.5,0.53
0,621,39,1227,12,6.09,1239,25.45,0.5,0.53
0,621,39,1227,12,6.09,1239,25.45,0.5,0.53
0,524,39,1254,10,5.04,1264,21.97,0.51,0.53
0,524,39,1254,10,5.04,1264,21.97,0.51,0.53
0,524,39,1254,10,5.04,1264,21.97,0.51,0.53
0,524,39,1254,10,5.04,1264,21.97,0.51,0.53
9,663,30,1255,6,3.07,1261,15.26,0.52,0.54
9,663,30,1255,6,3.07,1261,15.26,0.52,0.54
9,663,30,1255,6,3.07,1261,15.26,0.52,0.54
9,663,30,1255,6,3.07,1261,15.26,0.52,0.54
10,991,53,1261,4,1.91,1265,11.59,0.53,0.55
10,991,53,1261,4,1.91,1265,11.59,0.53,0.55
10,991,53,1261,4,1.91,1265,11.59,0.53,0.55
10,991,53,1261,4,1.91,1265,11.59,0.53,0.55
12,672,4,1298,2,0.84,1300,8.09,0.54,0.55
12,672,4,1298,2,0.84,1300,8.09,0.54,0.55
12,672,4,1298,2,0.84,1300,8.09,0.54,0.55
12,672,4,1298,2,0.84,1300,8.09,0.54,0.55
12,595,4,1348,12,6.02,1360,25.32,0.5,0.53
12,595,4,1348,12,6.02,1360,25.32,0.5,0.53
12,595,4,1348,12,6.02,1360,25.32,0.5,0.53
12,595,4,1348,12,6.02,1360,25.32,0.5,0.53
0,536,39,1360,4,1.8900000000000001,1364,11.56,0.53,0.55
0,536,39,1360,4,1.8900000000000001,1364,11.56,0.53,0.55
0,536,39,1360,4,1.8900000000000001,1364,11.56,0.53,0.55
0,536,39,1360,4,1.8900000000000001,1364,11.56,0.53,0.55
12,671,4,1414,22,11.19,1436,42.53,0.46,0.51
12,671,4,1414,22,11.19,1436,42.53,0.46,0.51
12,671,4,1414,22,11.19,1436,42.53,0.46,0.51
12,671,4,1414,22,11.19,1436,42.53,0.46,0.51
11,987,72,164,13,6.27,177,26.56,0.5,0.53
11,987,72,164,13,6.27,177,26.56,0.5,0.53
11,987,72,164,13,6.27,177,26.56,0.5,0.53
11,987,72,164,13,6.27,177,26.56,0.5,0.53
11,987,72,164,13,6.27,177,26.56,0.5,0.53
11,917,72,186,9,4.33,195,19.91,0.51,0.54
11,917,72,186,9,4.33,195,19.91,0.51,0.54
11,917,72,186,9,4.33,195,19.91,0.51,0.54
11,917,72,186,9,4.33,195,19.91,0.51,0.54
11,917,72,186,9,4.33,195,19.91,0.51,0.54
11,923,72,249,7,3.68,256,17.15,0.52,0.54
11,923,72,249,7,3.68,256,17.15,0.52,0.54
11,923,72,249,7,3.68,256,17.15,0.52,0.54
11,923,72,249,7,3.68,256,17.15,0.52,0.54
11,923,72,249,7,3.68,256,17.15,0.52,0.54
2,906,32,320,13,6.56,333,27.08,0.49,0.53
2,906,32,320,13,6.56,333,27.08,0.49,0.53
2,906,32,320,13,6.56,333,27.08,0.49,0.53
2,906,32,320,13,6.56,333,27.08,0.49,0.53
2,906,32,320,13,6.56,333,27.08,0.49,0.53
5,830,80,302,5,2.32,307,13.13,0.53,0.55
5,830,80,302,5,2.32,307,13.13,0.53,0.55
5,830,80,302,5,2.32,307,13.13,0.53,0.55
5,830,80,302,5,2.32,307,13.13,0.53,0.55
5,830,80,302,5,2.32,307,13.13,0.53,0.55
2,227,32,376,5,2.42,381,13.31,0.53,0.55
2,227,32,376,5,2.42,381,13.31,0.53,0.55
2,227,32,376,5,2.42,381,13.31,0.53,0.55
2,227,32,376,5,2.42,381,13.31,0.53,0.55
2,227,32,376,5,2.42,381,13.31,0.53,0.55
2,115,32,418,6,3.23,424,15.56,0.52,0.54
2,115,32,418,6,3.23,424,15.56,0.52,0.54
2,115,32,418,6,3.23,424,15.56,0.52,0.54
2,115,32,418,6,3.23,424,15.56,0.52,0.54
2,115,32,418,6,3.23,424,15.56,0.52,0.54
2,228,32,437,12,5.83,449,24.97,0.5,0.53
2,228,32,437,12,5.83,449,24.97,0.5,0.53
2,228,32,437,12,5.83,449,24.97,0.5,0.53
2,228,32,437,12,5.83,449,24.97,0.5,0.53
2,228,32,437,12,5.83,449,24.97,0.5,0.53
4,213,99,448,9,4.75,457,20.66,0.51,0.54
4,213,99,448,9,4.75,457,20.66,0.51,0.54
4,213,99,448,9,4.75,457,20.66,0.51,0.54
4,213,99,448,9,4.75,457,20.66,0.51,0.54
4,213,99,448,9,4.75,457,20.66,0.51,0.54
2,2,32,471,5,2.41,476,13.28,0.53,0.55
2,2,32,471,5,2.41,476,13.28,0.53,0.55
2,2,32,471,5,2.41,476,13.28,0.53,0.55
2,2,32,471,5,2.41,476,13.28,0.53,0.55
2,2,32,471,5,2.41,476,13.28,0.53,0.55
3,100,40,472,9,4.68,481,20.53,0.51,0.54
3,100,40,472,9,4.68,481,20.53,0.51,0.54
3,100,40,472,9,4.68,481,20.53,0.51,0.54
3,100,40,472,9,4.68,481,20.53,0.51,0.54
3,100,40,472,9,4.68,481,20.53,0.51,0.54
4,6,99,477,12,5.97,489,25.23,0.5,0.53
4,6,99,477,12,5.97,489,25.23,0.5,0.53
4,6,99,477,12,5.97,489,25.23,0.5,0.53
4,6,99,477,12,5.97,489,25.23,0.5,0.53
4,6,99,477,12,5.97,489,25.23,0.5,0.53
0,233,37,502,16,7.82,518,31.71,0.48,0.52
0,233,37,502,16,7.82,518,31.71,0.48,0.52
0,233,37,502,16,7.82,518,31.71,0.48,0.52
0,233,37,502,16,7.82,518,31.71,0.48,0.52
0,233,37,502,16,7.82,518,31.71,0.48,0.52
3,49,40,496,10,5.14,506,22.15,0.51,0.53
3,49,40,496,10,5.14,506,22.15,0.51,0.53
3,49,40,496,10,5.14,506,22.15,0.51,0.53
3,49,40,496,10,5.14,506,22.15,0.51,0.53
3,49,40,496,10,5.14,506,22.15,0.51,0.53
4,84,99,498,14,6.96,512,28.59,0.49,0.53
4,84,99,498,14,6.96,512,28.59,0.49,0.53
4,84,99,498,14,6.96,512,28.59,0.49,0.53
4,84,99,498,14,6.96,512,28.59,0.49,0.53
4,84,99,498,14,6.96,512,28.59,0.49,0.53
10,187,39,494,3,1.61,497,10.27,0.54,0.55
10,187,39,494,3,1.61,497,10.27,0.54,0.55
10,187,39,494,3,1.61,497,10.27,0.54,0.55
10,187,39,494,3,1.61,497,10.27,0.54,0.55
10,187,39,494,3,1.61,497,10.27,0.54,0.55
13,21,47,486,4,2.11,490,11.96,0.53,0.55
13,21,47,486,4,2.11,490,11.96,0.53,0.55
13,21,47,486,4,2.11,490,11.96,0.53,0.55
13,21,47,486,4,2.11,490,11.96,0.53,0.55
13,21,47,486,4,2.11,490,11.96,0.53,0.55
2,139,32,535,18,9.03,553,35.48,0.47000000000000003,0.52
2,139,32,535,18,9.03,553,35.48,0.47000000000000003,0.52
2,139,32,535,18,9.03,553,35.48,0.47000000000000003,0.52
2,139,32,535,18,9.03,553,35.48,0.47000000000000003,0.52
2,139,32,535,18,9.03,553,35.48,0.47000000000000003,0.52
4,119,99,512,14,6.77,526,28.24,0.49,0.53
4,119,99,512,14,6.77,526,28.24,0.49,0.53
4,119,99,512,14,6.77,526,28.24,0.49,0.53
4,119,99,512,14,6.77,526,28.24,0.49,0.53
4,119,99,512,14,6.77,526,28.24,0.49,0.53
7,104,87,518,11,5.26,529,23.15,0.5,0.53
7,104,87,518,11,5.26,529,23.15,0.5,0.53
7,104,87,518,11,5.26,529,23.15,0.5,0.53
7,104,87,518,11,5.26,529,23.15,0.5,0.53
7,104,87,518,11,5.26,529,23.15,0.5,0.53
12,161,54,523,12,6.14,535,25.54,0.5,0.53
12,161,54,523,12,6.14,535,25.54,0.5,0.53
12,161,54,523,12,6.14,535,25.54,0.5,0.53
12,161,54,523,12,6.14,535,25.54,0.5,0.53
12,161,54,523,12,6.14,535,25.54,0.5,0.53
13,29,47,515,7,3.57,522,16.95,0.52,0.54
13,29,47,515,7,3.57,522,16.95,0.52,0.54
13,29,47,515,7,3.57,522,16.95,0.52,0.54
13,29,47,515,7,3.57,522,16.95,0.52,0.54
13,29,47,515,7,3.57,522,16.95,0.52,0.54
0,111,37,548,10,5.06,558,22.01,0.51,0.53
0,111,37,548,10,5.06,558,22.01,0.51,0.53
0,111,37,548,10,5.06,558,22.01,0.51,0.53
0,111,37,548,10,5.06,558,22.01,0.51,0.53
0,111,37,548,10,5.06,558,22.01,0.51,0.53
10,171,39,566,8,4.02,574,18.55,0.52,0.54
10,171,39,566,8,4.02,574,18.55,0.52,0.54
10,171,39,566,8,4.02,574,18.55,0.52,0.54
10,171,39,566,8,4.02,574,18.55,0.52,0.54
10,171,39,566,8,4.02,574,18.55,0.52,0.54
12,2,54,553,19,9.64,572,37.37,0.47000000000000003,0.52
12,2,54,553,19,9.64,572,37.37,0.47000000000000003,0.52
12,2,54,553,19,9.64,572,37.37,0.47000000000000003,0.52
12,2,54,553,19,9.64,572,37.37,0.47000000000000003,0.52
12,2,54,553,19,9.64,572,37.37,0.47000000000000003,0.52
0,178,37,587,3,1.49,590,10.06,0.54,0.55
0,178,37,587,3,1.49,590,10.06,0.54,0.55
0,178,37,587,3,1.49,590,10.06,0.54,0.55
0,178,37,587,3,1.49,590,10.06,0.54,0.55
0,178,37,587,3,1.49,590,10.06,0.54,0.55
7,249,87,604,5,2.47,609,13.39,0.53,0.55
7,249,87,604,5,2.47,609,13.39,0.53,0.55
7,249,87,604,5,2.47,609,13.39,0.53,0.55
7,249,87,604,5,2.47,609,13.39,0.53,0.55
7,249,87,604,5,2.47,609,13.39,0.53,0.55
1,822,41,644,9,4.66,653,20.5,0.51,0.54
1,822,41,644,9,4.66,653,20.5,0.51,0.54
1,822,41,644,9,4.66,653,20.5,0.51,0.54
1,822,41,644,9,4.66,653,20.5,0.51,0.54
1,822,41,644,9,4.66,653,20.5,0.51,0.54
14,867,82,647,6,3.12,653,15.36,0.52,0.54
14,867,82,647,6,3.12,653,15.36,0.52,0.54
14,867,82,647,6,3.12,653,15.36,0.52,0.54
14,867,82,647,6,3.12,653,15.36,0.52,0.54
14,867,82,647,6,3.12,653,15.36,0.52,0.54
7,240,87,683,13,6.31,696,26.63,0.5,0.53
7,240,87,683,13,6.31,696,26.63,0.5,0.53
7,240,87,683,13,6.31,696,26.63,0.5,0.53
7,240,87,683,13,6.31,696,26.63,0.5,0.53
7,240,87,683,13,6.31,696,26.63,0.5,0.53
0,987,37,723,6,2.7600000000000002,729,14.7,0.53,0.54
0,987,37,723,6,2.7600000000000002,729,14.7,0.53,0.54
0,987,37,723,6,2.7600000000000002,729,14.7,0.53,0.54
0,987,37,723,6,2.7600000000000002,729,14.7,0.53,0.54
0,987,37,723,6,2.7600000000000002,729,14.7,0.53,0.54
0,915,37,830,13,6.49,843,26.94,0.5,0.53
0,915,37,830,13,6.49,843,26.94,0.5,0.53
0,915,37,830,13,6.49,843,26.94,0.5,0.53
0,915,37,830,13,6.49,843,26.94,0.5,0.53
0,915,37,830,13,6.49,843,26.94,0.5,0.53
3,936,46,875,17,8.61,892,33.92,0.48,0.52
3,936,46,875,17,8.61,892,33.92,0.48,0.52
3,936,46,875,17,8.61,892,33.92,0.48,0.52
3,936,46,875,17,8.61,892,33.92,0.48,0.52
3,936,46,875,17,8.61,892,33.92,0.48,0.52
4,346,25,947,13,6.72,960,27.37,0.49,0.53
4,346,25,947,13,6.72,960,27.37,0.49,0.53
4,346,25,947,13,6.72,960,27.37,0.49,0.53
4,346,25,947,13,6.72,960,27.37,0.49,0.53
4,346,25,947,13,6.72,960,27.37,0.49,0.53
6,280,65,983,9,4.36,992,19.95,0.51,0.54
6,280,65,983,9,4.36,992,19.95,0.51,0.54
6,280,65,983,9,4.36,992,19.95,0.51,0.54
6,280,65,983,9,4.36,992,19.95,0.51,0.54
6,280,65,983,9,4.36,992,19.95,0.51,0.54
6,452,65,1012,10,5.09,1022,22.07,0.51,0.53
6,452,65,1012,10,5.09,1022,22.07,0.51,0.53
6,452,65,1012,10,5.09,1022,22.07,0.51,0.53
6,452,65,1012,10,5.09,1022,22.07,0.51,0.53
6,452,65,1012,10,5.09,1022,22.07,0.51,0.53
12,273,4,1015,18,9.03,1033,35.47,0.47000000000000003,0.52
12,273,4,1015,18,9.03,1033,35.47,0.47000000000000003,0.52
12,273,4,1015,18,9.03,1033,35.47,0.47000000000000003,0.52
12,273,4,1015,18,9.03,1033,35.47,0.47000000000000003,0.52
12,273,4,1015,18,9.03,1033,35.47,0.47000000000000003,0.52
12,259,4,1038,13,6.63,1051,27.2,0.49,0.53
12,259,4,1038,13,6.63,1051,27.2,0.49,0.53
12,259,4,1038,13,6.63,1051,27.2,0.49,0.53
12,259,4,1038,13,6.63,1051,27.2,0.49,0.53
12,259,4,1038,13,6.63,1051,27.2,0.49,0.53
14,302,82,1047,15,7.52,1062,30.39,0.49,0.52
14,302,82,1047,15,7.52,1062,30.39,0.49,0.52
14,302,82,1047,15,7.52,1062,30.39,0.49,0.52
14,302,82,1047,15,7.52,1062,30.39,0.49,0.52
14,302,82,1047,15,7.52,1062,30.39,0.49,0.52
4,307,25,1060,2,1.19,1062,8.72,0.54,0.55
4,307,25,1060,2,1.19,1062,8.72,0.54,0.55
4,307,25,1060,2,1.19,1062,8.72,0.54,0.55
4,307,25,1060,2,1.19,1062,8.72,0.54,0.55
4,307,25,1060,2,1.19,1062,8.72,0.54,0.55
8,344,76,1065,5,2.41,1070,13.3,0.53,0.55
8,344,76,1065,5,2.41,1070,13.3,0.53,0.55
8,344,76,1065,5,2.41,1070,13.3,0.53,0.55
8,344,76,1065,5,2.41,1070,13.3,0.53,0.55
8,344,76,1065,5,2.41,1070,13.3,0.53,0.55
12,280,4,1060,2,0.9,1062,8.19,0.54,0.55
12,280,4,1060,2,0.9,1062,8.19,0.54,0.55
12,280,4,1060,2,0.9,1062,8.19,0.54,0.55
12,280,4,1060,2,0.9,1062,8.19,0.54,0.55
12,280,4,1060,2,0.9,1062,8.19,0.54,0.55
4,312,25,1102,12,6.07,1114,25.4,0.5,0.53
4,312,25,1102,12,6.07,1114,25.4,0.5,0.53
4,312,25,1102,12,6.07,1114,25.4,0.5,0.53
4,312,25,1102,12,6.07,1114,25.4,0.5,0.53
4,312,25,1102,12,6.07,1114,25.4,0.5,0.53
8,442,76,1083,12,5.98,1095,25.24,0.5,0.53
8,442,76,1083,12,5.98,1095,25.24,0.5,0.53
8,442,76,1083,12,5.98,1095,25.24,0.5,0.53
8,442,76,1083,12,5.98,1095,25.24,0.5,0.53
8,442,76,1083,12,5.98,1095,25.24,0.5,0.53
12,434,4,1094,15,7.28,1109,29.96,0.49,0.53
12,434,4,1094,15,7.28,1109,29.96,0.49,0.53
12,434,4,1094,15,7.28,1109,29.96,0.49,0.53
12,434,4,1094,15,7.28,1109,29.96,0.49,0.53
12,434,4,1094,15,7.28,1109,29.96,0.49,0.53
4,785,25,1127,17,8.44,1144,33.62,0.48,0.52
4,785,25,1127,17,8.44,1144,33.62,0.48,0.52
4,785,25,1127,17,8.44,1144,33.62,0.48,0.52
4,785,25,1127,17,8.44,1144,33.62,0.48,0.52
4,785,25,1127,17,8.44,1144,33.62,0.48,0.52
8,908,76,1114,2,0.89,1116,8.17,0.54,0.55
8,908,76,1114,2,0.89,1116,8.17,0.54,0.55
8,908,76,1114,2,0.89,1116,8.17,0.54,0.55
8,908,76,1114,2,0.89,1116,8.17,0.54,0.55
8,908,76,1114,2,0.89,1116,8.17,0.54,0.55
12,431,4,1114,4,1.8900000000000001,1118,11.57,0.53,0.55
12,431,4,1114,4,1.8900000000000001,1118,11.57,0.53,0.55
12,431,4,1114,4,1.8900000000000001,1118,11.57,0.53,0.55
12,431,4,1114,4,1.8900000000000001,1118,11.57,0.53,0.55
12,431,4,1114,4,1.8900000000000001,1118,11.57,0.53,0.55
12,299,4,1167,6,3.05,1173,15.24,0.52,0.54
12,299,4,1167,6,3.05,1173,15.24,0.52,0.54
12,299,4,1167,6,3.05,1173,15.24,0.52,0.54
12,299,4,1167,6,3.05,1173,15.24,0.52,0.54
12,299,4,1167,6,3.05,1173,15.24,0.52,0.54
4,343,25,1196,7,3.4,1203,16.65,0.52,0.54
4,343,25,1196,7,3.4,1203,16.65,0.52,0.54
4,343,25,1196,7,3.4,1203,16.65,0.52,0.54
4,343,25,1196,7,3.4,1203,16.65,0.52,0.54
4,343,25,1196,7,3.4,1203,16.65,0.52,0.54
8,792,76,1178,10,4.94,1188,21.8,0.51,0.54
8,792,76,1178,10,4.94,1188,21.8,0.51,0.54
8,792,76,1178,10,4.94,1188,21.8,0.51,0.54
8,792,76,1178,10,4.94,1188,21.8,0.51,0.54
8,792,76,1178,10,4.94,1188,21.8,0.51,0.54
12,941,4,1198,17,8.45,1215,33.63,0.48,0.52
12,941,4,1198,17,8.45,1215,33.63,0.48,0.52
12,941,4,1198,17,8.45,1215,33.63,0.48,0.52
12,941,4,1198,17,8.45,1215,33.63,0.48,0.52
12,941,4,1198,17,8.45,1215,33.63,0.48,0.52
4,557,25,1255,5,2.28,1260,13.05,0.53,0.55
4,557,25,1255,5,2.28,1260,13.05,0.53,0.55
4,557,25,1255,5,2.28,1260,13.05,0.53,0.55
4,557,25,1255,5,2.28,1260,13.05,0.53,0.55
4,557,25,1255,5,2.28,1260,13.05,0.53,0.55
12,521,4,1251,20,10.19,1271,39.14,0.46,0.51
12,521,4,1251,20,10.19,1271,39.14,0.46,0.51
12,521,4,1251,20,10.19,1271,39.14,0.46,0.51
12,521,4,1251,20,10.19,1271,39.14,0.46,0.51
12,521,4,1251,20,10.19,1271,39.14,0.46,0.51
8,625,76,1281,7,3.73,1288,17.25,0.52,0.54
8,625,76,1281,7,3.73,1288,17.25,0.52,0.54
8,625,76,1281,7,3.73,1288,17.25,0.52,0.54
8,625,76,1281,7,3.73,1288,17.25,0.52,0.54
8,625,76,1281,7,3.73,1288,17.25,0.52,0.54
4,625,25,1309,16,8.18,1325,32.37,0.48,0.52
4,625,25,1309,16,8.18,1325,32.37,0.48,0.52
4,625,25,1309,16,8.18,1325,32.37,0.48,0.52
4,625,25,1309,16,8.18,1325,32.37,0.48,0.52
4,625,25,1309,16,8.18,1325,32.37,0.48,0.52
12,719,4,1315,8,3.98,1323,18.48,0.52,0.54
12,719,4,1315,8,3.98,1323,18.48,0.52,0.54
12,719,4,1315,8,3.98,1323,18.48,0.52,0.54
12,719,4,1315,8,3.98,1323,18.48,0.52,0.54
12,719,4,1315,8,3.98,1323,18.48,0.52,0.54
8,634,76,1358,5,2.42,1363,13.3,0.53,0.55
8,634,76,1358,5,2.42,1363,13.3,0.53,0.55
8,634,76,1358,5,2.42,1363,13.3,0.53,0.55
8,634,76,1358,5,2.42,1363,13.3,0.53,0.55
8,634,76,1358,5,2.42,1363,13.3,0.53,0.55
4,730,25,1416,17,8.58,1433,33.88,0.48,0.52
4,730,25,1416,17,8.58,1433,33.88,0.48,0.52
4,730,25,1416,17,8.58,1433,33.88,0.48,0.52
4,730,25,1416,17,8.58,1433,33.88,0.48,0.52
4,730,25,1416,17,8.58,1433,33.88,0.48,0.52
8,729,76,1427,7,3.49,1434,16.81,0.52,0.54
8,729,76,1427,7,3.49,1434,16.81,0.52,0.54
8,729,76,1427,7,3.49,1434,16.81,0.52,0.54
8,729,76,1427,7,3.49,1434,16.81,0.52,0.54
8,729,76,1427,7,3.49,1434,16.81,0.52,0.54
12,542,4,1434,11,5.31,1445,23.25,0.5,0.53
12,542,4,1434,11,5.31,1445,23.25,0.5,0.53
12,542,4,1434,11,5.31,1445,23.25,0.5,0.53
12,542,4,1434,11,5.31,1445,23.25,0.5,0.53
12,542,4,1434,11,5.31,1445,23.25,0.5,0.53
12,954,34,63,4,2.16,67,12.05,0.53,0.55
12,954,34,63,4,2.16,67,12.05,0.53,0.55
12,954,34,63,4,2.16,67,12.05,0.53,0.55
12,954,34,63,4,2.16,67,12.05,0.53,0.55
12,954,34,63,4,2.16,67,12.05,0.53,0.55
12,954,34,63,4,2.16,67,12.05,0.53,0.55
12,830,34,97,15,7.55,112,30.45,0.49,0.52
12,830,34,97,15,7.55,112,30.45,0.49,0.52
12,830,34,97,15,7.55,112,30.45,0.49,0.52
12,830,34,97,15,7.55,112,30.45,0.49,0.52
12,830,34,97,15,7.55,112,30.45,0.49,0.52
12,830,34,97,15,7.55,112,30.45,0.49,0.52
13,779,22,114,5,2.5,119,13.45,0.53,0.55
13,779,22,114,5,2.5,119,13.45,0.53,0.55
13,779,22,114,5,2.5,119,13.45,0.53,0.55
13,779,22,114,5,2.5,119,13.45,0.53,0.55
13,779,22,114,5,2.5,119,13.45,0.53,0.55
13,779,22,114,5,2.5,119,13.45,0.53,0.55
6,764,16,121,11,5.66,132,23.89,0.5,0.53
6,764,16,121,11,5.66,132,23.89,0.5,0.53
6,764,16,121,11,5.66,132,23.89,0.5,0.53
6,764,16,121,11,5.66,132,23.89,0.5,0.53
6,764,16,121,11,5.66,132,23.89,0.5,0.53
6,764,16,121,11,5.66,132,23.89,0.5,0.53
6,817,16,160,7,3.28,167,16.43,0.52,0.54
6,817,16,160,7,3.28,167,16.43,0.52,0.54
6,817,16,160,7,3.28,167,16.43,0.52,0.54
6,817,16,160,7,3.28,167,16.43,0.52,0.54
6,817,16,160,7,3.28,167,16.43,0.52,0.54
6,817,16,160,7,3.28,167,16.43,0.52,0.54
4,897,42,313,7,3.59,320,16.99,0.52,0.54
4,897,42,313,7,3.59,320,16.99,0.52,0.54
4,897,42,313,7,3.59,320,16.99,0.52,0.54
4,897,42,313,7,3.59,320,16.99,0.52,0.54
4,897,42,313,7,3.59,320,16.99,0.52,0.54
4,897,42,313,7,3.59,320,16.99,0.52,0.54
6,9,16,377,6,2.85,383,14.88,0.53,0.54
6,9,16,377,6,2.85,383,14.88,0.53,0.54
6,9,16,377,6,2.85,383,14.88,0.53,0.54
6,9,16,377,6,2.85,383,14.88,0.53,0.54
6,9,16,377,6,2.85,383,14.88,0.53,0.54
6,9,16,377,6,2.85,383,14.88,0.53,0.54
15,987,87,377,18,9.09,395,35.58,0.47000000000000003,0.52
15,987,87,377,18,9.09,395,35.58,0.47000000000000003,0.52
15,987,87,377,18,9.09,395,35.58,0.47000000000000003,0.52
15,987,87,377,18,9.09,395,35.58,0.47000000000000003,0.52
15,987,87,377,18,9.09,395,35.58,0.47000000000000003,0.52
15,987,87,377,18,9.09,395,35.58,0.47000000000000003,0.52
4,115,42,396,9,4.44,405,20.1,0.51,0.54
4,115,42,396,9,4.44,405,20.1,0.51,0.54
4,115,42,396,9,4.44,405,20.1,0.51,0.54
4,115,42,396,9,4.44,405,20.1,0.51,0.54
4,115,42,396,9,4.44,405,20.1,0.51,0.54
4,115,42,396,9,4.44,405,20.1,0.51,0.54
11,212,18,406,4,1.8800000000000001,410,11.55,0.53,0.55
11,212,18,406,4,1.8800000000000001,410,11.55,0.53,0.55
11,212,18,406,4,1.8800000000000001,410,11.55,0.53,0.55
11,212,18,406,4,1.8800000000000001,410,11.55,0.53,0.55
11,212,18,406,4,1.8800000000000001,410,11.55,0.53,0.55
11,212,18,406,4,1.8800000000000001,410,11.55,0.53,0.55
15,63,87,397,15,7.41,412,30.19,0.49,0.52
15,63,87,397,15,7.41,412,30.19,0.49,0.52
15,63,87,397,15,7.41,412,30.19,0.49,0.52
15,63,87,397,15,7.41,412,30.19,0.49,0.52
15,63,87,397,15,7.41,412,30.19,0.49,0.52
15,63,87,397,15,7.41,412,30.19,0.49,0.52
4,621,42,444,6,2.88,450,14.93,0.53,0.54
4,621,42,444,6,2.88,450,14.93,0.53,0.54
4,621,42,444,6,2.88,450,14.93,0.53,0.54
4,621,42,444,6,2.88,450,14.93,0.53,0.54
4,621,42,444,6,2.88,450,14.93,0.53,0.54
4,621,42,444,6,2.88,450,14.93,0.53,0.54
5,105,69,438,5,2.68,443,13.77,0.53,0.55
5,105,69,438,5,2.68,443,13.77,0.53,0.55
5,105,69,438,5,2.68,443,13.77,0.53,0.55
5,105,69,438,5,2.68,443,13.77,0.53,0.55
5,105,69,438,5,2.68,443,13.77,0.53,0.55
5,105,69,438,5,2.68,443,13.77,0.53,0.55
6,18,16,447,10,4.79,457,21.51,0.51,0.54
6,18,16,447,10,4.79,457,21.51,0.51,0.54
6,18,16,447,10,4.79,457,21.51,0.51,0.54
6,18,16,447,10,4.79,457,21.51,0.51,0.54
6,18,16,447,10,4.79,457,21.51,0.51,0.54
6,18,16,447,10,4.79,457,21.51,0.51,0.54
4,87,42,460,13,6.28,473,26.56,0.5,0.53
4,87,42,460,13,6.28,473,26.56,0.5,0.53
4,87,42,460,13,6.28,473,26.56,0.5,0.53
4,87,42,460,13,6.28,473,26.56,0.5,0.53
4,87,42,460,13,6.28,473,26.56,0.5,0.53
4,87,42,460,13,6.28,473,26.56,0.5,0.53
6,180,16,465,6,3.15,471,15.42,0.52,0.54
6,180,16,465,6,3.15,471,15.42,0.52,0.54
6,180,16,465,6,3.15,471,15.42,0.52,0.54
6,180,16,465,6,3.15,471,15.42,0.52,0.54
6,180,16,465,6,3.15,471,15.42,0.52,0.54
6,180,16,465,6,3.15,471,15.42,0.52,0.54
7,100,0,461,9,4.52,470,20.25,0.51,0.54
7,100,0,461,9,4.52,470,20.25,0.51,0.54
7,100,0,461,9,4.52,470,20.25,0.51,0.54
7,100,0,461,9,4.52,470,20.25,0.51,0.54
7,100,0,461,9,4.52,470,20.25,0.51,0.54
7,100,0,461,9,4.52,470,20.25,0.51,0.54
11,63,18,479,9,4.73,488,20.62,0.51,0.54
11,63,18,479,9,4.73,488,20.62,0.51,0.54
11,63,18,479,9,4.73,488,20.62,0.51,0.54
11,63,18,479,9,4.73,488,20.62,0.51,0.54
11,63,18,479,9,4.73,488,20.62,0.51,0.54
11,63,18,479,9,4.73,488,20.62,0.51,0.54
13,100,22,478,8,3.85,486,18.24,0.52,0.54
13,100,22,478,8,3.85,486,18.24,0.52,0.54
13,100,22,478,8,3.85,486,18.24,0.52,0.54
13,100,22,478,8,3.85,486,18.24,0.52,0.54
13,100,22,478,8,3.85,486,18.24,0.52,0.54
13,100,22,478,8,3.85,486,18.24,0.52,0.54
1,752,78,484,17,8.58,501,33.88,0.48,0.52
1,752,78,484,17,8.58,501,33.88,0.48,0.52
1,752,78,484,17,8.58,501,33.88,0.48,0.52
1,752,78,484,17,8.58,501,33.88,0.48,0.52
1,752,78,484,17,8.58,501,33.88,0.48,0.52
1,752,78,484,17,8.58,501,33.88,0.48,0.52
3,145,93,496,18,8.95,514,35.33,0.47000000000000003,0.52
3,145,93,496,18,8.95,514,35.33,0.47000000000000003,0.52
3,145,93,496,18,8.95,514,35.33,0.47000000000000003,0.52
3,145,93,496,18,8.95,514,35.33,0.47000000000000003,0.52
3,145,93,496,18,8.95,514,35.33,0.47000000000000003,0.52
3,145,93,496,18,8.95,514,35.33,0.47000000000000003,0.52
11,104,18,480,17,8.4,497,33.54,0.48,0.52
11,104,18,480,17,8.4,497,33.54,0.48,0.52
11,104,18,480,17,8.4,497,33.54,0.48,0.52
11,104,18,480,17,8.4,497,33.54,0.48,0.52
11,104,18,480,17,8.4,497,33.54,0.48,0.52
11,104,18,480,17,8.4,497,33.54,0.48,0.52
1,197,78,511,7,3.73,518,17.26,0.52,0.54
1,197,78,511,7,3.73,518,17.26,0.52,0.54
1,197,78,511,7,3.73,518,17.26,0.52,0.54
1,197,78,511,7,3.73,518,17.26,0.52,0.54
1,197,78,511,7,3.73,518,17.26,0.52,0.54
1,197,78,511,7,3.73,518,17.26,0.52,0.54
3,88,93,534,21,10.55,555,40.59,0.46,0.51
3,88,93,534,21,10.55,555,40.59,0.46,0.51
3,88,93,534,21,10.55,555,40.59,0.46,0.51
3,88,93,534,21,10.55,555,40.59,0.46,0.51
3,88,93,534,21,10.55,555,40.59,0.46,0.51
3,88,93,534,21,10.55,555,40.59,0.46,0.51
1,63,78,550,12,6.06,562,25.39,0.5,0.53
1,63,78,550,12,6.06,562,25.39,0.5,0.53
1,63,78,550,12,6.06,562,25.39,0.5,0.53
1,63,78,550,12,6.06,562,25.39,0.5,0.53
1,63,78,550,12,6.06,562,25.39,0.5,0.53
1,63,78,550,12,6.06,562,25.39,0.5,0.53
11,84,18,561,5,2.38,566,13.24,0.53,0.55
11,84,18,561,5,2.38,566,13.24,0.53,0.55
11,84,18,561,5,2.38,566,13.24,0.53,0.55
11,84,18,561,5,2.38,566,13.24,0.53,0.55
11,84,18,561,5,2.38,566,13.24,0.53,0.55
11,84,18,561,5,2.38,566,13.24,0.53,0.55
1,87,78,579,4,1.84,583,11.47,0.53,0.55
1,87,78,579,4,1.84,583,11.47,0.53,0.55
1,87,78,579,4,1.84,583,11.47,0.53,0.55
1,87,78,579,4,1.84,583,11.47,0.53,0.55
1,87,78,579,4,1.84,583,11.47,0.53,0.55
1,87,78,579,4,1.84,583,11.47,0.53,0.55
2,822,11,596,11,5.68,607,23.93,0.5,0.53
2,822,11,596,11,5.68,607,23.93,0.5,0.53
2,822,11,596,11,5.68,607,23.93,0.5,0.53
2,822,11,596,11,5.68,607,23.93,0.5,0.53
2,822,11,596,11,5.68,607,23.93,0.5,0.53
2,822,11,596,11,5.68,607,23.93,0.5,0.53
14,35,30,615,9,4.26,624,19.78,0.51,0.54
14,35,30,615,9,4.26,624,19.78,0.51,0.54
14,35,30,615,9,4.26,624,19.78,0.51,0.54
14,35,30,615,9,4.26,624,19.78,0.51,0.54
14,35,30,615,9,4.26,624,19.78,0.51,0.54
14,35,30,615,9,4.26,624,19.78,0.51,0.54
14,980,30,735,19,9.42,754,36.96,0.47000000000000003,0.52
14,980,30,735,19,9.42,754,36.96,0.47000000000000003,0.52
14,980,30,735,19,9.42,754,36.96,0.47000000000000003,0.52
14,980,30,735,19,9.42,754,36.96,0.47000000000000003,0.52
14,980,30,735,19,9.42,754,36.96,0.47000000000000003,0.52
14,980,30,735,19,9.42,754,36.96,0.47000000000000003,0.52
2,259,39,968,8,4.18,976,18.85,0.52,0.54
2,259,39,968,8,4.18,976,18.85,0.52,0.54
2,259,39,968,8,4.18,976,18.85,0.52,0.54
2,259,39,968,8,4.18,976,18.85,0.52,0.54
2,259,39,968,8,4.18,976,18.85,0.52,0.54
2,259,39,968,8,4.18,976,18.85,0.52,0.54
4,294,63,1014,7,3.55,1021,16.92,0.52,0.54
4,294,63,1014,7,3.55,1021,16.92,0.52,0.54
4,294,63,1014,7,3.55,1021,16.92,0.52,0.54
4,294,63,1014,7,3.55,1021,16.92,0.52,0.54
4,294,63,1014,7,3.55,1021,16.92,0.52,0.54
4,294,63,1014,7,3.55,1021,16.92,0.52,0.54
4,488,63,1046,10,5.25,1056,22.35,0.51,0.53
4,488,63,1046,10,5.25,1056,22.35,0.51,0.53
4,488,63,1046,10,5.25,1056,22.35,0.51,0.53
4,488,63,1046,10,5.25,1056,22.35,0.51,0.53
4,488,63,1046,10,5.25,1056,22.35,0.51,0.53
4,488,63,1046,10,5.25,1056,22.35,0.51,0.53
8,264,50,1047,4,2.19,1051,12.1,0.53,0.55
8,264,50,1047,4,2.19,1051,12.1,0.53,0.55
8,264,50,1047,4,2.19,1051,12.1,0.53,0.55
8,264,50,1047,4,2.19,1051,12.1,0.53,0.55
8,264,50,1047,4,2.19,1051,12.1,0.53,0.55
8,264,50,1047,4,2.19,1051,12.1,0.53,0.55
4,369,63,1105,11,5.47,1116,23.54,0.5,0.53
4,369,63,1105,11,5.47,1116,23.54,0.5,0.53
4,369,63,1105,11,5.47,1116,23.54,0.5,0.53
4,369,63,1105,11,5.47,1116,23.54,0.5,0.53
4,369,63,1105,11,5.47,1116,23.54,0.5,0.53
4,369,63,1105,11,5.47,1116,23.54,0.5,0.53
8,346,50,1090,18,8.76,1108,34.98,0.48,0.52
8,346,50,1090,18,8.76,1108,34.98,0.48,0.52
8,346,50,1090,18,8.76,1108,34.98,0.48,0.52
8,346,50,1090,18,8.76,1108,34.98,0.48,0.52
8,346,50,1090,18,8.76,1108,34.98,0.48,0.52
8,346,50,1090,18,8.76,1108,34.98,0.48,0.52
2,434,39,1126,2,1.15,1128,8.65,0.54,0.55
2,434,39,1126,2,1.15,1128,8.65,0.54,0.55
2,434,39,1126,2,1.15,1128,8.65,0.54,0.55
2,434,39,1126,2,1.15,1128,8.65,0.54,0.55
2,434,39,1126,2,1.15,1128,8.65,0.54,0.55
2,434,39,1126,2,1.15,1128,8.65,0.54,0.55
4,315,63,1121,17,8.72,1138,34.14,0.48,0.52
4,315,63,1121,17,8.72,1138,34.14,0.48,0.52
4,315,63,1121,17,8.72,1138,34.14,0.48,0.52
4,315,63,1121,17,8.72,1138,34.14,0.48,0.52
4,315,63,1121,17,8.72,1138,34.14,0.48,0.52
4,315,63,1121,17,8.72,1138,34.14,0.48,0.52
8,855,50,1131,12,6.09,1143,25.44,0.5,0.53
8,855,50,1131,12,6.09,1143,25.44,0.5,0.53
8,855,50,1131,12,6.09,1143,25.44,0.5,0.53
8,855,50,1131,12,6.09,1143,25.44,0.5,0.53
8,855,50,1131,12,6.09,1143,25.44,0.5,0.53
8,855,50,1131,12,6.09,1143,25.44,0.5,0.53
2,362,39,1143,18,8.8,1161,35.06,0.47000000000000003,0.52
2,362,39,1143,18,8.8,1161,35.06,0.47000000000000003,0.52
2,362,39,1143,18,8.8,1161,35.06,0.47000000000000003,0.52
2,362,39,1143,18,8.8,1161,35.06,0.47000000000000003,0.52
2,362,39,1143,18,8.8,1161,35.06,0.47000000000000003,0.52
2,362,39,1143,18,8.8,1161,35.06,0.47000000000000003,0.52
8,488,50,1157,4,2.2,1161,12.13,0.53,0.55
8,488,50,1157,4,2.2,1161,12.13,0.53,0.55
8,488,50,1157,4,2.2,1161,12.13,0.53,0.55
8,488,50,1157,4,2.2,1161,12.13,0.53,0.55
8,488,50,1157,4,2.2,1161,12.13,0.53,0.55
8,488,50,1157,4,2.2,1161,12.13,0.53,0.55
14,662,19,1173,9,4.67,1182,20.52,0.51,0.54
14,662,19,1173,9,4.67,1182,20.52,0.51,0.54
14,662,19,1173,9,4.67,1182,20.52,0.51,0.54
14,662,19,1173,9,4.67,1182,20.52,0.51,0.54
14,662,19,1173,9,4.67,1182,20.52,0.51,0.54
14,662,19,1173,9,4.67,1182,20.52,0.51,0.54
4,606,63,1216,4,1.85,1220,11.48,0.53,0.55
4,606,63,1216,4,1.85,1220,11.48,0.53,0.55
4,606,63,1216,4,1.85,1220,11.48,0.53,0.55
4,606,63,1216,4,1.85,1220,11.48,0.53,0.55
4,606,63,1216,4,1.85,1220,11.48,0.53,0.55
4,606,63,1216,4,1.85,1220,11.48,0.53,0.55
4,559,63,1247,4,1.8,1251,11.4,0.53,0.55
4,559,63,1247,4,1.8,1251,11.4,0.53,0.55
4,559,63,1247,4,1.8,1251,11.4,0.53,0.55
4,559,63,1247,4,1.8,1251,11.4,0.53,0.55
4,559,63,1247,4,1.8,1251,11.4,0.53,0.55
4,559,63,1247,4,1.8,1251,11.4,0.53,0.55
2,716,39,1284,11,5.48,1295,23.56,0.5,0.53
2,716,39,1284,11,5.48,1295,23.56,0.5,0.53
2,716,39,1284,11,5.48,1295,23.56,0.5,0.53
2,716,39,1284,11,5.48,1295,23.56,0.5,0.53
2,716,39,1284,11,5.48,1295,23.56,0.5,0.53
2,716,39,1284,11,5.48,1295,23.56,0.5,0.53
14,789,19,1277,19,9.63,1296,37.35,0.47000000000000003,0.52
14,789,19,1277,19,9.63,1296,37.35,0.47000000000000003,0.52
14,789,19,1277,19,9.63,1296,37.35,0.47000000000000003,0.52
14,789,19,1277,19,9.63,1296,37.35,0.47000000000000003,0.52
14,789,19,1277,19,9.63,1296,37.35,0.47000000000000003,0.52
14,789,19,1277,19,9.63,1296,37.35,0.47000000000000003,0.52
2,530,39,1298,5,2.6,1303,13.63,0.53,0.55
2,530,39,1298,5,2.6,1303,13.63,0.53,0.55
2,530,39,1298,5,2.6,1303,13.63,0.53,0.55
2,530,39,1298,5,2.6,1303,13.63,0.53,0.55
2,530,39,1298,5,2.6,1303,13.63,0.53,0.55
2,530,39,1298,5,2.6,1303,13.63,0.53,0.55
4,567,63,1314,18,8.87,1332,35.18,0.47000000000000003,0.52
4,567,63,1314,18,8.87,1332,35.18,0.47000000000000003,0.52
4,567,63,1314,18,8.87,1332,35.18,0.47000000000000003,0.52
4,567,63,1314,18,8.87,1332,35.18,0.47000000000000003,0.52
4,567,63,1314,18,8.87,1332,35.18,0.47000000000000003,0.52
4,567,63,1314,18,8.87,1332,35.18,0.47000000000000003,0.52
14,658,19,1299,15,7.56,1314,30.45,0.49,0.52
14,658,19,1299,15,7.56,1314,30.45,0.49,0.52
14,658,19,1299,15,7.56,1314,30.45,0.49,0.52
14,658,19,1299,15,7.56,1314,30.45,0.49,0.52
14,658,19,1299,15,7.56,1314,30.45,0.49,0.52
14,658,19,1299,15,7.56,1314,30.45,0.49,0.52
4,728,63,1345,11,5.44,1356,23.48,0.5,0.53
4,728,63,1345,11,5.44,1356,23.48,0.5,0.53
4,728,63,1345,11,5.44,1356,23.48,0.5,0.53
4,728,63,1345,11,5.44,1356,23.48,0.5,0.53
4,728,63,1345,11,5.44,1356,23.48,0.5,0.53
4,728,63,1345,11,5.44,1356,23.48,0.5,0.53
4,643,63,1356,19,9.4,1375,36.93,0.47000000000000003,0.52
4,643,63,1356,19,9.4,1375,36.93,0.47000000000000003,0.52
4,643,63,1356,19,9.4,1375,36.93,0.47000000000000003,0.52
4,643,63,1356,19,9.4,1375,36.93,0.47000000000000003,0.52
4,643,63,1356,19,9.4,1375,36.93,0.47000000000000003,0.52
4,643,63,1356,19,9.4,1375,36.93,0.47000000000000003,0.52
14,662,19,1350,14,6.97,1364,28.61,0.49,0.53
14,662,19,1350,14,6.97,1364,28.61,0.49,0.53
14,662,19,1350,14,6.97,1364,28.61,0.49,0.53
14,662,19,1350,14,6.97,1364,28.61,0.49,0.53
14,662,19,1350,14,6.97,1364,28.61,0.49,0.53
14,662,19,1350,14,6.97,1364,28.61,0.49,0.53
4,738,63,1407,4,2.14,1411,12.02,0.53,0.55
4,738,63,1407,4,2.14,1411,12.02,0.53,0.55
4,738,63,1407,4,2.14,1411,12.02,0.53,0.55
4,738,63,1407,4,2.14,1411,12.02,0.53,0.55
4,738,63,1407,4,2.14,1411,12.02,0.53,0.55
4,738,63,1407,4,2.14,1411,12.02,0.53,0.55
5,554,88,1390,9,4.36,1399,19.96,0.51,0.54
5,554,88,1390,9,4.36,1399,19.96,0.51,0.54
5,554,88,1390,9,4.36,1399,19.96,0.51,0.54
5,554,88,1390,9,4.36,1399,19.96,0.51,0.54
5,554,88,1390,9,4.36,1399,19.96,0.51,0.54
5,554,88,1390,9,4.36,1399,19.96,0.51,0.54
14,542,19,1406,17,8.4,1423,33.54,0.48,0.52
14,542,19,1406,17,8.4,1423,33.54,0.48,0.52
14,542,19,1406,17,8.4,1423,33.54,0.48,0.52
14,542,19,1406,17,8.4,1423,33.54,0.48,0.52
14,542,19,1406,17,8.4,1423,33.54,0.48,0.52
14,542,19,1406,17,8.4,1423,33.54,0.48,0.52
8,906,50,1413,19,9.73,1432,37.53,0.47000000000000003,0.52
8,906,50,1413,19,9.73,1432,37.53,0.47000000000000003,0.52
8,906,50,1413,19,9.73,1432,37.53,0.47000000000000003,0.52
8,906,50,1413,19,9.73,1432,37.53,0.47000000000000003,0.52
8,906,50,1413,19,9.73,1432,37.53,0.47000000000000003,0.52
8,906,50,1413,19,9.73,1432,37.53,0.47000000000000003,0.52
8,874,56,61,17,8.26,78,33.29,0.48,0.52
8,874,56,61,17,8.26,78,33.29,0.48,0.52
8,874,56,61,17,8.26,78,33.29,0.48,0.52
8,874,56,61,17,8.26,78,33.29,0.48,0.52
8,874,56,61,17,8.26,78,33.29,0.48,0.52
8,874,56,61,17,8.26,78,33.29,0.48,0.52
8,874,56,61,17,8.26,78,33.29,0.48,0.52
8,875,56,110,15,7.45,125,30.26,0.49,0.52
8,875,56,110,15,7.45,125,30.26,0.49,0.52
8,875,56,110,15,7.45,125,30.26,0.49,0.52
8,875,56,110,15,7.45,125,30.26,0.49,0.52
8,875,56,110,15,7.45,125,30.26,0.49,0.52
8,875,56,110,15,7.45,125,30.26,0.49,0.52
8,875,56,110,15,7.45,125,30.26,0.49,0.52
8,810,56,153,5,2.5100000000000002,158,13.47,0.53,0.55
8,810,56,153,5,2.5100000000000002,158,13.47,0.53,0.55
8,810,56,153,5,2.5100000000000002,158,13.47,0.53,0.55
8,810,56,153,5,2.5100000000000002,158,13.47,0.53,0.55
8,810,56,153,5,2.5100000000000002,158,13.47,0.53,0.55
8,810,56,153,5,2.5100000000000002,158,13.47,0.53,0.55
8,810,56,153,5,2.5100000000000002,158,13.47,0.53,0.55
4,106,59,388,6,3.08,394,15.28,0.52,0.54
4,106,59,388,6,3.08,394,15.28,0.52,0.54
4,106,59,388,6,3.08,394,15.28,0.52,0.54
4,106,59,388,6,3.08,394,15.28,0.52,0.54
4,106,59,388,6,3.08,394,15.28,0.52,0.54
4,106,59,388,6,3.08,394,15.28,0.52,0.54
4,106,59,388,6,3.08,394,15.28,0.52,0.54
8,188,56,399,13,6.32,412,26.64,0.5,0.53
8,188,56,399,13,6.32,412,26.64,0.5,0.53
8,188,56,399,13,6.32,412,26.64,0.5,0.53
8,188,56,399,13,6.32,412,26.64,0.5,0.53
8,188,56,399,13,6.32,412,26.64,0.5,0.53
8,188,56,399,13,6.32,412,26.64,0.5,0.53
8,188,56,399,13,6.32,412,26.64,0.5,0.53
6,241,13,440,7,3.64,447,17.09,0.52,0.54
6,241,13,440,7,3.64,447,17.09,0.52,0.54
6,241,13,440,7,3.64,447,17.09,0.52,0.54
6,241,13,440,7,3.64,447,17.09,0.52,0.54
6,241,13,440,7,3.64,447,17.09,0.52,0.54
6,241,13,440,7,3.64,447,17.09,0.52,0.54
6,241,13,440,7,3.64,447,17.09,0.52,0.54
8,185,56,431,6,3.19,437,15.48,0.52,0.54
8,185,56,431,6,3.19,437,15.48,0.52,0.54
8,185,56,431,6,3.19,437,15.48,0.52,0.54
8,185,56,431,6,3.19,437,15.48,0.52,0.54
8,185,56,431,6,3.19,437,15.48,0.52,0.54
8,185,56,431,6,3.19,437,15.48,0.52,0.54
8,185,56,431,6,3.19,437,15.48,0.52,0.54
13,202,36,435,20,10.12,455,39.01,0.47000000000000003,0.51
13,202,36,435,20,10.12,455,39.01,0.47000000000000003,0.51
13,202,36,435,20,10.12,455,39.01,0.47000000000000003,0.51
13,202,36,435,20,10.12,455,39.01,0.47000000000000003,0.51
13,202,36,435,20,10.12,455,39.01,0.47000000000000003,0.51
13,202,36,435,20,10.12,455,39.01,0.47000000000000003,0.51
13,202,36,435,20,10.12,455,39.01,0.47000000000000003,0.51
3,56,7,467,16,8.03,483,32.09,0.48,0.52
3,56,7,467,16,8.03,483,32.09,0.48,0.52
3,56,7,467,16,8.03,483,32.09,0.48,0.52
3,56,7,467,16,8.03,483,32.09,0.48,0.52
3,56,7,467,16,8.03,483,32.09,0.48,0.52
3,56,7,467,16,8.03,483,32.09,0.48,0.52
3,56,7,467,16,8.03,483,32.09,0.48,0.52
4,35,59,459,8,3.94,467,18.41,0.52,0.54
4,35,59,459,8,3.94,467,18.41,0.52,0.54
4,35,59,459,8,3.94,467,18.41,0.52,0.54
4,35,59,459,8,3.94,467,18.41,0.52,0.54
4,35,59,459,8,3.94,467,18.41,0.52,0.54
4,35,59,459,8,3.94,467,18.41,0.52,0.54
4,35,59,459,8,3.94,467,18.41,0.52,0.54
8,143,56,462,17,8.3,479,33.37,0.48,0.52
8,143,56,462,17,8.3,479,33.37,0.48,0.52
8,143,56,462,17,8.3,479,33.37,0.48,0.52
8,143,56,462,17,8.3,479,33.37,0.48,0.52
8,143,56,462,17,8.3,479,33.37,0.48,0.52
8,143,56,462,17,8.3,479,33.37,0.48,0.52
8,143,56,462,17,8.3,479,33.37,0.48,0.52
11,49,35,460,13,6.42,473,26.82,0.5,0.53
11,49,35,460,13,6.42,473,26.82,0.5,0.53
11,49,35,460,13,6.42,473,26.82,0.5,0.53
11,49,35,460,13,6.42,473,26.82,0.5,0.53
11,49,35,460,13,6.42,473,26.82,0.5,0.53
11,49,35,460,13,6.42,473,26.82,0.5,0.53
11,49,35,460,13,6.42,473,26.82,0.5,0.53
13,101,36,455,12,6.24,467,25.72,0.5,0.53
13,101,36,455,12,6.24,467,25.72,0.5,0.53
13,101,36,455,12,6.24,467,25.72,0.5,0.53
13,101,36,455,12,6.24,467,25.72,0.5,0.53
13,101,36,455,12,6.24,467,25.72,0.5,0.53
13,101,36,455,12,6.24,467,25.72,0.5,0.53
13,101,36,455,12,6.24,467,25.72,0.5,0.53
14,47,24,479,5,2.73,484,13.87,0.53,0.55
14,47,24,479,5,2.73,484,13.87,0.53,0.55
14,47,24,479,5,2.73,484,13.87,0.53,0.55
14,47,24,479,5,2.73,484,13.87,0.53,0.55
14,47,24,479,5,2.73,484,13.87,0.53,0.55
14,47,24,479,5,2.73,484,13.87,0.53,0.55
14,47,24,479,5,2.73,484,13.87,0.53,0.55
8,6,56,504,10,5.08,514,22.04,0.51,0.53
8,6,56,504,10,5.08,514,22.04,0.51,0.53
8,6,56,504,10,5.08,514,22.04,0.51,0.53
8,6,56,504,10,5.08,514,22.04,0.51,0.53
8,6,56,504,10,5.08,514,22.04,0.51,0.53
8,6,56,504,10,5.08,514,22.04,0.51,0.53
8,6,56,504,10,5.08,514,22.04,0.51,0.53
14,230,24,515,9,4.38,524,19.99,0.51,0.54
14,230,24,515,9,4.38,524,19.99,0.51,0.54
14,230,24,515,9,4.38,524,19.99,0.51,0.54
14,230,24,515,9,4.38,524,19.99,0.51,0.54
14,230,24,515,9,4.38,524,19.99,0.51,0.54
14,230,24,515,9,4.38,524,19.99,0.51,0.54
14,230,24,515,9,4.38,524,19.99,0.51,0.54
8,84,56,546,13,6.29,559,26.59,0.5,0.53
8,84,56,546,13,6.29,559,26.59,0.5,0.53
8,84,56,546,13,6.29,559,26.59,0.5,0.53
8,84,56,546,13,6.29,559,26.59,0.5,0.53
8,84,56,546,13,6.29,559,26.59,0.5,0.53
8,84,56,546,13,6.29,559,26.59,0.5,0.53
8,84,56,546,13,6.29,559,26.59,0.5,0.53
14,76,24,556,13,6.63,569,27.2,0.49,0.53
14,76,24,556,13,6.63,569,27.2,0.49,0.53
14,76,24,556,13,6.63,569,27.2,0.49,0.53
14,76,24,556,13,6.63,569,27.2,0.49,0.53
14,76,24,556,13,6.63,569,27.2,0.49,0.53
14,76,24,556,13,6.63,569,27.2,0.49,0.53
14,76,24,556,13,6.63,569,27.2,0.49,0.53
8,867,56,571,17,8.68,588,34.06,0.48,0.52
8,867,56,571,17,8.68,588,34.06,0.48,0.52
8,867,56,571,17,8.68,588,34.06,0.48,0.52
8,867,56,571,17,8.68,588,34.06,0.48,0.52
8,867,56,571,17,8.68,588,34.06,0.48,0.52
8,867,56,571,17,8.68,588,34.06,0.48,0.52
8,867,56,571,17,8.68,588,34.06,0.48,0.52
9,943,41,744,10,5.17,754,22.2,0.51,0.53
9,943,41,744,10,5.17,754,22.2,0.51,0.53
9,943,41,744,10,5.17,754,22.2,0.51,0.53
9,943,41,744,10,5.17,754,22.2,0.51,0.53
9,943,41,744,10,5.17,754,22.2,0.51,0.53
9,943,41,744,10,5.17,754,22.2,0.51,0.53
9,943,41,744,10,5.17,754,22.2,0.51,0.53
1,995,23,827,7,3.32,834,16.5,0.52,0.54
1,995,23,827,7,3.32,834,16.5,0.52,0.54
1,995,23,827,7,3.32,834,16.5,0.52,0.54
1,995,23,827,7,3.32,834,16.5,0.52,0.54
1,995,23,827,7,3.32,834,16.5,0.52,0.54
1,995,23,827,7,3.32,834,16.5,0.52,0.54
1,995,23,827,7,3.32,834,16.5,0.52,0.54
12,413,17,1010,11,5.52,1021,23.62,0.5,0.53
12,413,17,1010,11,5.52,1021,23.62,0.5,0.53
12,413,17,1010,11,5.52,1021,23.62,0.5,0.53
12,413,17,1010,11,5.52,1021,23.62,0.5,0.53
12,413,17,1010,11,5.52,1021,23.62,0.5,0.53
12,413,17,1010,11,5.52,1021,23.62,0.5,0.53
12,413,17,1010,11,5.52,1021,23.62,0.5,0.53
12,867,17,1021,11,5.43,1032,23.46,0.5,0.53
12,867,17,1021,11,5.43,1032,23.46,0.5,0.53
12,867,17,1021,11,5.43,1032,23.46,0.5,0.53
12,867,17,1021,11,5.43,1032,23.46,0.5,0.53
12,867,17,1021,11,5.43,1032,23.46,0.5,0.53
12,867,17,1021,11,5.43,1032,23.46,0.5,0.53
12,867,17,1021,11,5.43,1032,23.46,0.5,0.53
2,299,2,1056,11,5.33,1067,23.28,0.5,0.53
2,299,2,1056,11,5.33,1067,23.28,0.5,0.53
2,299,2,1056,11,5.33,1067,23.28,0.5,0.53
2,299,2,1056,11,5.33,1067,23.28,0.5,0.53
2,299,2,1056,11,5.33,1067,23.28,0.5,0.53
2,299,2,1056,11,5.33,1067,23.28,0.5,0.53
2,299,2,1056,11,5.33,1067,23.28,0.5,0.53
12,428,17,1089,11,5.73,1100,24.0,0.5,0.53
12,428,17,1089,11,5.73,1100,24.0,0.5,0.53
12,428,17,1089,11,5.73,1100,24.0,0.5,0.53
12,428,17,1089,11,5.73,1100,24.0,0.5,0.53
12,428,17,1089,11,5.73,1100,24.0,0.5,0.53
12,428,17,1089,11,5.73,1100,24.0,0.5,0.53
12,428,17,1089,11,5.73,1100,24.0,0.5,0.53
0,317,75,1134,8,4.22,1142,18.93,0.52,0.54
0,317,75,1134,8,4.22,1142,18.93,0.52,0.54
0,317,75,1134,8,4.22,1142,18.93,0.52,0.54
0,317,75,1134,8,4.22,1142,18.93,0.52,0.54
0,317,75,1134,8,4.22,1142,18.93,0.52,0.54
0,317,75,1134,8,4.22,1142,18.93,0.52,0.54
0,317,75,1134,8,4.22,1142,18.93,0.52,0.54
9,463,41,1111,6,3.03,1117,15.2,0.52,0.54
9,463,41,1111,6,3.03,1117,15.2,0.52,0.54
9,463,41,1111,6,3.03,1117,15.2,0.52,0.54
9,463,41,1111,6,3.03,1117,15.2,0.52,0.54
9,463,41,1111,6,3.03,1117,15.2,0.52,0.54
9,463,41,1111,6,3.03,1117,15.2,0.52,0.54
9,463,41,1111,6,3.03,1117,15.2,0.52,0.54
12,390,17,1128,11,5.52,1139,23.62,0.5,0.53
12,390,17,1128,11,5.52,1139,23.62,0.5,0.53
12,390,17,1128,11,5.52,1139,23.62,0.5,0.53
12,390,17,1128,11,5.52,1139,23.62,0.5,0.53
12,390,17,1128,11,5.52,1139,23.62,0.5,0.53
12,390,17,1128,11,5.52,1139,23.62,0.5,0.53
12,390,17,1128,11,5.52,1139,23.62,0.5,0.53
15,302,25,1123,15,7.3,1138,29.98,0.49,0.52
15,302,25,1123,15,7.3,1138,29.98,0.49,0.52
15,302,25,1123,15,7.3,1138,29.98,0.49,0.52
15,302,25,1123,15,7.3,1138,29.98,0.49,0.52
15,302,25,1123,15,7.3,1138,29.98,0.49,0.52
15,302,25,1123,15,7.3,1138,29.98,0.49,0.52
15,302,25,1123,15,7.3,1138,29.98,0.49,0.52
9,344,41,1142,6,2.99,1148,15.12,0.52,0.54
9,344,41,1142,6,2.99,1148,15.12,0.52,0.54
9,344,41,1142,6,2.99,1148,15.12,0.52,0.54
9,344,41,1142,6,2.99,1148,15.12,0.52,0.54
9,344,41,1142,6,2.99,1148,15.12,0.52,0.54
9,344,41,1142,6,2.99,1148,15.12,0.52,0.54
9,344,41,1142,6,2.99,1148,15.12,0.52,0.54
12,836,17,1168,7,3.34,1175,16.54,0.52,0.54
12,836,17,1168,7,3.34,1175,16.54,0.52,0.54
12,836,17,1168,7,3.34,1175,16.54,0.52,0.54
12,836,17,1168,7,3.34,1175,16.54,0.52,0.54
12,836,17,1168,7,3.34,1175,16.54,0.52,0.54
12,836,17,1168,7,3.34,1175,16.54,0.52,0.54
12,836,17,1168,7,3.34,1175,16.54,0.52,0.54
12,364,17,1197,5,2.47,1202,13.4,0.53,0.55
12,364,17,1197,5,2.47,1202,13.4,0.53,0.55
12,364,17,1197,5,2.47,1202,13.4,0.53,0.55
12,364,17,1197,5,2.47,1202,13.4,0.53,0.55
12,364,17,1197,5,2.47,1202,13.4,0.53,0.55
12,364,17,1197,5,2.47,1202,13.4,0.53,0.55
12,364,17,1197,5,2.47,1202,13.4,0.53,0.55
0,296,75,1220,5,2.42,1225,13.31,0.53,0.55
0,296,75,1220,5,2.42,1225,13.31,0.53,0.55
0,296,75,1220,5,2.42,1225,13.31,0.53,0.55
0,296,75,1220,5,2.42,1225,13.31,0.53,0.55
0,296,75,1220,5,2.42,1225,13.31,0.53,0.55
0,296,75,1220,5,2.42,1225,13.31,0.53,0.55
0,296,75,1220,5,2.42,1225,13.31,0.53,0.55
12,506,17,1214,7,3.53,1221,16.89,0.52,0.54
12,506,17,1214,7,3.53,1221,16.89,0.52,0.54
12,506,17,1214,7,3.53,1221,16.89,0.52,0.54
12,506,17,1214,7,3.53,1221,16.89,0.52,0.54
12,506,17,1214,7,3.53,1221,16.89,0.52,0.54
12,506,17,1214,7,3.53,1221,16.89,0.52,0.54
12,506,17,1214,7,3.53,1221,16.89,0.52,0.54
0,539,75,1238,14,7.11,1252,28.86,0.49,0.53
0,539,75,1238,14,7.11,1252,28.86,0.49,0.53
0,539,75,1238,14,7.11,1252,28.86,0.49,0.53
0,539,75,1238,14,7.11,1252,28.86,0.49,0.53
0,539,75,1238,14,7.11,1252,28.86,0.49,0.53
0,539,75,1238,14,7.11,1252,28.86,0.49,0.53
0,539,75,1238,14,7.11,1252,28.86,0.49,0.53
9,506,41,1240,10,5.17,1250,22.21,0.51,0.53
9,506,41,1240,10,5.17,1250,22.21,0.51,0.53
9,506,41,1240,10,5.17,1250,22.21,0.51,0.53
9,506,41,1240,10,5.17,1250,22.21,0.51,0.53
9,506,41,1240,10,5.17,1250,22.21,0.51,0.53
9,506,41,1240,10,5.17,1250,22.21,0.51,0.53
9,506,41,1240,10,5.17,1250,22.21,0.51,0.53
12,744,17,1233,13,6.52,1246,27.0,0.5,0.53
12,744,17,1233,13,6.52,1246,27.0,0.5,0.53
12,744,17,1233,13,6.52,1246,27.0,0.5,0.53
12,744,17,1233,13,6.52,1246,27.0,0.5,0.53
12,744,17,1233,13,6.52,1246,27.0,0.5,0.53
12,744,17,1233,13,6.52,1246,27.0,0.5,0.53
12,744,17,1233,13,6.52,1246,27.0,0.5,0.53
12,744,17,1264,10,4.99,1274,21.88,0.51,0.54
12,744,17,1264,10,4.99,1274,21.88,0.51,0.54
12,744,17,1264,10,4.99,1274,21.88,0.51,0.54
12,744,17,1264,10,4.99,1274,21.88,0.51,0.54
12,744,17,1264,10,4.99,1274,21.88,0.51,0.54
12,744,17,1264,10,4.99,1274,21.88,0.51,0.54
12,744,17,1264,10,4.99,1274,21.88,0.51,0.54
12,610,17,1300,3,1.3800000000000001,1303,9.86,0.54,0.55
12,610,17,1300,3,1.3800000000000001,1303,9.86,0.54,0.55
12,610,17,1300,3,1.3800000000000001,1303,9.86,0.54,0.55
12,610,17,1300,3,1.3800000000000001,1303,9.86,0.54,0.55
12,610,17,1300,3,1.3800000000000001,1303,9.86,0.54,0.55
12,610,17,1300,3,1.3800000000000001,1303,9.86,0.54,0.55
12,610,17,1300,3,1.3800000000000001,1303,9.86,0.54,0.55
13,745,96,1313,17,8.69,1330,34.08,0.48,0.52
13,745,96,1313,17,8.69,1330,34.08,0.48,0.52
13,745,96,1313,17,8.69,1330,34.08,0.48,0.52
13,745,96,1313,17,8.69,1330,34.08,0.48,0.52
13,745,96,1313,17,8.69,1330,34.08,0.48,0.52
13,745,96,1313,17,8.69,1330,34.08,0.48,0.52
13,745,96,1313,17,8.69,1330,34.08,0.48,0.52
9,708,41,1337,12,5.91,1349,25.12,0.5,0.53
9,708,41,1337,12,5.91,1349,25.12,0.5,0.53
9,708,41,1337,12,5.91,1349,25.12,0.5,0.53
9,708,41,1337,12,5.91,1349,25.12,0.5,0.53
9,708,41,1337,12,5.91,1349,25.12,0.5,0.53
9,708,41,1337,12,5.91,1349,25.12,0.5,0.53
9,708,41,1337,12,5.91,1349,25.12,0.5,0.53
12,724,17,1326,14,6.78,1340,28.27,0.49,0.53
12,724,17,1326,14,6.78,1340,28.27,0.49,0.53
12,724,17,1326,14,6.78,1340,28.27,0.49,0.53
12,724,17,1326,14,6.78,1340,28.27,0.49,0.53
12,724,17,1326,14,6.78,1340,28.27,0.49,0.53
12,724,17,1326,14,6.78,1340,28.27,0.49,0.53
12,724,17,1326,14,6.78,1340,28.27,0.49,0.53
12,500,17,1380,10,5.15,1390,22.17,0.51,0.53
12,500,17,1380,10,5.15,1390,22.17,0.51,0.53
12,500,17,1380,10,5.15,1390,22.17,0.51,0.53
12,500,17,1380,10,5.15,1390,22.17,0.51,0.53
12,500,17,1380,10,5.15,1390,22.17,0.51,0.53
12,500,17,1380,10,5.15,1390,22.17,0.51,0.53
12,500,17,1380,10,5.15,1390,22.17,0.51,0.53
12,812,17,1427,8,4.15,1435,18.8,0.52,0.54
12,812,17,1427,8,4.15,1435,18.8,0.52,0.54
12,812,17,1427,8,4.15,1435,18.8,0.52,0.54
12,812,17,1427,8,4.15,1435,18.8,0.52,0.54
12,812,17,1427,8,4.15,1435,18.8,0.52,0.54
12,812,17,1427,8,4.15,1435,18.8,0.52,0.54
12,812,17,1427,8,4.15,1435,18.8,0.52,0.54
