square_index,rider_id,driver_idx,trip_start_timestamp,trip_duration,ride_miles,trip_end_timestamp,price_of_ride,rider_acceptance_prob,driver_acceptance_prob
12,944,58,301,16,7.98,317,32.01,0.48,0.52
1,825,35,382,10,4.98,392,21.87,0.51,0.54
1,925,35,429,11,5.47,440,23.54,0.5,0.53
4,216,9,446,7,3.54,453,16.9,0.52,0.54
6,45,22,447,15,7.26,462,29.91,0.49,0.53
9,113,86,444,2,1.07,446,8.5,0.54,0.55
11,92,10,444,14,6.92,458,28.51,0.49,0.53
4,195,9,462,13,6.52,475,27.0,0.49,0.53
6,108,22,478,2,0.97,480,8.32,0.54,0.55
9,10,86,469,7,3.5100000000000002,476,16.85,0.52,0.54
1,140,35,483,7,3.42,490,16.69,0.52,0.54
4,101,9,501,7,3.31,508,16.49,0.52,0.54
4,51,9,530,16,7.79,546,31.65,0.48,0.52
15,117,92,545,8,4.16,553,18.81,0.52,0.54
1,545,35,597,9,4.51,606,20.23,0.51,0.54
14,0,39,619,9,4.46,628,20.13,0.51,0.54
2,816,6,771,4,1.98,775,11.73,0.53,0.55
9,446,65,982,15,7.32,997,30.02,0.49,0.52
9,390,65,1007,9,4.68,1016,20.53,0.51,0.54
11,345,15,1007,13,6.51,1020,26.99,0.5,0.53
9,986,65,1070,4,2.1,1074,11.93,0.53,0.55
2,368,6,1100,12,5.91,1112,25.11,0.5,0.53
9,494,65,1139,16,8.23,1155,32.45,0.48,0.52
4,494,60,1175,3,1.73,1178,10.49,0.54,0.55
4,657,60,1269,11,5.74,1280,24.03,0.5,0.53
4,521,60,1300,5,2.35,1305,13.18,0.53,0.55
4,533,60,1324,15,7.71,1339,30.72,0.49,0.52
9,528,65,1321,10,5.11,1331,22.1,0.51,0.53
1,667,37,1384,11,5.46,1395,23.51,0.5,0.53
9,547,65,1386,9,4.44,1395,20.09,0.51,0.54
4,590,60,1411,6,3.11,1417,15.35,0.52,0.54
7,808,5,1434,9,4.72,1443,20.6,0.51,0.54
6,235,98,383,6,2.82,389,14.81,0.53,0.54
6,235,98,383,6,2.82,389,14.81,0.53,0.54
6,122,98,409,10,5.21,419,22.28,0.51,0.53
6,122,98,409,10,5.21,419,22.28,0.51,0.53
2,5,28,444,15,7.48,459,30.32,0.49,0.52
2,5,28,444,15,7.48,459,30.32,0.49,0.52
3,194,55,425,7,3.31,432,16.49,0.52,0.54
3,194,55,425,7,3.31,432,16.49,0.52,0.54
6,211,98,426,5,2.69,431,13.8,0.53,0.55
6,211,98,426,5,2.69,431,13.8,0.53,0.55
2,111,28,479,21,10.52,500,40.52,0.46,0.51
2,111,28,479,21,10.52,500,40.52,0.46,0.51
15,145,10,516,13,6.42,529,26.83,0.5,0.53
15,145,10,516,13,6.42,529,26.83,0.5,0.53
5,108,27,546,1,0.68,547,7.02,0.54,0.55
5,108,27,546,1,0.68,547,7.02,0.54,0.55
15,48,10,544,14,6.8,558,28.3,0.49,0.53
15,48,10,544,14,6.8,558,28.3,0.49,0.53
15,819,10,655,15,7.35,670,30.08,0.49,0.52
15,819,10,655,15,7.35,670,30.08,0.49,0.52
5,105,27,660,3,1.54,663,10.15,0.54,0.55
5,105,27,660,3,1.54,663,10.15,0.54,0.55
2,999,28,723,8,4.09,731,18.68,0.52,0.54
2,999,28,723,8,4.09,731,18.68,0.52,0.54
2,827,28,825,2,1.21,827,8.76,0.54,0.55
2,827,28,825,2,1.21,827,8.76,0.54,0.55
15,984,10,838,9,4.28,847,19.8,0.51,0.54
15,984,10,838,9,4.28,847,19.8,0.51,0.54
2,985,28,863,6,3.14,869,15.39,0.52,0.54
2,985,28,863,6,3.14,869,15.39,0.52,0.54
4,806,86,859,12,5.85,871,25.01,0.5,0.53
4,806,86,859,12,5.85,871,25.01,0.5,0.53
1,916,68,883,12,5.79,895,24.9,0.5,0.53
1,916,68,883,12,5.79,895,24.9,0.5,0.53
1,973,68,932,16,7.78,948,31.65,0.48,0.52
1,973,68,932,16,7.78,948,31.65,0.48,0.52
2,250,28,943,7,3.48,950,16.8,0.52,0.54
2,250,28,943,7,3.48,950,16.8,0.52,0.54
7,903,41,954,12,5.99,966,25.26,0.5,0.53
7,903,41,954,12,5.99,966,25.26,0.5,0.53
7,494,41,969,7,3.72,976,17.23,0.52,0.54
7,494,41,969,7,3.72,976,17.23,0.52,0.54
7,289,41,996,9,4.69,1005,20.56,0.51,0.54
7,289,41,996,9,4.69,1005,20.56,0.51,0.54
12,351,17,1013,15,7.45,1028,30.25,0.49,0.52
12,351,17,1013,15,7.45,1028,30.25,0.49,0.52
8,292,35,1046,12,6.0,1058,25.28,0.5,0.53
8,292,35,1046,12,6.0,1058,25.28,0.5,0.53
12,997,17,1044,13,6.3,1057,26.61,0.5,0.53
12,997,17,1044,13,6.3,1057,26.61,0.5,0.53
8,263,35,1055,10,4.96,1065,21.83,0.51,0.54
8,263,35,1055,10,4.96,1065,21.83,0.51,0.54
12,277,17,1093,6,2.9,1099,14.96,0.53,0.54
12,277,17,1093,6,2.9,1099,14.96,0.53,0.54
8,478,35,1115,5,2.58,1120,13.59,0.53,0.55
8,478,35,1115,5,2.58,1120,13.59,0.53,0.55
10,446,37,1113,11,5.48,1124,23.56,0.5,0.53
10,446,37,1113,11,5.48,1124,23.56,0.5,0.53
8,450,35,1185,6,2.92,1191,15.0,0.52,0.54
8,450,35,1185,6,2.92,1191,15.0,0.52,0.54
7,276,41,1282,12,6.0,1294,25.28,0.5,0.53
7,276,41,1282,12,6.0,1294,25.28,0.5,0.53
8,528,35,1281,3,1.32,1284,9.73,0.54,0.55
8,528,35,1281,3,1.32,1284,9.73,0.54,0.55
14,722,77,1269,18,9.22,1287,35.82,0.47000000000000003,0.52
14,722,77,1269,18,9.22,1287,35.82,0.47000000000000003,0.52
14,657,77,1315,16,8.03,1331,32.1,0.48,0.52
14,657,77,1315,16,8.03,1331,32.1,0.48,0.52
7,537,41,1352,19,9.51,1371,37.12,0.47000000000000003,0.52
7,537,41,1352,19,9.51,1371,37.12,0.47000000000000003,0.52
14,639,77,1357,5,2.43,1362,13.33,0.53,0.55
14,639,77,1357,5,2.43,1362,13.33,0.53,0.55
2,983,95,277,7,3.25,284,16.38,0.52,0.54
2,983,95,277,7,3.25,284,16.38,0.52,0.54
2,983,95,277,7,3.25,284,16.38,0.52,0.54
11,79,92,331,12,6.08,343,25.42,0.5,0.53
11,79,92,331,12,6.08,343,25.42,0.5,0.53
11,79,92,331,12,6.08,343,25.42,0.5,0.53
9,197,90,363,7,3.55,370,16.91,0.52,0.54
9,197,90,363,7,3.55,370,16.91,0.52,0.54
9,197,90,363,7,3.55,370,16.91,0.52,0.54
12,536,56,388,10,5.01,398,21.91,0.51,0.54
12,536,56,388,10,5.01,398,21.91,0.51,0.54
12,536,56,388,10,5.01,398,21.91,0.51,0.54
11,121,92,392,11,5.49,403,23.57,0.5,0.53
11,121,92,392,11,5.49,403,23.57,0.5,0.53
11,121,92,392,11,5.49,403,23.57,0.5,0.53
12,94,56,400,16,7.89,416,31.85,0.48,0.52
12,94,56,400,16,7.89,416,31.85,0.48,0.52
12,94,56,400,16,7.89,416,31.85,0.48,0.52
13,70,3,414,12,6.15,426,25.56,0.5,0.53
13,70,3,414,12,6.15,426,25.56,0.5,0.53
13,70,3,414,12,6.15,426,25.56,0.5,0.53
12,245,56,431,20,10.07,451,38.92,0.47000000000000003,0.51
12,245,56,431,20,10.07,451,38.92,0.47000000000000003,0.51
12,245,56,431,20,10.07,451,38.92,0.47000000000000003,0.51
13,29,3,441,1,0.67,442,7.0,0.54,0.55
13,29,3,441,1,0.67,442,7.0,0.54,0.55
13,29,3,441,1,0.67,442,7.0,0.54,0.55
12,121,56,475,17,8.34,492,33.44,0.48,0.52
12,121,56,475,17,8.34,492,33.44,0.48,0.52
12,121,56,475,17,8.34,492,33.44,0.48,0.52
9,69,90,484,17,8.63,501,33.97,0.48,0.52
9,69,90,484,17,8.63,501,33.97,0.48,0.52
9,69,90,484,17,8.63,501,33.97,0.48,0.52
12,61,56,494,12,6.18,506,25.61,0.5,0.53
12,61,56,494,12,6.18,506,25.61,0.5,0.53
12,61,56,494,12,6.18,506,25.61,0.5,0.53
13,108,3,506,9,4.74,515,20.64,0.51,0.54
13,108,3,506,9,4.74,515,20.64,0.51,0.54
13,108,3,506,9,4.74,515,20.64,0.51,0.54
1,655,89,511,10,5.16,521,22.19,0.51,0.53
1,655,89,511,10,5.16,521,22.19,0.51,0.53
1,655,89,511,10,5.16,521,22.19,0.51,0.53
6,128,85,534,6,2.79,540,14.75,0.53,0.54
6,128,85,534,6,2.79,540,14.75,0.53,0.54
6,128,85,534,6,2.79,540,14.75,0.53,0.54
9,122,90,522,13,6.37,535,26.73,0.5,0.53
9,122,90,522,13,6.37,535,26.73,0.5,0.53
9,122,90,522,13,6.37,535,26.73,0.5,0.53
12,229,56,524,24,12.16,548,45.84,0.45,0.51
12,229,56,524,24,12.16,548,45.84,0.45,0.51
12,229,56,524,24,12.16,548,45.84,0.45,0.51
13,107,3,520,21,10.38,541,40.27,0.46,0.51
13,107,3,520,21,10.38,541,40.27,0.46,0.51
13,107,3,520,21,10.38,541,40.27,0.46,0.51
1,94,89,550,6,3.03,556,15.2,0.52,0.54
1,94,89,550,6,3.03,556,15.2,0.52,0.54
1,94,89,550,6,3.03,556,15.2,0.52,0.54
13,58,3,564,5,2.36,569,13.2,0.53,0.55
13,58,3,564,5,2.36,569,13.2,0.53,0.55
13,58,3,564,5,2.36,569,13.2,0.53,0.55
6,69,85,576,6,3.25,582,15.59,0.52,0.54
6,69,85,576,6,3.25,582,15.59,0.52,0.54
6,69,85,576,6,3.25,582,15.59,0.52,0.54
1,890,89,648,21,10.38,669,40.26,0.46,0.51
1,890,89,648,21,10.38,669,40.26,0.46,0.51
1,890,89,648,21,10.38,669,40.26,0.46,0.51
4,816,19,667,3,1.54,670,10.15,0.54,0.55
4,816,19,667,3,1.54,670,10.15,0.54,0.55
4,816,19,667,3,1.54,670,10.15,0.54,0.55
4,809,19,707,3,1.29,710,9.68,0.54,0.55
4,809,19,707,3,1.29,710,9.68,0.54,0.55
4,809,19,707,3,1.29,710,9.68,0.54,0.55
1,810,89,763,16,7.88,779,31.81,0.48,0.52
1,810,89,763,16,7.88,779,31.81,0.48,0.52
1,810,89,763,16,7.88,779,31.81,0.48,0.52
9,897,90,751,12,6.2,763,25.64,0.5,0.53
9,897,90,751,12,6.2,763,25.64,0.5,0.53
9,897,90,751,12,6.2,763,25.64,0.5,0.53
15,969,20,771,5,2.47,776,13.4,0.53,0.55
15,969,20,771,5,2.47,776,13.4,0.53,0.55
15,969,20,771,5,2.47,776,13.4,0.53,0.55
14,797,41,838,11,5.72,849,23.99,0.5,0.53
14,797,41,838,11,5.72,849,23.99,0.5,0.53
14,797,41,838,11,5.72,849,23.99,0.5,0.53
10,808,58,882,8,4.07,890,18.65,0.52,0.54
10,808,58,882,8,4.07,890,18.65,0.52,0.54
10,808,58,882,8,4.07,890,18.65,0.52,0.54
6,278,85,1011,7,3.44,1018,16.73,0.52,0.54
6,278,85,1011,7,3.44,1018,16.73,0.52,0.54
6,278,85,1011,7,3.44,1018,16.73,0.52,0.54
3,359,67,1022,7,3.45,1029,16.74,0.52,0.54
3,359,67,1022,7,3.45,1029,16.74,0.52,0.54
3,359,67,1022,7,3.45,1029,16.74,0.52,0.54
12,454,98,1039,6,2.89,1045,14.95,0.53,0.54
12,454,98,1039,6,2.89,1045,14.95,0.53,0.54
12,454,98,1039,6,2.89,1045,14.95,0.53,0.54
3,461,67,1064,3,1.61,1067,10.26,0.54,0.55
3,461,67,1064,3,1.61,1067,10.26,0.54,0.55
3,461,67,1064,3,1.61,1067,10.26,0.54,0.55
5,250,80,1057,11,5.73,1068,24.01,0.5,0.53
5,250,80,1057,11,5.73,1068,24.01,0.5,0.53
5,250,80,1057,11,5.73,1068,24.01,0.5,0.53
4,250,19,1130,6,2.91,1136,14.98,0.53,0.54
4,250,19,1130,6,2.91,1136,14.98,0.53,0.54
4,250,19,1130,6,2.91,1136,14.98,0.53,0.54
5,365,80,1112,14,6.83,1126,28.35,0.49,0.53
5,365,80,1112,14,6.83,1126,28.35,0.49,0.53
5,365,80,1112,14,6.83,1126,28.35,0.49,0.53
5,475,80,1143,10,4.98,1153,21.86,0.51,0.54
5,475,80,1143,10,4.98,1153,21.86,0.51,0.54
5,475,80,1143,10,4.98,1153,21.86,0.51,0.54
5,277,80,1174,14,6.94,1188,28.56,0.49,0.53
5,277,80,1174,14,6.94,1188,28.56,0.49,0.53
5,277,80,1174,14,6.94,1188,28.56,0.49,0.53
5,634,80,1253,4,1.78,1257,11.35,0.53,0.55
5,634,80,1253,4,1.78,1257,11.35,0.53,0.55
5,634,80,1253,4,1.78,1257,11.35,0.53,0.55
12,935,18,131,13,6.44,144,26.86,0.5,0.53
12,935,18,131,13,6.44,144,26.86,0.5,0.53
12,935,18,131,13,6.44,144,26.86,0.5,0.53
12,935,18,131,13,6.44,144,26.86,0.5,0.53
1,903,98,235,11,5.38,246,23.37,0.5,0.53
1,903,98,235,11,5.38,246,23.37,0.5,0.53
1,903,98,235,11,5.38,246,23.37,0.5,0.53
1,903,98,235,11,5.38,246,23.37,0.5,0.53
12,898,18,236,10,5.15,246,22.17,0.51,0.53
12,898,18,236,10,5.15,246,22.17,0.51,0.53
12,898,18,236,10,5.15,246,22.17,0.51,0.53
12,898,18,236,10,5.15,246,22.17,0.51,0.53
14,20,60,388,5,2.37,393,13.21,0.53,0.55
14,20,60,388,5,2.37,393,13.21,0.53,0.55
14,20,60,388,5,2.37,393,13.21,0.53,0.55
14,20,60,388,5,2.37,393,13.21,0.53,0.55
4,86,9,401,14,7.13,415,28.89,0.49,0.53
4,86,9,401,14,7.13,415,28.89,0.49,0.53
4,86,9,401,14,7.13,415,28.89,0.49,0.53
4,86,9,401,14,7.13,415,28.89,0.49,0.53
15,606,17,414,4,1.83,418,11.45,0.53,0.55
15,606,17,414,4,1.83,418,11.45,0.53,0.55
15,606,17,414,4,1.83,418,11.45,0.53,0.55
15,606,17,414,4,1.83,418,11.45,0.53,0.55
0,825,23,432,4,1.94,436,11.66,0.53,0.55
0,825,23,432,4,1.94,436,11.66,0.53,0.55
0,825,23,432,4,1.94,436,11.66,0.53,0.55
0,825,23,432,4,1.94,436,11.66,0.53,0.55
4,19,9,449,16,7.86,465,31.78,0.48,0.52
4,19,9,449,16,7.86,465,31.78,0.48,0.52
4,19,9,449,16,7.86,465,31.78,0.48,0.52
4,19,9,449,16,7.86,465,31.78,0.48,0.52
8,832,96,446,4,1.98,450,11.73,0.53,0.55
8,832,96,446,4,1.98,450,11.73,0.53,0.55
8,832,96,446,4,1.98,450,11.73,0.53,0.55
8,832,96,446,4,1.98,450,11.73,0.53,0.55
10,175,15,431,4,2.24,435,12.19,0.53,0.55
10,175,15,431,4,2.24,435,12.19,0.53,0.55
10,175,15,431,4,2.24,435,12.19,0.53,0.55
10,175,15,431,4,2.24,435,12.19,0.53,0.55
14,16,60,445,3,1.56,448,10.18,0.54,0.55
14,16,60,445,3,1.56,448,10.18,0.54,0.55
14,16,60,445,3,1.56,448,10.18,0.54,0.55
14,16,60,445,3,1.56,448,10.18,0.54,0.55
1,76,98,462,6,2.95,468,15.06,0.52,0.54
1,76,98,462,6,2.95,468,15.06,0.52,0.54
1,76,98,462,6,2.95,468,15.06,0.52,0.54
1,76,98,462,6,2.95,468,15.06,0.52,0.54
6,246,88,479,13,6.31,492,26.62,0.5,0.53
6,246,88,479,13,6.31,492,26.62,0.5,0.53
6,246,88,479,13,6.31,492,26.62,0.5,0.53
6,246,88,479,13,6.31,492,26.62,0.5,0.53
8,108,96,457,13,6.34,470,26.68,0.5,0.53
8,108,96,457,13,6.34,470,26.68,0.5,0.53
8,108,96,457,13,6.34,470,26.68,0.5,0.53
8,108,96,457,13,6.34,470,26.68,0.5,0.53
10,76,15,454,8,4.19,462,18.86,0.52,0.54
10,76,15,454,8,4.19,462,18.86,0.52,0.54
10,76,15,454,8,4.19,462,18.86,0.52,0.54
10,76,15,454,8,4.19,462,18.86,0.52,0.54
13,211,86,468,19,9.25,487,36.66,0.47000000000000003,0.52
13,211,86,468,19,9.25,487,36.66,0.47000000000000003,0.52
13,211,86,468,19,9.25,487,36.66,0.47000000000000003,0.52
13,211,86,468,19,9.25,487,36.66,0.47000000000000003,0.52
14,154,60,461,11,5.64,472,23.84,0.5,0.53
14,154,60,461,11,5.64,472,23.84,0.5,0.53
14,154,60,461,11,5.64,472,23.84,0.5,0.53
14,154,60,461,11,5.64,472,23.84,0.5,0.53
0,194,23,496,10,4.75,506,21.45,0.51,0.54
0,194,23,496,10,4.75,506,21.45,0.51,0.54
0,194,23,496,10,4.75,506,21.45,0.51,0.54
0,194,23,496,10,4.75,506,21.45,0.51,0.54
2,25,16,491,21,10.41,512,40.32,0.46,0.51
2,25,16,491,21,10.41,512,40.32,0.46,0.51
2,25,16,491,21,10.41,512,40.32,0.46,0.51
2,25,16,491,21,10.41,512,40.32,0.46,0.51
8,25,96,498,10,5.1,508,22.08,0.51,0.53
8,25,96,498,10,5.1,508,22.08,0.51,0.53
8,25,96,498,10,5.1,508,22.08,0.51,0.53
8,25,96,498,10,5.1,508,22.08,0.51,0.53
10,56,15,507,14,7.02,521,28.71,0.49,0.53
10,56,15,507,14,7.02,521,28.71,0.49,0.53
10,56,15,507,14,7.02,521,28.71,0.49,0.53
10,56,15,507,14,7.02,521,28.71,0.49,0.53
13,47,86,480,17,8.68,497,34.05,0.48,0.52
13,47,86,480,17,8.68,497,34.05,0.48,0.52
13,47,86,480,17,8.68,497,34.05,0.48,0.52
13,47,86,480,17,8.68,497,34.05,0.48,0.52
14,196,60,499,10,4.88,509,21.68,0.51,0.54
14,196,60,499,10,4.88,509,21.68,0.51,0.54
14,196,60,499,10,4.88,509,21.68,0.51,0.54
14,196,60,499,10,4.88,509,21.68,0.51,0.54
0,179,23,520,7,3.41,527,16.66,0.52,0.54
0,179,23,520,7,3.41,527,16.66,0.52,0.54
0,179,23,520,7,3.41,527,16.66,0.52,0.54
0,179,23,520,7,3.41,527,16.66,0.52,0.54
8,10,96,512,10,5.24,522,22.34,0.51,0.53
8,10,96,512,10,5.24,522,22.34,0.51,0.53
8,10,96,512,10,5.24,522,22.34,0.51,0.53
8,10,96,512,10,5.24,522,22.34,0.51,0.53
10,23,15,511,7,3.67,518,17.14,0.52,0.54
10,23,15,511,7,3.67,518,17.14,0.52,0.54
10,23,15,511,7,3.67,518,17.14,0.52,0.54
10,23,15,511,7,3.67,518,17.14,0.52,0.54
0,937,23,544,13,6.35,557,26.7,0.5,0.53
0,937,23,544,13,6.35,557,26.7,0.5,0.53
0,937,23,544,13,6.35,557,26.7,0.5,0.53
0,937,23,544,13,6.35,557,26.7,0.5,0.53
8,898,96,552,12,6.01,564,25.29,0.5,0.53
8,898,96,552,12,6.01,564,25.29,0.5,0.53
8,898,96,552,12,6.01,564,25.29,0.5,0.53
8,898,96,552,12,6.01,564,25.29,0.5,0.53
10,106,15,549,6,3.09,555,15.31,0.52,0.54
10,106,15,549,6,3.09,555,15.31,0.52,0.54
10,106,15,549,6,3.09,555,15.31,0.52,0.54
10,106,15,549,6,3.09,555,15.31,0.52,0.54
13,106,86,552,6,2.99,558,15.13,0.52,0.54
13,106,86,552,6,2.99,558,15.13,0.52,0.54
13,106,86,552,6,2.99,558,15.13,0.52,0.54
13,106,86,552,6,2.99,558,15.13,0.52,0.54
14,28,60,546,8,4.05,554,18.61,0.52,0.54
14,28,60,546,8,4.05,554,18.61,0.52,0.54
14,28,60,546,8,4.05,554,18.61,0.52,0.54
14,28,60,546,8,4.05,554,18.61,0.52,0.54
0,124,23,605,16,8.19,621,32.39,0.48,0.52
0,124,23,605,16,8.19,621,32.39,0.48,0.52
0,124,23,605,16,8.19,621,32.39,0.48,0.52
0,124,23,605,16,8.19,621,32.39,0.48,0.52
13,179,86,605,2,1.01,607,8.4,0.54,0.55
13,179,86,605,2,1.01,607,8.4,0.54,0.55
13,179,86,605,2,1.01,607,8.4,0.54,0.55
13,179,86,605,2,1.01,607,8.4,0.54,0.55
2,994,16,661,11,5.49,672,23.57,0.5,0.53
2,994,16,661,11,5.49,672,23.57,0.5,0.53
2,994,16,661,11,5.49,672,23.57,0.5,0.53
2,994,16,661,11,5.49,672,23.57,0.5,0.53
7,939,45,688,7,3.57,695,16.96,0.52,0.54
7,939,45,688,7,3.57,695,16.96,0.52,0.54
7,939,45,688,7,3.57,695,16.96,0.52,0.54
7,939,45,688,7,3.57,695,16.96,0.52,0.54
11,896,65,678,12,6.11,690,25.47,0.5,0.53
11,896,65,678,12,6.11,690,25.47,0.5,0.53
11,896,65,678,12,6.11,690,25.47,0.5,0.53
11,896,65,678,12,6.11,690,25.47,0.5,0.53
11,984,65,721,9,4.35,730,19.94,0.51,0.54
11,984,65,721,9,4.35,730,19.94,0.51,0.54
11,984,65,721,9,4.35,730,19.94,0.51,0.54
11,984,65,721,9,4.35,730,19.94,0.51,0.54
7,997,45,914,3,1.27,917,9.65,0.54,0.55
7,997,45,914,3,1.27,917,9.65,0.54,0.55
7,997,45,914,3,1.27,917,9.65,0.54,0.55
7,997,45,914,3,1.27,917,9.65,0.54,0.55
0,251,23,938,7,3.46,945,16.76,0.52,0.54
0,251,23,938,7,3.46,945,16.76,0.52,0.54
0,251,23,938,7,3.46,945,16.76,0.52,0.54
0,251,23,938,7,3.46,945,16.76,0.52,0.54
2,366,16,937,13,6.31,950,26.63,0.5,0.53
2,366,16,937,13,6.31,950,26.63,0.5,0.53
2,366,16,937,13,6.31,950,26.63,0.5,0.53
2,366,16,937,13,6.31,950,26.63,0.5,0.53
1,955,67,983,10,4.88,993,21.68,0.51,0.54
1,955,67,983,10,4.88,993,21.68,0.51,0.54
1,955,67,983,10,4.88,993,21.68,0.51,0.54
1,955,67,983,10,4.88,993,21.68,0.51,0.54
2,971,16,977,3,1.48,980,10.03,0.54,0.55
2,971,16,977,3,1.48,980,10.03,0.54,0.55
2,971,16,977,3,1.48,980,10.03,0.54,0.55
2,971,16,977,3,1.48,980,10.03,0.54,0.55
11,378,65,963,17,8.45,980,33.64,0.48,0.52
11,378,65,963,17,8.45,980,33.64,0.48,0.52
11,378,65,963,17,8.45,980,33.64,0.48,0.52
11,378,65,963,17,8.45,980,33.64,0.48,0.52
0,479,23,1010,9,4.58,1019,20.35,0.51,0.54
0,479,23,1010,9,4.58,1019,20.35,0.51,0.54
0,479,23,1010,9,4.58,1019,20.35,0.51,0.54
0,479,23,1010,9,4.58,1019,20.35,0.51,0.54
1,454,67,1001,16,7.96,1017,31.97,0.48,0.52
1,454,67,1001,16,7.96,1017,31.97,0.48,0.52
1,454,67,1001,16,7.96,1017,31.97,0.48,0.52
1,454,67,1001,16,7.96,1017,31.97,0.48,0.52
2,363,16,999,6,2.92,1005,14.99,0.52,0.54
2,363,16,999,6,2.92,1005,14.99,0.52,0.54
2,363,16,999,6,2.92,1005,14.99,0.52,0.54
2,363,16,999,6,2.92,1005,14.99,0.52,0.54
8,350,11,1019,18,9.0,1037,35.43,0.47000000000000003,0.52
8,350,11,1019,18,9.0,1037,35.43,0.47000000000000003,0.52
8,350,11,1019,18,9.0,1037,35.43,0.47000000000000003,0.52
8,350,11,1019,18,9.0,1037,35.43,0.47000000000000003,0.52
13,471,86,994,17,8.68,1011,34.05,0.48,0.52
13,471,86,994,17,8.68,1011,34.05,0.48,0.52
13,471,86,994,17,8.68,1011,34.05,0.48,0.52
13,471,86,994,17,8.68,1011,34.05,0.48,0.52
0,286,23,1034,24,12.06,1058,45.66,0.45,0.51
0,286,23,1034,24,12.06,1058,45.66,0.45,0.51
0,286,23,1034,24,12.06,1058,45.66,0.45,0.51
0,286,23,1034,24,12.06,1058,45.66,0.45,0.51
1,258,67,1031,4,2.12,1035,11.97,0.53,0.55
1,258,67,1031,4,2.12,1035,11.97,0.53,0.55
1,258,67,1031,4,2.12,1035,11.97,0.53,0.55
1,258,67,1031,4,2.12,1035,11.97,0.53,0.55
13,792,86,1025,7,3.71,1032,17.22,0.52,0.54
13,792,86,1025,7,3.71,1032,17.22,0.52,0.54
13,792,86,1025,7,3.71,1032,17.22,0.52,0.54
13,792,86,1025,7,3.71,1032,17.22,0.52,0.54
0,390,23,1069,16,7.91,1085,31.88,0.48,0.52
0,390,23,1069,16,7.91,1085,31.88,0.48,0.52
0,390,23,1069,16,7.91,1085,31.88,0.48,0.52
0,390,23,1069,16,7.91,1085,31.88,0.48,0.52
1,364,67,1065,5,2.46,1070,13.37,0.53,0.55
1,364,67,1065,5,2.46,1070,13.37,0.53,0.55
1,364,67,1065,5,2.46,1070,13.37,0.53,0.55
1,364,67,1065,5,2.46,1070,13.37,0.53,0.55
2,432,16,1051,12,5.95,1063,25.18,0.5,0.53
2,432,16,1051,12,5.95,1063,25.18,0.5,0.53
2,432,16,1051,12,5.95,1063,25.18,0.5,0.53
2,432,16,1051,12,5.95,1063,25.18,0.5,0.53
7,375,45,1077,11,5.29,1088,23.21,0.5,0.53
7,375,45,1077,11,5.29,1088,23.21,0.5,0.53
7,375,45,1077,11,5.29,1088,23.21,0.5,0.53
7,375,45,1077,11,5.29,1088,23.21,0.5,0.53
11,457,65,1065,9,4.53,1074,20.26,0.51,0.54
11,457,65,1065,9,4.53,1074,20.26,0.51,0.54
11,457,65,1065,9,4.53,1074,20.26,0.51,0.54
11,457,65,1065,9,4.53,1074,20.26,0.51,0.54
13,351,86,1079,8,3.87,1087,18.28,0.52,0.54
13,351,86,1079,8,3.87,1087,18.28,0.52,0.54
13,351,86,1079,8,3.87,1087,18.28,0.52,0.54
13,351,86,1079,8,3.87,1087,18.28,0.52,0.54
0,898,23,1102,13,6.29,1115,26.58,0.5,0.53
0,898,23,1102,13,6.29,1115,26.58,0.5,0.53
0,898,23,1102,13,6.29,1115,26.58,0.5,0.53
0,898,23,1102,13,6.29,1115,26.58,0.5,0.53
2,303,16,1080,18,9.21,1098,35.81,0.47000000000000003,0.52
2,303,16,1080,18,9.21,1098,35.81,0.47000000000000003,0.52
2,303,16,1080,18,9.21,1098,35.81,0.47000000000000003,0.52
2,303,16,1080,18,9.21,1098,35.81,0.47000000000000003,0.52
7,345,45,1090,13,6.32,1103,26.65,0.5,0.53
7,345,45,1090,13,6.32,1103,26.65,0.5,0.53
7,345,45,1090,13,6.32,1103,26.65,0.5,0.53
7,345,45,1090,13,6.32,1103,26.65,0.5,0.53
13,428,86,1109,10,4.84,1119,21.61,0.51,0.54
13,428,86,1109,10,4.84,1119,21.61,0.51,0.54
13,428,86,1109,10,4.84,1119,21.61,0.51,0.54
13,428,86,1109,10,4.84,1119,21.61,0.51,0.54
2,360,16,1117,11,5.46,1128,23.52,0.5,0.53
2,360,16,1117,11,5.46,1128,23.52,0.5,0.53
2,360,16,1117,11,5.46,1128,23.52,0.5,0.53
2,360,16,1117,11,5.46,1128,23.52,0.5,0.53
4,284,47,1112,10,4.93,1122,21.77,0.51,0.54
4,284,47,1112,10,4.93,1122,21.77,0.51,0.54
4,284,47,1112,10,4.93,1122,21.77,0.51,0.54
4,284,47,1112,10,4.93,1122,21.77,0.51,0.54
13,250,86,1116,14,7.08,1130,28.8,0.49,0.53
13,250,86,1116,14,7.08,1130,28.8,0.49,0.53
13,250,86,1116,14,7.08,1130,28.8,0.49,0.53
13,250,86,1116,14,7.08,1130,28.8,0.49,0.53
0,345,23,1142,4,1.77,1146,11.34,0.53,0.55
0,345,23,1142,4,1.77,1146,11.34,0.53,0.55
0,345,23,1142,4,1.77,1146,11.34,0.53,0.55
0,345,23,1142,4,1.77,1146,11.34,0.53,0.55
7,461,45,1148,13,6.56,1161,27.07,0.49,0.53
7,461,45,1148,13,6.56,1161,27.07,0.49,0.53
7,461,45,1148,13,6.56,1161,27.07,0.49,0.53
7,461,45,1148,13,6.56,1161,27.07,0.49,0.53
4,478,47,1187,17,8.34,1204,33.43,0.48,0.52
4,478,47,1187,17,8.34,1204,33.43,0.48,0.52
4,478,47,1187,17,8.34,1204,33.43,0.48,0.52
4,478,47,1187,17,8.34,1204,33.43,0.48,0.52
4,948,47,1222,8,4.12,1230,18.74,0.52,0.54
4,948,47,1222,8,4.12,1230,18.74,0.52,0.54
4,948,47,1222,8,4.12,1230,18.74,0.52,0.54
4,948,47,1222,8,4.12,1230,18.74,0.52,0.54
7,872,45,1221,2,0.85,1223,8.11,0.54,0.55
7,872,45,1221,2,0.85,1223,8.11,0.54,0.55
7,872,45,1221,2,0.85,1223,8.11,0.54,0.55
7,872,45,1221,2,0.85,1223,8.11,0.54,0.55
4,546,47,1278,11,5.54,1289,23.66,0.5,0.53
4,546,47,1278,11,5.54,1289,23.66,0.5,0.53
4,546,47,1278,11,5.54,1289,23.66,0.5,0.53
4,546,47,1278,11,5.54,1289,23.66,0.5,0.53
4,556,47,1306,10,5.05,1316,21.98,0.51,0.53
4,556,47,1306,10,5.05,1316,21.98,0.51,0.53
4,556,47,1306,10,5.05,1316,21.98,0.51,0.53
4,556,47,1306,10,5.05,1316,21.98,0.51,0.53
9,639,46,1292,4,1.94,1296,11.65,0.53,0.55
9,639,46,1292,4,1.94,1296,11.65,0.53,0.55
9,639,46,1292,4,1.94,1296,11.65,0.53,0.55
9,639,46,1292,4,1.94,1296,11.65,0.53,0.55
8,692,19,1411,10,4.9,1421,21.72,0.51,0.54
8,692,19,1411,10,4.9,1421,21.72,0.51,0.54
8,692,19,1411,10,4.9,1421,21.72,0.51,0.54
8,692,19,1411,10,4.9,1421,21.72,0.51,0.54
3,795,88,137,5,2.72,142,13.84,0.53,0.55
3,795,88,137,5,2.72,142,13.84,0.53,0.55
3,795,88,137,5,2.72,142,13.84,0.53,0.55
3,795,88,137,5,2.72,142,13.84,0.53,0.55
3,795,88,137,5,2.72,142,13.84,0.53,0.55
6,969,99,164,10,4.88,174,21.69,0.51,0.54
6,969,99,164,10,4.88,174,21.69,0.51,0.54
6,969,99,164,10,4.88,174,21.69,0.51,0.54
6,969,99,164,10,4.88,174,21.69,0.51,0.54
6,969,99,164,10,4.88,174,21.69,0.51,0.54
5,916,48,257,12,6.19,269,25.62,0.5,0.53
5,916,48,257,12,6.19,269,25.62,0.5,0.53
5,916,48,257,12,6.19,269,25.62,0.5,0.53
5,916,48,257,12,6.19,269,25.62,0.5,0.53
5,916,48,257,12,6.19,269,25.62,0.5,0.53
13,861,94,266,9,4.3,275,19.85,0.51,0.54
13,861,94,266,9,4.3,275,19.85,0.51,0.54
13,861,94,266,9,4.3,275,19.85,0.51,0.54
13,861,94,266,9,4.3,275,19.85,0.51,0.54
13,861,94,266,9,4.3,275,19.85,0.51,0.54
5,214,48,295,15,7.59,310,30.51,0.49,0.52
5,214,48,295,15,7.59,310,30.51,0.49,0.52
5,214,48,295,15,7.59,310,30.51,0.49,0.52
5,214,48,295,15,7.59,310,30.51,0.49,0.52
5,214,48,295,15,7.59,310,30.51,0.49,0.52
10,169,32,346,6,2.9,352,14.95,0.53,0.54
10,169,32,346,6,2.9,352,14.95,0.53,0.54
10,169,32,346,6,2.9,352,14.95,0.53,0.54
10,169,32,346,6,2.9,352,14.95,0.53,0.54
10,169,32,346,6,2.9,352,14.95,0.53,0.54
3,975,88,370,8,3.82,378,18.2,0.52,0.54
3,975,88,370,8,3.82,378,18.2,0.52,0.54
3,975,88,370,8,3.82,378,18.2,0.52,0.54
3,975,88,370,8,3.82,378,18.2,0.52,0.54
3,975,88,370,8,3.82,378,18.2,0.52,0.54
5,121,48,365,14,6.93,379,28.52,0.49,0.53
5,121,48,365,14,6.93,379,28.52,0.49,0.53
5,121,48,365,14,6.93,379,28.52,0.49,0.53
5,121,48,365,14,6.93,379,28.52,0.49,0.53
5,121,48,365,14,6.93,379,28.52,0.49,0.53
14,959,61,389,12,5.98,401,25.24,0.5,0.53
14,959,61,389,12,5.98,401,25.24,0.5,0.53
14,959,61,389,12,5.98,401,25.24,0.5,0.53
14,959,61,389,12,5.98,401,25.24,0.5,0.53
14,959,61,389,12,5.98,401,25.24,0.5,0.53
7,94,69,396,5,2.58,401,13.59,0.53,0.55
7,94,69,396,5,2.58,401,13.59,0.53,0.55
7,94,69,396,5,2.58,401,13.59,0.53,0.55
7,94,69,396,5,2.58,401,13.59,0.53,0.55
7,94,69,396,5,2.58,401,13.59,0.53,0.55
14,149,61,415,16,8.23,431,32.45,0.48,0.52
14,149,61,415,16,8.23,431,32.45,0.48,0.52
14,149,61,415,16,8.23,431,32.45,0.48,0.52
14,149,61,415,16,8.23,431,32.45,0.48,0.52
14,149,61,415,16,8.23,431,32.45,0.48,0.52
7,170,69,438,7,3.74,445,17.27,0.52,0.54
7,170,69,438,7,3.74,445,17.27,0.52,0.54
7,170,69,438,7,3.74,445,17.27,0.52,0.54
7,170,69,438,7,3.74,445,17.27,0.52,0.54
7,170,69,438,7,3.74,445,17.27,0.52,0.54
9,18,57,435,11,5.63,446,23.82,0.5,0.53
9,18,57,435,11,5.63,446,23.82,0.5,0.53
9,18,57,435,11,5.63,446,23.82,0.5,0.53
9,18,57,435,11,5.63,446,23.82,0.5,0.53
9,18,57,435,11,5.63,446,23.82,0.5,0.53
10,11,32,429,3,1.66,432,10.36,0.54,0.55
10,11,32,429,3,1.66,432,10.36,0.54,0.55
10,11,32,429,3,1.66,432,10.36,0.54,0.55
10,11,32,429,3,1.66,432,10.36,0.54,0.55
10,11,32,429,3,1.66,432,10.36,0.54,0.55
5,101,48,463,6,2.92,469,15.0,0.52,0.54
5,101,48,463,6,2.92,469,15.0,0.52,0.54
5,101,48,463,6,2.92,469,15.0,0.52,0.54
5,101,48,463,6,2.92,469,15.0,0.52,0.54
5,101,48,463,6,2.92,469,15.0,0.52,0.54
7,53,69,479,14,6.84,493,28.37,0.49,0.53
7,53,69,479,14,6.84,493,28.37,0.49,0.53
7,53,69,479,14,6.84,493,28.37,0.49,0.53
7,53,69,479,14,6.84,493,28.37,0.49,0.53
7,53,69,479,14,6.84,493,28.37,0.49,0.53
13,176,94,466,12,5.9,478,25.09,0.5,0.53
13,176,94,466,12,5.9,478,25.09,0.5,0.53
13,176,94,466,12,5.9,478,25.09,0.5,0.53
13,176,94,466,12,5.9,478,25.09,0.5,0.53
13,176,94,466,12,5.9,478,25.09,0.5,0.53
2,139,76,505,2,1.16,507,8.68,0.54,0.55
2,139,76,505,2,1.16,507,8.68,0.54,0.55
2,139,76,505,2,1.16,507,8.68,0.54,0.55
2,139,76,505,2,1.16,507,8.68,0.54,0.55
2,139,76,505,2,1.16,507,8.68,0.54,0.55
5,212,48,488,8,3.91,496,18.36,0.52,0.54
5,212,48,488,8,3.91,496,18.36,0.52,0.54
5,212,48,488,8,3.91,496,18.36,0.52,0.54
5,212,48,488,8,3.91,496,18.36,0.52,0.54
5,212,48,488,8,3.91,496,18.36,0.52,0.54
9,23,57,509,10,5.21,519,22.28,0.51,0.53
9,23,57,509,10,5.21,519,22.28,0.51,0.53
9,23,57,509,10,5.21,519,22.28,0.51,0.53
9,23,57,509,10,5.21,519,22.28,0.51,0.53
9,23,57,509,10,5.21,519,22.28,0.51,0.53
10,169,32,507,4,2.1,511,11.95,0.53,0.55
10,169,32,507,4,2.1,511,11.95,0.53,0.55
10,169,32,507,4,2.1,511,11.95,0.53,0.55
10,169,32,507,4,2.1,511,11.95,0.53,0.55
10,169,32,507,4,2.1,511,11.95,0.53,0.55
2,175,76,536,3,1.51,539,10.09,0.54,0.55
2,175,76,536,3,1.51,539,10.09,0.54,0.55
2,175,76,536,3,1.51,539,10.09,0.54,0.55
2,175,76,536,3,1.51,539,10.09,0.54,0.55
2,175,76,536,3,1.51,539,10.09,0.54,0.55
4,105,89,512,8,4.15,520,18.79,0.52,0.54
4,105,89,512,8,4.15,520,18.79,0.52,0.54
4,105,89,512,8,4.15,520,18.79,0.52,0.54
4,105,89,512,8,4.15,520,18.79,0.52,0.54
4,105,89,512,8,4.15,520,18.79,0.52,0.54
6,11,0,512,11,5.26,523,23.16,0.5,0.53
6,11,0,512,11,5.26,523,23.16,0.5,0.53
6,11,0,512,11,5.26,523,23.16,0.5,0.53
6,11,0,512,11,5.26,523,23.16,0.5,0.53
6,11,0,512,11,5.26,523,23.16,0.5,0.53
10,64,32,527,9,4.5,536,20.21,0.51,0.54
10,64,32,527,9,4.5,536,20.21,0.51,0.54
10,64,32,527,9,4.5,536,20.21,0.51,0.54
10,64,32,527,9,4.5,536,20.21,0.51,0.54
10,64,32,527,9,4.5,536,20.21,0.51,0.54
2,28,76,554,12,5.77,566,24.87,0.5,0.53
2,28,76,554,12,5.77,566,24.87,0.5,0.53
2,28,76,554,12,5.77,566,24.87,0.5,0.53
2,28,76,554,12,5.77,566,24.87,0.5,0.53
2,28,76,554,12,5.77,566,24.87,0.5,0.53
4,939,89,545,13,6.47,558,26.91,0.5,0.53
4,939,89,545,13,6.47,558,26.91,0.5,0.53
4,939,89,545,13,6.47,558,26.91,0.5,0.53
4,939,89,545,13,6.47,558,26.91,0.5,0.53
4,939,89,545,13,6.47,558,26.91,0.5,0.53
8,31,43,544,5,2.67,549,13.76,0.53,0.55
8,31,43,544,5,2.67,549,13.76,0.53,0.55
8,31,43,544,5,2.67,549,13.76,0.53,0.55
8,31,43,544,5,2.67,549,13.76,0.53,0.55
8,31,43,544,5,2.67,549,13.76,0.53,0.55
4,124,89,601,7,3.6,608,17.01,0.52,0.54
4,124,89,601,7,3.6,608,17.01,0.52,0.54
4,124,89,601,7,3.6,608,17.01,0.52,0.54
4,124,89,601,7,3.6,608,17.01,0.52,0.54
4,124,89,601,7,3.6,608,17.01,0.52,0.54
14,951,61,701,8,4.15,709,18.78,0.52,0.54
14,951,61,701,8,4.15,709,18.78,0.52,0.54
14,951,61,701,8,4.15,709,18.78,0.52,0.54
14,951,61,701,8,4.15,709,18.78,0.52,0.54
14,951,61,701,8,4.15,709,18.78,0.52,0.54
0,810,64,737,11,5.54,748,23.66,0.5,0.53
0,810,64,737,11,5.54,748,23.66,0.5,0.53
0,810,64,737,11,5.54,748,23.66,0.5,0.53
0,810,64,737,11,5.54,748,23.66,0.5,0.53
0,810,64,737,11,5.54,748,23.66,0.5,0.53
14,894,61,747,2,1.17,749,8.69,0.54,0.55
14,894,61,747,2,1.17,749,8.69,0.54,0.55
14,894,61,747,2,1.17,749,8.69,0.54,0.55
14,894,61,747,2,1.17,749,8.69,0.54,0.55
14,894,61,747,2,1.17,749,8.69,0.54,0.55
0,794,64,800,21,10.6,821,40.67,0.46,0.51
0,794,64,800,21,10.6,821,40.67,0.46,0.51
0,794,64,800,21,10.6,821,40.67,0.46,0.51
0,794,64,800,21,10.6,821,40.67,0.46,0.51
0,794,64,800,21,10.6,821,40.67,0.46,0.51
0,932,64,825,4,1.95,829,11.67,0.53,0.55
0,932,64,825,4,1.95,829,11.67,0.53,0.55
0,932,64,825,4,1.95,829,11.67,0.53,0.55
0,932,64,825,4,1.95,829,11.67,0.53,0.55
0,932,64,825,4,1.95,829,11.67,0.53,0.55
9,788,57,905,10,5.11,915,22.09,0.51,0.53
9,788,57,905,10,5.11,915,22.09,0.51,0.53
9,788,57,905,10,5.11,915,22.09,0.51,0.53
9,788,57,905,10,5.11,915,22.09,0.51,0.53
9,788,57,905,10,5.11,915,22.09,0.51,0.53
6,973,11,952,4,2.15,956,12.04,0.53,0.55
6,973,11,952,4,2.15,956,12.04,0.53,0.55
6,973,11,952,4,2.15,956,12.04,0.53,0.55
6,973,11,952,4,2.15,956,12.04,0.53,0.55
6,973,11,952,4,2.15,956,12.04,0.53,0.55
2,289,7,976,1,0.42,977,6.54,0.55,0.55
2,289,7,976,1,0.42,977,6.54,0.55,0.55
2,289,7,976,1,0.42,977,6.54,0.55,0.55
2,289,7,976,1,0.42,977,6.54,0.55,0.55
2,289,7,976,1,0.42,977,6.54,0.55,0.55
9,292,57,978,10,4.88,988,21.68,0.51,0.54
9,292,57,978,10,4.88,988,21.68,0.51,0.54
9,292,57,978,10,4.88,988,21.68,0.51,0.54
9,292,57,978,10,4.88,988,21.68,0.51,0.54
9,292,57,978,10,4.88,988,21.68,0.51,0.54
2,287,7,1001,12,6.15,1013,25.55,0.5,0.53
2,287,7,1001,12,6.15,1013,25.55,0.5,0.53
2,287,7,1001,12,6.15,1013,25.55,0.5,0.53
2,287,7,1001,12,6.15,1013,25.55,0.5,0.53
2,287,7,1001,12,6.15,1013,25.55,0.5,0.53
6,389,11,1012,13,6.59,1025,27.14,0.49,0.53
6,389,11,1012,13,6.59,1025,27.14,0.49,0.53
6,389,11,1012,13,6.59,1025,27.14,0.49,0.53
6,389,11,1012,13,6.59,1025,27.14,0.49,0.53
6,389,11,1012,13,6.59,1025,27.14,0.49,0.53
2,344,7,1020,8,4.04,1028,18.59,0.52,0.54
2,344,7,1020,8,4.04,1028,18.59,0.52,0.54
2,344,7,1020,8,4.04,1028,18.59,0.52,0.54
2,344,7,1020,8,4.04,1028,18.59,0.52,0.54
2,344,7,1020,8,4.04,1028,18.59,0.52,0.54
4,431,13,1021,7,3.6,1028,17.02,0.52,0.54
4,431,13,1021,7,3.6,1028,17.02,0.52,0.54
4,431,13,1021,7,3.6,1028,17.02,0.52,0.54
4,431,13,1021,7,3.6,1028,17.02,0.52,0.54
4,431,13,1021,7,3.6,1028,17.02,0.52,0.54
9,366,57,1037,7,3.5,1044,16.84,0.52,0.54
9,366,57,1037,7,3.5,1044,16.84,0.52,0.54
9,366,57,1037,7,3.5,1044,16.84,0.52,0.54
9,366,57,1037,7,3.5,1044,16.84,0.52,0.54
9,366,57,1037,7,3.5,1044,16.84,0.52,0.54
2,372,7,1061,16,7.77,1077,31.63,0.48,0.52
2,372,7,1061,16,7.77,1077,31.63,0.48,0.52
2,372,7,1061,16,7.77,1077,31.63,0.48,0.52
2,372,7,1061,16,7.77,1077,31.63,0.48,0.52
2,372,7,1061,16,7.77,1077,31.63,0.48,0.52
4,275,13,1076,3,1.35,1079,9.8,0.54,0.55
4,275,13,1076,3,1.35,1079,9.8,0.54,0.55
4,275,13,1076,3,1.35,1079,9.8,0.54,0.55
4,275,13,1076,3,1.35,1079,9.8,0.54,0.55
4,275,13,1076,3,1.35,1079,9.8,0.54,0.55
5,297,15,1053,4,2.19,1057,12.11,0.53,0.55
5,297,15,1053,4,2.19,1057,12.11,0.53,0.55
5,297,15,1053,4,2.19,1057,12.11,0.53,0.55
5,297,15,1053,4,2.19,1057,12.11,0.53,0.55
5,297,15,1053,4,2.19,1057,12.11,0.53,0.55
6,313,11,1066,4,2.16,1070,12.05,0.53,0.55
6,313,11,1066,4,2.16,1070,12.05,0.53,0.55
6,313,11,1066,4,2.16,1070,12.05,0.53,0.55
6,313,11,1066,4,2.16,1070,12.05,0.53,0.55
6,313,11,1066,4,2.16,1070,12.05,0.53,0.55
9,830,57,1057,4,1.97,1061,11.71,0.53,0.55
9,830,57,1057,4,1.97,1061,11.71,0.53,0.55
9,830,57,1057,4,1.97,1061,11.71,0.53,0.55
9,830,57,1057,4,1.97,1061,11.71,0.53,0.55
9,830,57,1057,4,1.97,1061,11.71,0.53,0.55
2,454,7,1094,14,7.18,1108,28.99,0.49,0.53
2,454,7,1094,14,7.18,1108,28.99,0.49,0.53
2,454,7,1094,14,7.18,1108,28.99,0.49,0.53
2,454,7,1094,14,7.18,1108,28.99,0.49,0.53
2,454,7,1094,14,7.18,1108,28.99,0.49,0.53
2,343,7,1120,11,5.73,1131,24.0,0.5,0.53
2,343,7,1120,11,5.73,1131,24.0,0.5,0.53
2,343,7,1120,11,5.73,1131,24.0,0.5,0.53
2,343,7,1120,11,5.73,1131,24.0,0.5,0.53
2,343,7,1120,11,5.73,1131,24.0,0.5,0.53
5,278,15,1120,14,6.78,1134,28.25,0.49,0.53
5,278,15,1120,14,6.78,1134,28.25,0.49,0.53
5,278,15,1120,14,6.78,1134,28.25,0.49,0.53
5,278,15,1120,14,6.78,1134,28.25,0.49,0.53
5,278,15,1120,14,6.78,1134,28.25,0.49,0.53
5,336,15,1165,5,2.42,1170,13.31,0.53,0.55
5,336,15,1165,5,2.42,1170,13.31,0.53,0.55
5,336,15,1165,5,2.42,1170,13.31,0.53,0.55
5,336,15,1165,5,2.42,1170,13.31,0.53,0.55
5,336,15,1165,5,2.42,1170,13.31,0.53,0.55
6,431,11,1142,11,5.35,1153,23.31,0.5,0.53
6,431,11,1142,11,5.35,1153,23.31,0.5,0.53
6,431,11,1142,11,5.35,1153,23.31,0.5,0.53
6,431,11,1142,11,5.35,1153,23.31,0.5,0.53
6,431,11,1142,11,5.35,1153,23.31,0.5,0.53
5,284,15,1179,9,4.46,1188,20.13,0.51,0.54
5,284,15,1179,9,4.46,1188,20.13,0.51,0.54
5,284,15,1179,9,4.46,1188,20.13,0.51,0.54
5,284,15,1179,9,4.46,1188,20.13,0.51,0.54
5,284,15,1179,9,4.46,1188,20.13,0.51,0.54
7,537,36,1173,17,8.71,1190,34.11,0.48,0.52
7,537,36,1173,17,8.71,1190,34.11,0.48,0.52
7,537,36,1173,17,8.71,1190,34.11,0.48,0.52
7,537,36,1173,17,8.71,1190,34.11,0.48,0.52
7,537,36,1173,17,8.71,1190,34.11,0.48,0.52
2,537,7,1250,5,2.34,1255,13.16,0.53,0.55
2,537,7,1250,5,2.34,1255,13.16,0.53,0.55
2,537,7,1250,5,2.34,1255,13.16,0.53,0.55
2,537,7,1250,5,2.34,1255,13.16,0.53,0.55
2,537,7,1250,5,2.34,1255,13.16,0.53,0.55
5,591,15,1241,7,3.71,1248,17.21,0.52,0.54
5,591,15,1241,7,3.71,1248,17.21,0.52,0.54
5,591,15,1241,7,3.71,1248,17.21,0.52,0.54
5,591,15,1241,7,3.71,1248,17.21,0.52,0.54
5,591,15,1241,7,3.71,1248,17.21,0.52,0.54
6,540,11,1238,7,3.29,1245,16.44,0.52,0.54
6,540,11,1238,7,3.29,1245,16.44,0.52,0.54
6,540,11,1238,7,3.29,1245,16.44,0.52,0.54
6,540,11,1238,7,3.29,1245,16.44,0.52,0.54
6,540,11,1238,7,3.29,1245,16.44,0.52,0.54
7,650,36,1235,17,8.53,1252,33.79,0.48,0.52
7,650,36,1235,17,8.53,1252,33.79,0.48,0.52
7,650,36,1235,17,8.53,1252,33.79,0.48,0.52
7,650,36,1235,17,8.53,1252,33.79,0.48,0.52
7,650,36,1235,17,8.53,1252,33.79,0.48,0.52
5,615,15,1286,2,0.76,1288,7.94,0.54,0.55
5,615,15,1286,2,0.76,1288,7.94,0.54,0.55
5,615,15,1286,2,0.76,1288,7.94,0.54,0.55
5,615,15,1286,2,0.76,1288,7.94,0.54,0.55
5,615,15,1286,2,0.76,1288,7.94,0.54,0.55
7,535,36,1273,20,9.84,1293,38.5,0.47000000000000003,0.51
7,535,36,1273,20,9.84,1293,38.5,0.47000000000000003,0.51
7,535,36,1273,20,9.84,1293,38.5,0.47000000000000003,0.51
7,535,36,1273,20,9.84,1293,38.5,0.47000000000000003,0.51
7,535,36,1273,20,9.84,1293,38.5,0.47000000000000003,0.51
8,596,63,1260,4,1.78,1264,11.36,0.53,0.55
8,596,63,1260,4,1.78,1264,11.36,0.53,0.55
8,596,63,1260,4,1.78,1264,11.36,0.53,0.55
8,596,63,1260,4,1.78,1264,11.36,0.53,0.55
8,596,63,1260,4,1.78,1264,11.36,0.53,0.55
5,639,15,1319,8,4.03,1327,18.58,0.52,0.54
5,639,15,1319,8,4.03,1327,18.58,0.52,0.54
5,639,15,1319,8,4.03,1327,18.58,0.52,0.54
5,639,15,1319,8,4.03,1327,18.58,0.52,0.54
5,639,15,1319,8,4.03,1327,18.58,0.52,0.54
7,594,36,1296,3,1.67,1299,10.38,0.54,0.55
7,594,36,1296,3,1.67,1299,10.38,0.54,0.55
7,594,36,1296,3,1.67,1299,10.38,0.54,0.55
7,594,36,1296,3,1.67,1299,10.38,0.54,0.55
7,594,36,1296,3,1.67,1299,10.38,0.54,0.55
8,584,63,1313,16,8.15,1329,32.31,0.48,0.52
8,584,63,1313,16,8.15,1329,32.31,0.48,0.52
8,584,63,1313,16,8.15,1329,32.31,0.48,0.52
8,584,63,1313,16,8.15,1329,32.31,0.48,0.52
8,584,63,1313,16,8.15,1329,32.31,0.48,0.52
14,707,41,1317,11,5.52,1328,23.63,0.5,0.53
14,707,41,1317,11,5.52,1328,23.63,0.5,0.53
14,707,41,1317,11,5.52,1328,23.63,0.5,0.53
14,707,41,1317,11,5.52,1328,23.63,0.5,0.53
14,707,41,1317,11,5.52,1328,23.63,0.5,0.53
14,534,41,1340,13,6.39,1353,26.76,0.5,0.53
14,534,41,1340,13,6.39,1353,26.76,0.5,0.53
14,534,41,1340,13,6.39,1353,26.76,0.5,0.53
14,534,41,1340,13,6.39,1353,26.76,0.5,0.53
14,534,41,1340,13,6.39,1353,26.76,0.5,0.53
5,503,15,1369,7,3.63,1376,17.06,0.52,0.54
5,503,15,1369,7,3.63,1376,17.06,0.52,0.54
5,503,15,1369,7,3.63,1376,17.06,0.52,0.54
5,503,15,1369,7,3.63,1376,17.06,0.52,0.54
5,503,15,1369,7,3.63,1376,17.06,0.52,0.54
14,935,41,1384,18,9.01,1402,35.44,0.47000000000000003,0.52
14,935,41,1384,18,9.01,1402,35.44,0.47000000000000003,0.52
14,935,41,1384,18,9.01,1402,35.44,0.47000000000000003,0.52
14,935,41,1384,18,9.01,1402,35.44,0.47000000000000003,0.52
14,935,41,1384,18,9.01,1402,35.44,0.47000000000000003,0.52
5,745,15,1421,6,2.96,1427,15.07,0.52,0.54
5,745,15,1421,6,2.96,1427,15.07,0.52,0.54
5,745,15,1421,6,2.96,1427,15.07,0.52,0.54
5,745,15,1421,6,2.96,1427,15.07,0.52,0.54
5,745,15,1421,6,2.96,1427,15.07,0.52,0.54
7,911,36,1418,8,4.1,1426,18.7,0.52,0.54
7,911,36,1418,8,4.1,1426,18.7,0.52,0.54
7,911,36,1418,8,4.1,1426,18.7,0.52,0.54
7,911,36,1418,8,4.1,1426,18.7,0.52,0.54
7,911,36,1418,8,4.1,1426,18.7,0.52,0.54
8,878,10,229,7,3.59,236,16.99,0.52,0.54
8,878,10,229,7,3.59,236,16.99,0.52,0.54
8,878,10,229,7,3.59,236,16.99,0.52,0.54
8,878,10,229,7,3.59,236,16.99,0.52,0.54
8,878,10,229,7,3.59,236,16.99,0.52,0.54
8,878,10,229,7,3.59,236,16.99,0.52,0.54
7,216,25,412,6,2.83,418,14.84,0.53,0.54
7,216,25,412,6,2.83,418,14.84,0.53,0.54
7,216,25,412,6,2.83,418,14.84,0.53,0.54
7,216,25,412,6,2.83,418,14.84,0.53,0.54
7,216,25,412,6,2.83,418,14.84,0.53,0.54
7,216,25,412,6,2.83,418,14.84,0.53,0.54
8,112,10,395,6,3.24,401,15.58,0.52,0.54
8,112,10,395,6,3.24,401,15.58,0.52,0.54
8,112,10,395,6,3.24,401,15.58,0.52,0.54
8,112,10,395,6,3.24,401,15.58,0.52,0.54
8,112,10,395,6,3.24,401,15.58,0.52,0.54
8,112,10,395,6,3.24,401,15.58,0.52,0.54
3,194,89,439,6,3.1,445,15.33,0.52,0.54
3,194,89,439,6,3.1,445,15.33,0.52,0.54
3,194,89,439,6,3.1,445,15.33,0.52,0.54
3,194,89,439,6,3.1,445,15.33,0.52,0.54
3,194,89,439,6,3.1,445,15.33,0.52,0.54
3,194,89,439,6,3.1,445,15.33,0.52,0.54
6,170,28,434,6,3.19,440,15.48,0.52,0.54
6,170,28,434,6,3.19,440,15.48,0.52,0.54
6,170,28,434,6,3.19,440,15.48,0.52,0.54
6,170,28,434,6,3.19,440,15.48,0.52,0.54
6,170,28,434,6,3.19,440,15.48,0.52,0.54
6,170,28,434,6,3.19,440,15.48,0.52,0.54
7,952,25,428,13,6.56,441,27.09,0.49,0.53
7,952,25,428,13,6.56,441,27.09,0.49,0.53
7,952,25,428,13,6.56,441,27.09,0.49,0.53
7,952,25,428,13,6.56,441,27.09,0.49,0.53
7,952,25,428,13,6.56,441,27.09,0.49,0.53
7,952,25,428,13,6.56,441,27.09,0.49,0.53
2,135,92,475,3,1.3,478,9.71,0.54,0.55
2,135,92,475,3,1.3,478,9.71,0.54,0.55
2,135,92,475,3,1.3,478,9.71,0.54,0.55
2,135,92,475,3,1.3,478,9.71,0.54,0.55
2,135,92,475,3,1.3,478,9.71,0.54,0.55
2,135,92,475,3,1.3,478,9.71,0.54,0.55
8,150,10,450,12,5.91,462,25.12,0.5,0.53
8,150,10,450,12,5.91,462,25.12,0.5,0.53
8,150,10,450,12,5.91,462,25.12,0.5,0.53
8,150,10,450,12,5.91,462,25.12,0.5,0.53
8,150,10,450,12,5.91,462,25.12,0.5,0.53
8,150,10,450,12,5.91,462,25.12,0.5,0.53
13,197,27,460,12,6.0,472,25.27,0.5,0.53
13,197,27,460,12,6.0,472,25.27,0.5,0.53
13,197,27,460,12,6.0,472,25.27,0.5,0.53
13,197,27,460,12,6.0,472,25.27,0.5,0.53
13,197,27,460,12,6.0,472,25.27,0.5,0.53
13,197,27,460,12,6.0,472,25.27,0.5,0.53
2,14,92,499,9,4.35,508,19.94,0.51,0.54
2,14,92,499,9,4.35,508,19.94,0.51,0.54
2,14,92,499,9,4.35,508,19.94,0.51,0.54
2,14,92,499,9,4.35,508,19.94,0.51,0.54
2,14,92,499,9,4.35,508,19.94,0.51,0.54
2,14,92,499,9,4.35,508,19.94,0.51,0.54
6,27,28,505,9,4.29,514,19.83,0.51,0.54
6,27,28,505,9,4.29,514,19.83,0.51,0.54
6,27,28,505,9,4.29,514,19.83,0.51,0.54
6,27,28,505,9,4.29,514,19.83,0.51,0.54
6,27,28,505,9,4.29,514,19.83,0.51,0.54
6,27,28,505,9,4.29,514,19.83,0.51,0.54
8,78,10,501,5,2.34,506,13.16,0.53,0.55
8,78,10,501,5,2.34,506,13.16,0.53,0.55
8,78,10,501,5,2.34,506,13.16,0.53,0.55
8,78,10,501,5,2.34,506,13.16,0.53,0.55
8,78,10,501,5,2.34,506,13.16,0.53,0.55
8,78,10,501,5,2.34,506,13.16,0.53,0.55
13,981,27,494,16,7.92,510,31.9,0.48,0.52
13,981,27,494,16,7.92,510,31.9,0.48,0.52
13,981,27,494,16,7.92,510,31.9,0.48,0.52
13,981,27,494,16,7.92,510,31.9,0.48,0.52
13,981,27,494,16,7.92,510,31.9,0.48,0.52
13,981,27,494,16,7.92,510,31.9,0.48,0.52
2,48,92,517,14,6.77,531,28.25,0.49,0.53
2,48,92,517,14,6.77,531,28.25,0.49,0.53
2,48,92,517,14,6.77,531,28.25,0.49,0.53
2,48,92,517,14,6.77,531,28.25,0.49,0.53
2,48,92,517,14,6.77,531,28.25,0.49,0.53
2,48,92,517,14,6.77,531,28.25,0.49,0.53
3,857,89,524,7,3.61,531,17.03,0.52,0.54
3,857,89,524,7,3.61,531,17.03,0.52,0.54
3,857,89,524,7,3.61,531,17.03,0.52,0.54
3,857,89,524,7,3.61,531,17.03,0.52,0.54
3,857,89,524,7,3.61,531,17.03,0.52,0.54
3,857,89,524,7,3.61,531,17.03,0.52,0.54
6,122,28,515,11,5.54,526,23.66,0.5,0.53
6,122,28,515,11,5.54,526,23.66,0.5,0.53
6,122,28,515,11,5.54,526,23.66,0.5,0.53
6,122,28,515,11,5.54,526,23.66,0.5,0.53
6,122,28,515,11,5.54,526,23.66,0.5,0.53
6,122,28,515,11,5.54,526,23.66,0.5,0.53
10,63,45,535,8,4.07,543,18.64,0.52,0.54
10,63,45,535,8,4.07,543,18.64,0.52,0.54
10,63,45,535,8,4.07,543,18.64,0.52,0.54
10,63,45,535,8,4.07,543,18.64,0.52,0.54
10,63,45,535,8,4.07,543,18.64,0.52,0.54
10,63,45,535,8,4.07,543,18.64,0.52,0.54
13,17,27,527,8,3.91,535,18.37,0.52,0.54
13,17,27,527,8,3.91,535,18.37,0.52,0.54
13,17,27,527,8,3.91,535,18.37,0.52,0.54
13,17,27,527,8,3.91,535,18.37,0.52,0.54
13,17,27,527,8,3.91,535,18.37,0.52,0.54
13,17,27,527,8,3.91,535,18.37,0.52,0.54
15,117,47,529,5,2.45,534,13.36,0.53,0.55
15,117,47,529,5,2.45,534,13.36,0.53,0.55
15,117,47,529,5,2.45,534,13.36,0.53,0.55
15,117,47,529,5,2.45,534,13.36,0.53,0.55
15,117,47,529,5,2.45,534,13.36,0.53,0.55
15,117,47,529,5,2.45,534,13.36,0.53,0.55
0,63,35,554,15,7.42,569,30.2,0.49,0.52
0,63,35,554,15,7.42,569,30.2,0.49,0.52
0,63,35,554,15,7.42,569,30.2,0.49,0.52
0,63,35,554,15,7.42,569,30.2,0.49,0.52
0,63,35,554,15,7.42,569,30.2,0.49,0.52
0,63,35,554,15,7.42,569,30.2,0.49,0.52
3,224,89,541,6,2.77,547,14.72,0.53,0.54
3,224,89,541,6,2.77,547,14.72,0.53,0.54
3,224,89,541,6,2.77,547,14.72,0.53,0.54
3,224,89,541,6,2.77,547,14.72,0.53,0.54
3,224,89,541,6,2.77,547,14.72,0.53,0.54
3,224,89,541,6,2.77,547,14.72,0.53,0.54
11,218,19,582,4,1.81,586,11.42,0.53,0.55
11,218,19,582,4,1.81,586,11.42,0.53,0.55
11,218,19,582,4,1.81,586,11.42,0.53,0.55
11,218,19,582,4,1.81,586,11.42,0.53,0.55
11,218,19,582,4,1.81,586,11.42,0.53,0.55
11,218,19,582,4,1.81,586,11.42,0.53,0.55
0,898,35,615,8,3.78,623,18.13,0.52,0.54
0,898,35,615,8,3.78,623,18.13,0.52,0.54
0,898,35,615,8,3.78,623,18.13,0.52,0.54
0,898,35,615,8,3.78,623,18.13,0.52,0.54
0,898,35,615,8,3.78,623,18.13,0.52,0.54
0,898,35,615,8,3.78,623,18.13,0.52,0.54
4,890,56,922,12,5.85,934,25.01,0.5,0.53
4,890,56,922,12,5.85,934,25.01,0.5,0.53
4,890,56,922,12,5.85,934,25.01,0.5,0.53
4,890,56,922,12,5.85,934,25.01,0.5,0.53
4,890,56,922,12,5.85,934,25.01,0.5,0.53
4,890,56,922,12,5.85,934,25.01,0.5,0.53
5,955,32,1046,6,3.11,1052,15.34,0.52,0.54
5,955,32,1046,6,3.11,1052,15.34,0.52,0.54
5,955,32,1046,6,3.11,1052,15.34,0.52,0.54
5,955,32,1046,6,3.11,1052,15.34,0.52,0.54
5,955,32,1046,6,3.11,1052,15.34,0.52,0.54
5,955,32,1046,6,3.11,1052,15.34,0.52,0.54
8,326,84,1093,8,4.23,1101,18.93,0.52,0.54
8,326,84,1093,8,4.23,1101,18.93,0.52,0.54
8,326,84,1093,8,4.23,1101,18.93,0.52,0.54
8,326,84,1093,8,4.23,1101,18.93,0.52,0.54
8,326,84,1093,8,4.23,1101,18.93,0.52,0.54
8,326,84,1093,8,4.23,1101,18.93,0.52,0.54
8,383,84,1157,13,6.51,1170,26.99,0.5,0.53
8,383,84,1157,13,6.51,1170,26.99,0.5,0.53
8,383,84,1157,13,6.51,1170,26.99,0.5,0.53
8,383,84,1157,13,6.51,1170,26.99,0.5,0.53
8,383,84,1157,13,6.51,1170,26.99,0.5,0.53
8,383,84,1157,13,6.51,1170,26.99,0.5,0.53
11,350,19,1141,9,4.63,1150,20.44,0.51,0.54
11,350,19,1141,9,4.63,1150,20.44,0.51,0.54
11,350,19,1141,9,4.63,1150,20.44,0.51,0.54
11,350,19,1141,9,4.63,1150,20.44,0.51,0.54
11,350,19,1141,9,4.63,1150,20.44,0.51,0.54
11,350,19,1141,9,4.63,1150,20.44,0.51,0.54
8,865,84,1210,14,6.88,1224,28.44,0.49,0.53
8,865,84,1210,14,6.88,1224,28.44,0.49,0.53
8,865,84,1210,14,6.88,1224,28.44,0.49,0.53
8,865,84,1210,14,6.88,1224,28.44,0.49,0.53
8,865,84,1210,14,6.88,1224,28.44,0.49,0.53
8,865,84,1210,14,6.88,1224,28.44,0.49,0.53
11,686,19,1207,8,4.17,1215,18.82,0.52,0.54
11,686,19,1207,8,4.17,1215,18.82,0.52,0.54
11,686,19,1207,8,4.17,1215,18.82,0.52,0.54
11,686,19,1207,8,4.17,1215,18.82,0.52,0.54
11,686,19,1207,8,4.17,1215,18.82,0.52,0.54
11,686,19,1207,8,4.17,1215,18.82,0.52,0.54
8,799,84,1281,14,6.8,1295,28.29,0.49,0.53
8,799,84,1281,14,6.8,1295,28.29,0.49,0.53
8,799,84,1281,14,6.8,1295,28.29,0.49,0.53
8,799,84,1281,14,6.8,1295,28.29,0.49,0.53
8,799,84,1281,14,6.8,1295,28.29,0.49,0.53
8,799,84,1281,14,6.8,1295,28.29,0.49,0.53
11,576,19,1269,13,6.43,1282,26.85,0.5,0.53
11,576,19,1269,13,6.43,1282,26.85,0.5,0.53
11,576,19,1269,13,6.43,1282,26.85,0.5,0.53
11,576,19,1269,13,6.43,1282,26.85,0.5,0.53
11,576,19,1269,13,6.43,1282,26.85,0.5,0.53
11,576,19,1269,13,6.43,1282,26.85,0.5,0.53
7,653,78,1303,9,4.3,1312,19.85,0.51,0.54
7,653,78,1303,9,4.3,1312,19.85,0.51,0.54
7,653,78,1303,9,4.3,1312,19.85,0.51,0.54
7,653,78,1303,9,4.3,1312,19.85,0.51,0.54
7,653,78,1303,9,4.3,1312,19.85,0.51,0.54
7,653,78,1303,9,4.3,1312,19.85,0.51,0.54
11,600,19,1312,11,5.56,1323,23.7,0.5,0.53
11,600,19,1312,11,5.56,1323,23.7,0.5,0.53
11,600,19,1312,11,5.56,1323,23.7,0.5,0.53
11,600,19,1312,11,5.56,1323,23.7,0.5,0.53
11,600,19,1312,11,5.56,1323,23.7,0.5,0.53
11,600,19,1312,11,5.56,1323,23.7,0.5,0.53
8,569,84,1329,22,10.81,1351,41.84,0.46,0.51
8,569,84,1329,22,10.81,1351,41.84,0.46,0.51
8,569,84,1329,22,10.81,1351,41.84,0.46,0.51
8,569,84,1329,22,10.81,1351,41.84,0.46,0.51
8,569,84,1329,22,10.81,1351,41.84,0.46,0.51
8,569,84,1329,22,10.81,1351,41.84,0.46,0.51
4,27,44,411,3,1.73,414,10.49,0.54,0.55
4,27,44,411,3,1.73,414,10.49,0.54,0.55
4,27,44,411,3,1.73,414,10.49,0.54,0.55
4,27,44,411,3,1.73,414,10.49,0.54,0.55
4,27,44,411,3,1.73,414,10.49,0.54,0.55
4,27,44,411,3,1.73,414,10.49,0.54,0.55
4,27,44,411,3,1.73,414,10.49,0.54,0.55
12,761,1,416,19,9.45,435,37.01,0.47000000000000003,0.52
12,761,1,416,19,9.45,435,37.01,0.47000000000000003,0.52
12,761,1,416,19,9.45,435,37.01,0.47000000000000003,0.52
12,761,1,416,19,9.45,435,37.01,0.47000000000000003,0.52
12,761,1,416,19,9.45,435,37.01,0.47000000000000003,0.52
12,761,1,416,19,9.45,435,37.01,0.47000000000000003,0.52
12,761,1,416,19,9.45,435,37.01,0.47000000000000003,0.52
4,240,44,423,4,2.19,427,12.11,0.53,0.55
4,240,44,423,4,2.19,427,12.11,0.53,0.55
4,240,44,423,4,2.19,427,12.11,0.53,0.55
4,240,44,423,4,2.19,427,12.11,0.53,0.55
4,240,44,423,4,2.19,427,12.11,0.53,0.55
4,240,44,423,4,2.19,427,12.11,0.53,0.55
4,240,44,423,4,2.19,427,12.11,0.53,0.55
6,37,83,424,9,4.5,433,20.22,0.51,0.54
6,37,83,424,9,4.5,433,20.22,0.51,0.54
6,37,83,424,9,4.5,433,20.22,0.51,0.54
6,37,83,424,9,4.5,433,20.22,0.51,0.54
6,37,83,424,9,4.5,433,20.22,0.51,0.54
6,37,83,424,9,4.5,433,20.22,0.51,0.54
6,37,83,424,9,4.5,433,20.22,0.51,0.54
8,226,77,438,5,2.71,443,13.83,0.53,0.55
8,226,77,438,5,2.71,443,13.83,0.53,0.55
8,226,77,438,5,2.71,443,13.83,0.53,0.55
8,226,77,438,5,2.71,443,13.83,0.53,0.55
8,226,77,438,5,2.71,443,13.83,0.53,0.55
8,226,77,438,5,2.71,443,13.83,0.53,0.55
8,226,77,438,5,2.71,443,13.83,0.53,0.55
11,63,68,423,19,9.52,442,37.14,0.47000000000000003,0.52
11,63,68,423,19,9.52,442,37.14,0.47000000000000003,0.52
11,63,68,423,19,9.52,442,37.14,0.47000000000000003,0.52
11,63,68,423,19,9.52,442,37.14,0.47000000000000003,0.52
11,63,68,423,19,9.52,442,37.14,0.47000000000000003,0.52
11,63,68,423,19,9.52,442,37.14,0.47000000000000003,0.52
11,63,68,423,19,9.52,442,37.14,0.47000000000000003,0.52
4,133,44,464,6,3.1,470,15.33,0.52,0.54
4,133,44,464,6,3.1,470,15.33,0.52,0.54
4,133,44,464,6,3.1,470,15.33,0.52,0.54
4,133,44,464,6,3.1,470,15.33,0.52,0.54
4,133,44,464,6,3.1,470,15.33,0.52,0.54
4,133,44,464,6,3.1,470,15.33,0.52,0.54
4,133,44,464,6,3.1,470,15.33,0.52,0.54
6,58,83,464,6,2.91,470,14.97,0.53,0.54
6,58,83,464,6,2.91,470,14.97,0.53,0.54
6,58,83,464,6,2.91,470,14.97,0.53,0.54
6,58,83,464,6,2.91,470,14.97,0.53,0.54
6,58,83,464,6,2.91,470,14.97,0.53,0.54
6,58,83,464,6,2.91,470,14.97,0.53,0.54
6,58,83,464,6,2.91,470,14.97,0.53,0.54
3,203,55,505,16,7.92,521,31.89,0.48,0.52
3,203,55,505,16,7.92,521,31.89,0.48,0.52
3,203,55,505,16,7.92,521,31.89,0.48,0.52
3,203,55,505,16,7.92,521,31.89,0.48,0.52
3,203,55,505,16,7.92,521,31.89,0.48,0.52
3,203,55,505,16,7.92,521,31.89,0.48,0.52
3,203,55,505,16,7.92,521,31.89,0.48,0.52
4,156,44,480,4,1.8,484,11.39,0.53,0.55
4,156,44,480,4,1.8,484,11.39,0.53,0.55
4,156,44,480,4,1.8,484,11.39,0.53,0.55
4,156,44,480,4,1.8,484,11.39,0.53,0.55
4,156,44,480,4,1.8,484,11.39,0.53,0.55
4,156,44,480,4,1.8,484,11.39,0.53,0.55
4,156,44,480,4,1.8,484,11.39,0.53,0.55
13,245,96,489,20,9.77,509,38.39,0.47000000000000003,0.51
13,245,96,489,20,9.77,509,38.39,0.47000000000000003,0.51
13,245,96,489,20,9.77,509,38.39,0.47000000000000003,0.51
13,245,96,489,20,9.77,509,38.39,0.47000000000000003,0.51
13,245,96,489,20,9.77,509,38.39,0.47000000000000003,0.51
13,245,96,489,20,9.77,509,38.39,0.47000000000000003,0.51
13,245,96,489,20,9.77,509,38.39,0.47000000000000003,0.51
6,233,83,510,12,5.96,522,25.21,0.5,0.53
6,233,83,510,12,5.96,522,25.21,0.5,0.53
6,233,83,510,12,5.96,522,25.21,0.5,0.53
6,233,83,510,12,5.96,522,25.21,0.5,0.53
6,233,83,510,12,5.96,522,25.21,0.5,0.53
6,233,83,510,12,5.96,522,25.21,0.5,0.53
6,233,83,510,12,5.96,522,25.21,0.5,0.53
10,76,27,517,8,4.01,525,18.54,0.52,0.54
10,76,27,517,8,4.01,525,18.54,0.52,0.54
10,76,27,517,8,4.01,525,18.54,0.52,0.54
10,76,27,517,8,4.01,525,18.54,0.52,0.54
10,76,27,517,8,4.01,525,18.54,0.52,0.54
10,76,27,517,8,4.01,525,18.54,0.52,0.54
10,76,27,517,8,4.01,525,18.54,0.52,0.54
12,117,1,542,12,6.11,554,25.48,0.5,0.53
12,117,1,542,12,6.11,554,25.48,0.5,0.53
12,117,1,542,12,6.11,554,25.48,0.5,0.53
12,117,1,542,12,6.11,554,25.48,0.5,0.53
12,117,1,542,12,6.11,554,25.48,0.5,0.53
12,117,1,542,12,6.11,554,25.48,0.5,0.53
12,117,1,542,12,6.11,554,25.48,0.5,0.53
6,170,83,571,5,2.69,576,13.79,0.53,0.55
6,170,83,571,5,2.69,576,13.79,0.53,0.55
6,170,83,571,5,2.69,576,13.79,0.53,0.55
6,170,83,571,5,2.69,576,13.79,0.53,0.55
6,170,83,571,5,2.69,576,13.79,0.53,0.55
6,170,83,571,5,2.69,576,13.79,0.53,0.55
6,170,83,571,5,2.69,576,13.79,0.53,0.55
7,926,92,633,19,9.55,652,37.2,0.47000000000000003,0.52
7,926,92,633,19,9.55,652,37.2,0.47000000000000003,0.52
7,926,92,633,19,9.55,652,37.2,0.47000000000000003,0.52
7,926,92,633,19,9.55,652,37.2,0.47000000000000003,0.52
7,926,92,633,19,9.55,652,37.2,0.47000000000000003,0.52
7,926,92,633,19,9.55,652,37.2,0.47000000000000003,0.52
7,926,92,633,19,9.55,652,37.2,0.47000000000000003,0.52
10,935,27,906,1,0.73,907,7.11,0.54,0.55
10,935,27,906,1,0.73,907,7.11,0.54,0.55
10,935,27,906,1,0.73,907,7.11,0.54,0.55
10,935,27,906,1,0.73,907,7.11,0.54,0.55
10,935,27,906,1,0.73,907,7.11,0.54,0.55
10,935,27,906,1,0.73,907,7.11,0.54,0.55
10,935,27,906,1,0.73,907,7.11,0.54,0.55
5,473,65,940,11,5.46,951,23.52,0.5,0.53
5,473,65,940,11,5.46,951,23.52,0.5,0.53
5,473,65,940,11,5.46,951,23.52,0.5,0.53
5,473,65,940,11,5.46,951,23.52,0.5,0.53
5,473,65,940,11,5.46,951,23.52,0.5,0.53
5,473,65,940,11,5.46,951,23.52,0.5,0.53
5,473,65,940,11,5.46,951,23.52,0.5,0.53
5,310,65,965,6,2.8,971,14.78,0.53,0.54
5,310,65,965,6,2.8,971,14.78,0.53,0.54
5,310,65,965,6,2.8,971,14.78,0.53,0.54
5,310,65,965,6,2.8,971,14.78,0.53,0.54
5,310,65,965,6,2.8,971,14.78,0.53,0.54
5,310,65,965,6,2.8,971,14.78,0.53,0.54
5,310,65,965,6,2.8,971,14.78,0.53,0.54
4,999,6,1019,2,0.97,1021,8.33,0.54,0.55
4,999,6,1019,2,0.97,1021,8.33,0.54,0.55
4,999,6,1019,2,0.97,1021,8.33,0.54,0.55
4,999,6,1019,2,0.97,1021,8.33,0.54,0.55
4,999,6,1019,2,0.97,1021,8.33,0.54,0.55
4,999,6,1019,2,0.97,1021,8.33,0.54,0.55
4,999,6,1019,2,0.97,1021,8.33,0.54,0.55
6,810,83,1005,11,5.63,1016,23.83,0.5,0.53
6,810,83,1005,11,5.63,1016,23.83,0.5,0.53
6,810,83,1005,11,5.63,1016,23.83,0.5,0.53
6,810,83,1005,11,5.63,1016,23.83,0.5,0.53
6,810,83,1005,11,5.63,1016,23.83,0.5,0.53
6,810,83,1005,11,5.63,1016,23.83,0.5,0.53
6,810,83,1005,11,5.63,1016,23.83,0.5,0.53
3,350,61,1034,3,1.55,1037,10.15,0.54,0.55
3,350,61,1034,3,1.55,1037,10.15,0.54,0.55
3,350,61,1034,3,1.55,1037,10.15,0.54,0.55
3,350,61,1034,3,1.55,1037,10.15,0.54,0.55
3,350,61,1034,3,1.55,1037,10.15,0.54,0.55
3,350,61,1034,3,1.55,1037,10.15,0.54,0.55
3,350,61,1034,3,1.55,1037,10.15,0.54,0.55
10,361,27,1030,10,5.02,1040,21.93,0.51,0.54
10,361,27,1030,10,5.02,1040,21.93,0.51,0.54
10,361,27,1030,10,5.02,1040,21.93,0.51,0.54
10,361,27,1030,10,5.02,1040,21.93,0.51,0.54
10,361,27,1030,10,5.02,1040,21.93,0.51,0.54
10,361,27,1030,10,5.02,1040,21.93,0.51,0.54
10,361,27,1030,10,5.02,1040,21.93,0.51,0.54
14,278,72,1020,16,8.2,1036,32.41,0.48,0.52
14,278,72,1020,16,8.2,1036,32.41,0.48,0.52
14,278,72,1020,16,8.2,1036,32.41,0.48,0.52
14,278,72,1020,16,8.2,1036,32.41,0.48,0.52
14,278,72,1020,16,8.2,1036,32.41,0.48,0.52
14,278,72,1020,16,8.2,1036,32.41,0.48,0.52
14,278,72,1020,16,8.2,1036,32.41,0.48,0.52
4,433,6,1050,11,5.49,1061,23.57,0.5,0.53
4,433,6,1050,11,5.49,1061,23.57,0.5,0.53
4,433,6,1050,11,5.49,1061,23.57,0.5,0.53
4,433,6,1050,11,5.49,1061,23.57,0.5,0.53
4,433,6,1050,11,5.49,1061,23.57,0.5,0.53
4,433,6,1050,11,5.49,1061,23.57,0.5,0.53
4,433,6,1050,11,5.49,1061,23.57,0.5,0.53
5,276,65,1063,10,5.23,1073,22.32,0.51,0.53
5,276,65,1063,10,5.23,1073,22.32,0.51,0.53
5,276,65,1063,10,5.23,1073,22.32,0.51,0.53
5,276,65,1063,10,5.23,1073,22.32,0.51,0.53
5,276,65,1063,10,5.23,1073,22.32,0.51,0.53
5,276,65,1063,10,5.23,1073,22.32,0.51,0.53
5,276,65,1063,10,5.23,1073,22.32,0.51,0.53
10,292,27,1073,12,5.85,1085,25.01,0.5,0.53
10,292,27,1073,12,5.85,1085,25.01,0.5,0.53
10,292,27,1073,12,5.85,1085,25.01,0.5,0.53
10,292,27,1073,12,5.85,1085,25.01,0.5,0.53
10,292,27,1073,12,5.85,1085,25.01,0.5,0.53
10,292,27,1073,12,5.85,1085,25.01,0.5,0.53
10,292,27,1073,12,5.85,1085,25.01,0.5,0.53
14,343,72,1070,17,8.75,1087,34.18,0.48,0.52
14,343,72,1070,17,8.75,1087,34.18,0.48,0.52
14,343,72,1070,17,8.75,1087,34.18,0.48,0.52
14,343,72,1070,17,8.75,1087,34.18,0.48,0.52
14,343,72,1070,17,8.75,1087,34.18,0.48,0.52
14,343,72,1070,17,8.75,1087,34.18,0.48,0.52
14,343,72,1070,17,8.75,1087,34.18,0.48,0.52
5,460,65,1087,8,3.88,1095,18.31,0.52,0.54
5,460,65,1087,8,3.88,1095,18.31,0.52,0.54
5,460,65,1087,8,3.88,1095,18.31,0.52,0.54
5,460,65,1087,8,3.88,1095,18.31,0.52,0.54
5,460,65,1087,8,3.88,1095,18.31,0.52,0.54
5,460,65,1087,8,3.88,1095,18.31,0.52,0.54
5,460,65,1087,8,3.88,1095,18.31,0.52,0.54
9,388,88,1100,8,4.16,1108,18.81,0.52,0.54
9,388,88,1100,8,4.16,1108,18.81,0.52,0.54
9,388,88,1100,8,4.16,1108,18.81,0.52,0.54
9,388,88,1100,8,4.16,1108,18.81,0.52,0.54
9,388,88,1100,8,4.16,1108,18.81,0.52,0.54
9,388,88,1100,8,4.16,1108,18.81,0.52,0.54
9,388,88,1100,8,4.16,1108,18.81,0.52,0.54
10,375,27,1088,8,4.04,1096,18.6,0.52,0.54
10,375,27,1088,8,4.04,1096,18.6,0.52,0.54
10,375,27,1088,8,4.04,1096,18.6,0.52,0.54
10,375,27,1088,8,4.04,1096,18.6,0.52,0.54
10,375,27,1088,8,4.04,1096,18.6,0.52,0.54
10,375,27,1088,8,4.04,1096,18.6,0.52,0.54
10,375,27,1088,8,4.04,1096,18.6,0.52,0.54
14,292,72,1094,15,7.6,1109,30.54,0.49,0.52
14,292,72,1094,15,7.6,1109,30.54,0.49,0.52
14,292,72,1094,15,7.6,1109,30.54,0.49,0.52
14,292,72,1094,15,7.6,1109,30.54,0.49,0.52
14,292,72,1094,15,7.6,1109,30.54,0.49,0.52
14,292,72,1094,15,7.6,1109,30.54,0.49,0.52
14,292,72,1094,15,7.6,1109,30.54,0.49,0.52
5,368,65,1139,5,2.68,1144,13.78,0.53,0.55
5,368,65,1139,5,2.68,1144,13.78,0.53,0.55
5,368,65,1139,5,2.68,1144,13.78,0.53,0.55
5,368,65,1139,5,2.68,1144,13.78,0.53,0.55
5,368,65,1139,5,2.68,1144,13.78,0.53,0.55
5,368,65,1139,5,2.68,1144,13.78,0.53,0.55
5,368,65,1139,5,2.68,1144,13.78,0.53,0.55
9,296,88,1112,5,2.52,1117,13.49,0.53,0.55
9,296,88,1112,5,2.52,1117,13.49,0.53,0.55
9,296,88,1112,5,2.52,1117,13.49,0.53,0.55
9,296,88,1112,5,2.52,1117,13.49,0.53,0.55
9,296,88,1112,5,2.52,1117,13.49,0.53,0.55
9,296,88,1112,5,2.52,1117,13.49,0.53,0.55
9,296,88,1112,5,2.52,1117,13.49,0.53,0.55
10,380,27,1134,11,5.48,1145,23.56,0.5,0.53
10,380,27,1134,11,5.48,1145,23.56,0.5,0.53
10,380,27,1134,11,5.48,1145,23.56,0.5,0.53
10,380,27,1134,11,5.48,1145,23.56,0.5,0.53
10,380,27,1134,11,5.48,1145,23.56,0.5,0.53
10,380,27,1134,11,5.48,1145,23.56,0.5,0.53
10,380,27,1134,11,5.48,1145,23.56,0.5,0.53
5,743,65,1192,6,2.79,1198,14.75,0.53,0.54
5,743,65,1192,6,2.79,1198,14.75,0.53,0.54
5,743,65,1192,6,2.79,1198,14.75,0.53,0.54
5,743,65,1192,6,2.79,1198,14.75,0.53,0.54
5,743,65,1192,6,2.79,1198,14.75,0.53,0.54
5,743,65,1192,6,2.79,1198,14.75,0.53,0.54
5,743,65,1192,6,2.79,1198,14.75,0.53,0.54
14,288,72,1176,19,9.57,1195,37.24,0.47000000000000003,0.52
14,288,72,1176,19,9.57,1195,37.24,0.47000000000000003,0.52
14,288,72,1176,19,9.57,1195,37.24,0.47000000000000003,0.52
14,288,72,1176,19,9.57,1195,37.24,0.47000000000000003,0.52
14,288,72,1176,19,9.57,1195,37.24,0.47000000000000003,0.52
14,288,72,1176,19,9.57,1195,37.24,0.47000000000000003,0.52
14,288,72,1176,19,9.57,1195,37.24,0.47000000000000003,0.52
11,600,22,1235,18,8.91,1253,35.26,0.47000000000000003,0.52
11,600,22,1235,18,8.91,1253,35.26,0.47000000000000003,0.52
11,600,22,1235,18,8.91,1253,35.26,0.47000000000000003,0.52
11,600,22,1235,18,8.91,1253,35.26,0.47000000000000003,0.52
11,600,22,1235,18,8.91,1253,35.26,0.47000000000000003,0.52
11,600,22,1235,18,8.91,1253,35.26,0.47000000000000003,0.52
11,600,22,1235,18,8.91,1253,35.26,0.47000000000000003,0.52
14,514,72,1238,5,2.4,1243,13.26,0.53,0.55
14,514,72,1238,5,2.4,1243,13.26,0.53,0.55
14,514,72,1238,5,2.4,1243,13.26,0.53,0.55
14,514,72,1238,5,2.4,1243,13.26,0.53,0.55
14,514,72,1238,5,2.4,1243,13.26,0.53,0.55
14,514,72,1238,5,2.4,1243,13.26,0.53,0.55
14,514,72,1238,5,2.4,1243,13.26,0.53,0.55
5,520,65,1285,10,5.18,1295,22.23,0.51,0.53
5,520,65,1285,10,5.18,1295,22.23,0.51,0.53
5,520,65,1285,10,5.18,1295,22.23,0.51,0.53
5,520,65,1285,10,5.18,1295,22.23,0.51,0.53
5,520,65,1285,10,5.18,1295,22.23,0.51,0.53
5,520,65,1285,10,5.18,1295,22.23,0.51,0.53
5,520,65,1285,10,5.18,1295,22.23,0.51,0.53
5,534,65,1313,2,1.2,1315,8.75,0.54,0.55
5,534,65,1313,2,1.2,1315,8.75,0.54,0.55
5,534,65,1313,2,1.2,1315,8.75,0.54,0.55
5,534,65,1313,2,1.2,1315,8.75,0.54,0.55
5,534,65,1313,2,1.2,1315,8.75,0.54,0.55
5,534,65,1313,2,1.2,1315,8.75,0.54,0.55
5,534,65,1313,2,1.2,1315,8.75,0.54,0.55
14,594,72,1315,17,8.6,1332,33.92,0.48,0.52
14,594,72,1315,17,8.6,1332,33.92,0.48,0.52
14,594,72,1315,17,8.6,1332,33.92,0.48,0.52
14,594,72,1315,17,8.6,1332,33.92,0.48,0.52
14,594,72,1315,17,8.6,1332,33.92,0.48,0.52
14,594,72,1315,17,8.6,1332,33.92,0.48,0.52
14,594,72,1315,17,8.6,1332,33.92,0.48,0.52
5,618,65,1329,16,7.96,1345,31.97,0.48,0.52
5,618,65,1329,16,7.96,1345,31.97,0.48,0.52
5,618,65,1329,16,7.96,1345,31.97,0.48,0.52
5,618,65,1329,16,7.96,1345,31.97,0.48,0.52
5,618,65,1329,16,7.96,1345,31.97,0.48,0.52
5,618,65,1329,16,7.96,1345,31.97,0.48,0.52
5,618,65,1329,16,7.96,1345,31.97,0.48,0.52
5,939,65,1354,7,3.64,1361,17.09,0.52,0.54
5,939,65,1354,7,3.64,1361,17.09,0.52,0.54
5,939,65,1354,7,3.64,1361,17.09,0.52,0.54
5,939,65,1354,7,3.64,1361,17.09,0.52,0.54
5,939,65,1354,7,3.64,1361,17.09,0.52,0.54
5,939,65,1354,7,3.64,1361,17.09,0.52,0.54
5,939,65,1354,7,3.64,1361,17.09,0.52,0.54
14,918,72,1414,5,2.62,1419,13.67,0.53,0.55
14,918,72,1414,5,2.62,1419,13.67,0.53,0.55
14,918,72,1414,5,2.62,1419,13.67,0.53,0.55
14,918,72,1414,5,2.62,1419,13.67,0.53,0.55
14,918,72,1414,5,2.62,1419,13.67,0.53,0.55
14,918,72,1414,5,2.62,1419,13.67,0.53,0.55
14,918,72,1414,5,2.62,1419,13.67,0.53,0.55
