square_index,rider_id,driver_idx,trip_start_timestamp,trip_duration,ride_miles,trip_end_timestamp,price_of_ride,rider_acceptance_prob,driver_acceptance_prob
7,954,51,219,8,4.23,227,18.94,0.52,0.54
5,875,40,290,10,4.78,300,21.5,0.51,0.54
15,898,26,309,15,7.52,324,30.39,0.49,0.52
5,207,40,406,13,6.39,419,26.77,0.5,0.53
15,888,26,416,19,9.41,435,36.95,0.47000000000000003,0.52
10,151,87,466,8,4.03,474,18.58,0.52,0.54
10,177,87,483,4,1.81,487,11.41,0.53,0.55
11,240,53,497,5,2.32,502,13.11,0.53,0.55
13,172,29,488,7,3.31,495,16.49,0.52,0.54
14,168,99,481,14,6.98,495,28.62,0.49,0.53
15,214,26,492,16,7.98,508,32.0,0.48,0.52
10,112,87,537,3,1.46,540,10.0,0.54,0.55
11,80,53,524,11,5.66,535,23.87,0.5,0.53
9,160,90,546,7,3.61,553,17.03,0.52,0.54
6,67,85,599,5,2.58,604,13.59,0.53,0.55
11,79,53,584,9,4.41,593,20.05,0.51,0.54
2,205,44,615,10,4.83,625,21.59,0.51,0.54
4,940,91,632,9,4.65,641,20.48,0.51,0.54
10,787,87,848,10,4.95,858,21.81,0.51,0.54
10,478,87,909,2,1.09,911,8.54,0.54,0.55
1,435,50,954,15,7.51,969,30.36,0.49,0.52
4,805,91,985,3,1.37,988,9.83,0.54,0.55
10,436,87,987,8,4.04,995,18.6,0.52,0.54
1,277,50,1002,18,8.96,1020,35.35,0.47000000000000003,0.52
4,377,91,1006,11,5.38,1017,23.37,0.5,0.53
1,448,50,1044,5,2.41,1049,13.29,0.53,0.55
7,254,2,1049,11,5.36,1060,23.33,0.5,0.53
13,398,69,1025,7,3.5,1032,16.84,0.52,0.54
7,295,2,1050,16,7.83,1066,31.74,0.48,0.52
1,385,50,1109,14,6.77,1123,28.24,0.49,0.53
4,416,91,1084,13,6.65,1097,27.24,0.49,0.53
1,385,50,1124,9,4.57,1133,20.34,0.51,0.54
1,256,50,1181,20,9.92,1201,38.66,0.47000000000000003,0.51
4,475,91,1178,18,8.88,1196,35.19,0.47000000000000003,0.52
1,510,50,1218,11,5.62,1229,23.81,0.5,0.53
1,642,50,1297,6,2.82,1303,14.81,0.53,0.54
15,682,26,1290,11,5.56,1301,23.7,0.5,0.53
15,521,26,1323,3,1.51,1326,10.09,0.54,0.55
1,579,50,1375,12,6.15,1387,25.55,0.5,0.53
15,731,26,1384,4,1.98,1388,11.73,0.53,0.55
14,775,29,330,3,1.57,333,10.2,0.54,0.55
14,775,29,330,3,1.57,333,10.2,0.54,0.55
12,58,53,361,11,5.67,372,23.89,0.5,0.53
12,58,53,361,11,5.67,372,23.89,0.5,0.53
3,83,87,402,19,9.3,421,36.75,0.47000000000000003,0.52
3,83,87,402,19,9.3,421,36.75,0.47000000000000003,0.52
7,218,99,426,13,6.69,439,27.32,0.49,0.53
7,218,99,426,13,6.69,439,27.32,0.49,0.53
9,194,63,423,7,3.4,430,16.65,0.52,0.54
9,194,63,423,7,3.4,430,16.65,0.52,0.54
12,22,53,445,16,8.22,461,32.44,0.48,0.52
12,22,53,445,16,8.22,461,32.44,0.48,0.52
14,218,29,431,3,1.43,434,9.95,0.54,0.55
14,218,29,431,3,1.43,434,9.95,0.54,0.55
0,56,70,462,17,8.73,479,34.14,0.48,0.52
0,56,70,462,17,8.73,479,34.14,0.48,0.52
4,30,7,451,8,3.89,459,18.32,0.52,0.54
4,30,7,451,8,3.89,459,18.32,0.52,0.54
5,90,30,451,4,1.9000000000000001,455,11.58,0.53,0.55
5,90,30,451,4,1.9000000000000001,455,11.58,0.53,0.55
7,63,99,463,8,4.04,471,18.59,0.52,0.54
7,63,99,463,8,4.04,471,18.59,0.52,0.54
0,180,70,488,10,5.1,498,22.08,0.51,0.53
0,180,70,488,10,5.1,498,22.08,0.51,0.53
6,133,9,500,8,4.08,508,18.66,0.52,0.54
6,133,9,500,8,4.08,508,18.66,0.52,0.54
10,24,89,494,5,2.44,499,13.33,0.53,0.55
10,24,89,494,5,2.44,499,13.33,0.53,0.55
12,242,53,480,14,7.19,494,29.0,0.49,0.53
12,242,53,480,14,7.19,494,29.0,0.49,0.53
15,39,56,499,2,0.97,501,8.33,0.54,0.55
15,39,56,499,2,0.97,501,8.33,0.54,0.55
0,30,70,514,10,5.19,524,22.24,0.51,0.53
0,30,70,514,10,5.19,524,22.24,0.51,0.53
5,58,30,536,13,6.74,549,27.41,0.49,0.53
5,58,30,536,13,6.74,549,27.41,0.49,0.53
10,214,89,521,17,8.33,538,33.42,0.48,0.52
10,214,89,521,17,8.33,538,33.42,0.48,0.52
12,126,53,525,16,8.14,541,32.29,0.48,0.52
12,126,53,525,16,8.14,541,32.29,0.48,0.52
14,82,29,519,2,1.22,521,8.79,0.54,0.55
14,82,29,519,2,1.22,521,8.79,0.54,0.55
6,817,9,592,9,4.74,601,20.64,0.51,0.54
6,817,9,592,9,4.74,601,20.64,0.51,0.54
14,912,29,603,9,4.56,612,20.32,0.51,0.54
14,912,29,603,9,4.56,612,20.32,0.51,0.54
14,804,29,657,21,10.48,678,40.46,0.46,0.51
14,804,29,657,21,10.48,678,40.46,0.46,0.51
4,999,8,921,11,5.61,932,23.78,0.5,0.53
4,999,8,921,11,5.61,932,23.78,0.5,0.53
10,688,89,1228,8,3.99,1236,18.5,0.52,0.54
10,688,89,1228,8,3.99,1236,18.5,0.52,0.54
11,614,41,1348,2,0.9400000000000001,1350,8.27,0.54,0.55
11,614,41,1348,2,0.9400000000000001,1350,8.27,0.54,0.55
0,778,98,38,15,7.32,53,30.03,0.49,0.52
0,778,98,38,15,7.32,53,30.03,0.49,0.52
0,778,98,38,15,7.32,53,30.03,0.49,0.52
7,845,31,87,14,6.91,101,28.5,0.49,0.53
7,845,31,87,14,6.91,101,28.5,0.49,0.53
7,845,31,87,14,6.91,101,28.5,0.49,0.53
0,976,98,207,6,3.12,213,15.35,0.52,0.54
0,976,98,207,6,3.12,213,15.35,0.52,0.54
0,976,98,207,6,3.12,213,15.35,0.52,0.54
0,82,98,326,14,7.0,340,28.67,0.49,0.53
0,82,98,326,14,7.0,340,28.67,0.49,0.53
0,82,98,326,14,7.0,340,28.67,0.49,0.53
5,783,77,324,2,1.17,326,8.69,0.54,0.55
5,783,77,324,2,1.17,326,8.69,0.54,0.55
5,783,77,324,2,1.17,326,8.69,0.54,0.55
5,753,77,367,10,5.24,377,22.34,0.51,0.53
5,753,77,367,10,5.24,377,22.34,0.51,0.53
5,753,77,367,10,5.24,377,22.34,0.51,0.53
8,78,67,361,9,4.72,370,20.61,0.51,0.54
8,78,67,361,9,4.72,370,20.61,0.51,0.54
8,78,67,361,9,4.72,370,20.61,0.51,0.54
0,58,98,408,23,11.66,431,44.17,0.45,0.51
0,58,98,408,23,11.66,431,44.17,0.45,0.51
0,58,98,408,23,11.66,431,44.17,0.45,0.51
5,198,77,406,11,5.36,417,23.34,0.5,0.53
5,198,77,406,11,5.36,417,23.34,0.5,0.53
5,198,77,406,11,5.36,417,23.34,0.5,0.53
8,227,67,411,16,7.82,427,31.71,0.48,0.52
8,227,67,411,16,7.82,427,31.71,0.48,0.52
8,227,67,411,16,7.82,427,31.71,0.48,0.52
3,192,13,448,20,9.94,468,38.69,0.47000000000000003,0.51
3,192,13,448,20,9.94,468,38.69,0.47000000000000003,0.51
3,192,13,448,20,9.94,468,38.69,0.47000000000000003,0.51
5,121,77,445,9,4.52,454,20.24,0.51,0.54
5,121,77,445,9,4.52,454,20.24,0.51,0.54
5,121,77,445,9,4.52,454,20.24,0.51,0.54
11,206,63,440,20,9.78,460,38.4,0.47000000000000003,0.51
11,206,63,440,20,9.78,460,38.4,0.47000000000000003,0.51
11,206,63,440,20,9.78,460,38.4,0.47000000000000003,0.51
12,10,84,427,11,5.37,438,23.35,0.5,0.53
12,10,84,427,11,5.37,438,23.35,0.5,0.53
12,10,84,427,11,5.37,438,23.35,0.5,0.53
14,196,97,433,6,3.14,439,15.39,0.52,0.54
14,196,97,433,6,3.14,439,15.39,0.52,0.54
14,196,97,433,6,3.14,439,15.39,0.52,0.54
1,56,11,451,4,2.23,455,12.18,0.53,0.55
1,56,11,451,4,2.23,455,12.18,0.53,0.55
1,56,11,451,4,2.23,455,12.18,0.53,0.55
5,236,77,464,11,5.59,475,23.76,0.5,0.53
5,236,77,464,11,5.59,475,23.76,0.5,0.53
5,236,77,464,11,5.59,475,23.76,0.5,0.53
8,8,67,456,5,2.49,461,13.43,0.53,0.55
8,8,67,456,5,2.49,461,13.43,0.53,0.55
8,8,67,456,5,2.49,461,13.43,0.53,0.55
12,120,84,471,16,8.15,487,32.3,0.48,0.52
12,120,84,471,16,8.15,487,32.3,0.48,0.52
12,120,84,471,16,8.15,487,32.3,0.48,0.52
2,180,82,506,7,3.5,513,16.83,0.52,0.54
2,180,82,506,7,3.5,513,16.83,0.52,0.54
2,180,82,506,7,3.5,513,16.83,0.52,0.54
5,213,77,485,11,5.73,496,24.01,0.5,0.53
5,213,77,485,11,5.73,496,24.01,0.5,0.53
5,213,77,485,11,5.73,496,24.01,0.5,0.53
11,236,63,480,10,5.22,490,22.3,0.51,0.53
11,236,63,480,10,5.22,490,22.3,0.51,0.53
11,236,63,480,10,5.22,490,22.3,0.51,0.53
14,963,97,488,9,4.72,497,20.61,0.51,0.54
14,963,97,488,9,4.72,497,20.61,0.51,0.54
14,963,97,488,9,4.72,497,20.61,0.51,0.54
5,24,77,538,9,4.26,547,19.78,0.51,0.54
5,24,77,538,9,4.26,547,19.78,0.51,0.54
5,24,77,538,9,4.26,547,19.78,0.51,0.54
6,139,71,522,7,3.44,529,16.71,0.52,0.54
6,139,71,522,7,3.44,529,16.71,0.52,0.54
6,139,71,522,7,3.44,529,16.71,0.52,0.54
8,89,67,513,2,1.09,515,8.55,0.54,0.55
8,89,67,513,2,1.09,515,8.55,0.54,0.55
8,89,67,513,2,1.09,515,8.55,0.54,0.55
12,1,84,529,18,9.2,547,35.78,0.47000000000000003,0.52
12,1,84,529,18,9.2,547,35.78,0.47000000000000003,0.52
12,1,84,529,18,9.2,547,35.78,0.47000000000000003,0.52
6,219,71,540,4,2.03,544,11.81,0.53,0.55
6,219,71,540,4,2.03,544,11.81,0.53,0.55
6,219,71,540,4,2.03,544,11.81,0.53,0.55
10,127,36,542,10,5.24,552,22.34,0.51,0.53
10,127,36,542,10,5.24,552,22.34,0.51,0.53
10,127,36,542,10,5.24,552,22.34,0.51,0.53
11,158,63,556,5,2.65,561,13.73,0.53,0.55
11,158,63,556,5,2.65,561,13.73,0.53,0.55
11,158,63,556,5,2.65,561,13.73,0.53,0.55
11,58,63,580,10,5.19,590,22.25,0.51,0.53
11,58,63,580,10,5.19,590,22.25,0.51,0.53
11,58,63,580,10,5.19,590,22.25,0.51,0.53
14,936,97,647,17,8.72,664,34.14,0.48,0.52
14,936,97,647,17,8.72,664,34.14,0.48,0.52
14,936,97,647,17,8.72,664,34.14,0.48,0.52
2,896,81,903,12,5.85,915,25.01,0.5,0.53
2,896,81,903,12,5.85,915,25.01,0.5,0.53
2,896,81,903,12,5.85,915,25.01,0.5,0.53
2,828,81,958,13,6.42,971,26.83,0.5,0.53
2,828,81,958,13,6.42,971,26.83,0.5,0.53
2,828,81,958,13,6.42,971,26.83,0.5,0.53
5,994,3,947,14,6.77,961,28.24,0.49,0.53
5,994,3,947,14,6.77,961,28.24,0.49,0.53
5,994,3,947,14,6.77,961,28.24,0.49,0.53
2,491,81,1016,9,4.42,1025,20.07,0.51,0.54
2,491,81,1016,9,4.42,1025,20.07,0.51,0.54
2,491,81,1016,9,4.42,1025,20.07,0.51,0.54
8,278,57,1019,10,5.09,1029,22.06,0.51,0.53
8,278,57,1019,10,5.09,1029,22.06,0.51,0.53
8,278,57,1019,10,5.09,1029,22.06,0.51,0.53
15,834,6,1036,14,6.85,1050,28.39,0.49,0.53
15,834,6,1036,14,6.85,1050,28.39,0.49,0.53
15,834,6,1036,14,6.85,1050,28.39,0.49,0.53
10,311,46,1054,8,4.13,1062,18.76,0.52,0.54
10,311,46,1054,8,4.13,1062,18.76,0.52,0.54
10,311,46,1054,8,4.13,1062,18.76,0.52,0.54
14,280,72,1056,18,8.95,1074,35.32,0.47000000000000003,0.52
14,280,72,1056,18,8.95,1074,35.32,0.47000000000000003,0.52
14,280,72,1056,18,8.95,1074,35.32,0.47000000000000003,0.52
15,286,6,1060,16,7.87,1076,31.81,0.48,0.52
15,286,6,1060,16,7.87,1076,31.81,0.48,0.52
15,286,6,1060,16,7.87,1076,31.81,0.48,0.52
14,280,72,1088,15,7.45,1103,30.26,0.49,0.52
14,280,72,1088,15,7.45,1103,30.26,0.49,0.52
14,280,72,1088,15,7.45,1103,30.26,0.49,0.52
14,352,72,1123,5,2.35,1128,13.18,0.53,0.55
14,352,72,1123,5,2.35,1128,13.18,0.53,0.55
14,352,72,1123,5,2.35,1128,13.18,0.53,0.55
6,680,1,1259,5,2.57,1264,13.58,0.53,0.55
6,680,1,1259,5,2.57,1264,13.58,0.53,0.55
6,680,1,1259,5,2.57,1264,13.58,0.53,0.55
14,835,72,1237,7,3.37,1244,16.6,0.52,0.54
14,835,72,1237,7,3.37,1244,16.6,0.52,0.54
14,835,72,1237,7,3.37,1244,16.6,0.52,0.54
6,655,1,1289,15,7.35,1304,30.08,0.49,0.52
6,655,1,1289,15,7.35,1304,30.08,0.49,0.52
6,655,1,1289,15,7.35,1304,30.08,0.49,0.52
14,590,72,1286,10,4.89,1296,21.69,0.51,0.54
14,590,72,1286,10,4.89,1296,21.69,0.51,0.54
14,590,72,1286,10,4.89,1296,21.69,0.51,0.54
14,633,72,1314,1,0.64,1315,6.95,0.55,0.55
14,633,72,1314,1,0.64,1315,6.95,0.55,0.55
14,633,72,1314,1,0.64,1315,6.95,0.55,0.55
6,951,1,1405,13,6.56,1418,27.08,0.49,0.53
6,951,1,1405,13,6.56,1418,27.08,0.49,0.53
6,951,1,1405,13,6.56,1418,27.08,0.49,0.53
10,578,26,1416,7,3.28,1423,16.42,0.52,0.54
10,578,26,1416,7,3.28,1423,16.42,0.52,0.54
10,578,26,1416,7,3.28,1423,16.42,0.52,0.54
3,940,79,299,17,8.6,316,33.91,0.48,0.52
3,940,79,299,17,8.6,316,33.91,0.48,0.52
3,940,79,299,17,8.6,316,33.91,0.48,0.52
3,940,79,299,17,8.6,316,33.91,0.48,0.52
6,180,20,295,2,0.78,297,7.97,0.54,0.55
6,180,20,295,2,0.78,297,7.97,0.54,0.55
6,180,20,295,2,0.78,297,7.97,0.54,0.55
6,180,20,295,2,0.78,297,7.97,0.54,0.55
11,824,63,271,17,8.72,288,34.13,0.48,0.52
11,824,63,271,17,8.72,288,34.13,0.48,0.52
11,824,63,271,17,8.72,288,34.13,0.48,0.52
11,824,63,271,17,8.72,288,34.13,0.48,0.52
6,917,20,325,2,1.02,327,8.42,0.54,0.55
6,917,20,325,2,1.02,327,8.42,0.54,0.55
6,917,20,325,2,1.02,327,8.42,0.54,0.55
6,917,20,325,2,1.02,327,8.42,0.54,0.55
0,151,47,369,14,6.96,383,28.6,0.49,0.53
0,151,47,369,14,6.96,383,28.6,0.49,0.53
0,151,47,369,14,6.96,383,28.6,0.49,0.53
0,151,47,369,14,6.96,383,28.6,0.49,0.53
3,872,79,370,15,7.62,385,30.57,0.49,0.52
3,872,79,370,15,7.62,385,30.57,0.49,0.52
3,872,79,370,15,7.62,385,30.57,0.49,0.52
3,872,79,370,15,7.62,385,30.57,0.49,0.52
0,150,47,415,7,3.49,422,16.81,0.52,0.54
0,150,47,415,7,3.49,422,16.81,0.52,0.54
0,150,47,415,7,3.49,422,16.81,0.52,0.54
0,150,47,415,7,3.49,422,16.81,0.52,0.54
3,163,79,402,3,1.43,405,9.94,0.54,0.55
3,163,79,402,3,1.43,405,9.94,0.54,0.55
3,163,79,402,3,1.43,405,9.94,0.54,0.55
3,163,79,402,3,1.43,405,9.94,0.54,0.55
12,112,19,399,16,7.8,415,31.68,0.48,0.52
12,112,19,399,16,7.8,415,31.68,0.48,0.52
12,112,19,399,16,7.8,415,31.68,0.48,0.52
12,112,19,399,16,7.8,415,31.68,0.48,0.52
0,79,47,421,20,10.23,441,39.22,0.46,0.51
0,79,47,421,20,10.23,441,39.22,0.46,0.51
0,79,47,421,20,10.23,441,39.22,0.46,0.51
0,79,47,421,20,10.23,441,39.22,0.46,0.51
2,117,55,438,6,2.88,444,14.93,0.53,0.54
2,117,55,438,6,2.88,444,14.93,0.53,0.54
2,117,55,438,6,2.88,444,14.93,0.53,0.54
2,117,55,438,6,2.88,444,14.93,0.53,0.54
13,114,92,435,7,3.42,442,16.68,0.52,0.54
13,114,92,435,7,3.42,442,16.68,0.52,0.54
13,114,92,435,7,3.42,442,16.68,0.52,0.54
13,114,92,435,7,3.42,442,16.68,0.52,0.54
13,17,92,469,3,1.39,472,9.87,0.54,0.55
13,17,92,469,3,1.39,472,9.87,0.54,0.55
13,17,92,469,3,1.39,472,9.87,0.54,0.55
13,17,92,469,3,1.39,472,9.87,0.54,0.55
4,174,46,480,14,7.03,494,28.72,0.49,0.53
4,174,46,480,14,7.03,494,28.72,0.49,0.53
4,174,46,480,14,7.03,494,28.72,0.49,0.53
4,174,46,480,14,7.03,494,28.72,0.49,0.53
5,150,39,509,13,6.68,522,27.3,0.49,0.53
5,150,39,509,13,6.68,522,27.3,0.49,0.53
5,150,39,509,13,6.68,522,27.3,0.49,0.53
5,150,39,509,13,6.68,522,27.3,0.49,0.53
13,82,92,481,12,5.89,493,25.09,0.5,0.53
13,82,92,481,12,5.89,493,25.09,0.5,0.53
13,82,92,481,12,5.89,493,25.09,0.5,0.53
13,82,92,481,12,5.89,493,25.09,0.5,0.53
15,181,7,499,14,7.07,513,28.78,0.49,0.53
15,181,7,499,14,7.07,513,28.78,0.49,0.53
15,181,7,499,14,7.07,513,28.78,0.49,0.53
15,181,7,499,14,7.07,513,28.78,0.49,0.53
0,18,47,510,3,1.32,513,9.73,0.54,0.55
0,18,47,510,3,1.32,513,9.73,0.54,0.55
0,18,47,510,3,1.32,513,9.73,0.54,0.55
0,18,47,510,3,1.32,513,9.73,0.54,0.55
2,18,55,516,15,7.26,531,29.91,0.49,0.53
2,18,55,516,15,7.26,531,29.91,0.49,0.53
2,18,55,516,15,7.26,531,29.91,0.49,0.53
2,18,55,516,15,7.26,531,29.91,0.49,0.53
4,136,46,527,15,7.61,542,30.54,0.49,0.52
4,136,46,527,15,7.61,542,30.54,0.49,0.52
4,136,46,527,15,7.61,542,30.54,0.49,0.52
4,136,46,527,15,7.61,542,30.54,0.49,0.52
5,80,39,512,12,6.02,524,25.31,0.5,0.53
5,80,39,512,12,6.02,524,25.31,0.5,0.53
5,80,39,512,12,6.02,524,25.31,0.5,0.53
5,80,39,512,12,6.02,524,25.31,0.5,0.53
7,174,22,530,2,1.15,532,8.65,0.54,0.55
7,174,22,530,2,1.15,532,8.65,0.54,0.55
7,174,22,530,2,1.15,532,8.65,0.54,0.55
7,174,22,530,2,1.15,532,8.65,0.54,0.55
15,79,7,531,9,4.34,540,19.92,0.51,0.54
15,79,7,531,9,4.34,540,19.92,0.51,0.54
15,79,7,531,9,4.34,540,19.92,0.51,0.54
15,79,7,531,9,4.34,540,19.92,0.51,0.54
5,165,39,545,14,7.07,559,28.79,0.49,0.53
5,165,39,545,14,7.07,559,28.79,0.49,0.53
5,165,39,545,14,7.07,559,28.79,0.49,0.53
5,165,39,545,14,7.07,559,28.79,0.49,0.53
9,934,2,560,8,3.98,568,18.48,0.52,0.54
9,934,2,560,8,3.98,568,18.48,0.52,0.54
9,934,2,560,8,3.98,568,18.48,0.52,0.54
9,934,2,560,8,3.98,568,18.48,0.52,0.54
4,80,46,577,12,6.19,589,25.62,0.5,0.53
4,80,46,577,12,6.19,589,25.62,0.5,0.53
4,80,46,577,12,6.19,589,25.62,0.5,0.53
4,80,46,577,12,6.19,589,25.62,0.5,0.53
7,140,22,589,15,7.55,604,30.45,0.49,0.52
7,140,22,589,15,7.55,604,30.45,0.49,0.52
7,140,22,589,15,7.55,604,30.45,0.49,0.52
7,140,22,589,15,7.55,604,30.45,0.49,0.52
0,830,47,680,21,10.33,701,40.18,0.46,0.51
0,830,47,680,21,10.33,701,40.18,0.46,0.51
0,830,47,680,21,10.33,701,40.18,0.46,0.51
0,830,47,680,21,10.33,701,40.18,0.46,0.51
0,929,47,693,21,10.38,714,40.27,0.46,0.51
0,929,47,693,21,10.38,714,40.27,0.46,0.51
0,929,47,693,21,10.38,714,40.27,0.46,0.51
0,929,47,693,21,10.38,714,40.27,0.46,0.51
7,923,22,767,10,4.76,777,21.47,0.51,0.54
7,923,22,767,10,4.76,777,21.47,0.51,0.54
7,923,22,767,10,4.76,777,21.47,0.51,0.54
7,923,22,767,10,4.76,777,21.47,0.51,0.54
10,985,6,787,8,3.9,795,18.33,0.52,0.54
10,985,6,787,8,3.9,795,18.33,0.52,0.54
10,985,6,787,8,3.9,795,18.33,0.52,0.54
10,985,6,787,8,3.9,795,18.33,0.52,0.54
2,850,55,819,8,4.19,827,18.87,0.52,0.54
2,850,55,819,8,4.19,827,18.87,0.52,0.54
2,850,55,819,8,4.19,827,18.87,0.52,0.54
2,850,55,819,8,4.19,827,18.87,0.52,0.54
3,798,18,957,4,1.91,961,11.6,0.53,0.55
3,798,18,957,4,1.91,961,11.6,0.53,0.55
3,798,18,957,4,1.91,961,11.6,0.53,0.55
3,798,18,957,4,1.91,961,11.6,0.53,0.55
5,361,81,1003,10,4.9,1013,21.71,0.51,0.54
5,361,81,1003,10,4.9,1013,21.71,0.51,0.54
5,361,81,1003,10,4.9,1013,21.71,0.51,0.54
5,361,81,1003,10,4.9,1013,21.71,0.51,0.54
6,253,66,998,3,1.25,1001,9.62,0.54,0.55
6,253,66,998,3,1.25,1001,9.62,0.54,0.55
6,253,66,998,3,1.25,1001,9.62,0.54,0.55
6,253,66,998,3,1.25,1001,9.62,0.54,0.55
3,278,18,1077,10,4.93,1087,21.77,0.51,0.54
3,278,18,1077,10,4.93,1087,21.77,0.51,0.54
3,278,18,1077,10,4.93,1087,21.77,0.51,0.54
3,278,18,1077,10,4.93,1087,21.77,0.51,0.54
3,332,18,1081,20,9.83,1101,38.48,0.47000000000000003,0.51
3,332,18,1081,20,9.83,1101,38.48,0.47000000000000003,0.51
3,332,18,1081,20,9.83,1101,38.48,0.47000000000000003,0.51
3,332,18,1081,20,9.83,1101,38.48,0.47000000000000003,0.51
3,257,18,1130,12,5.91,1142,25.11,0.5,0.53
3,257,18,1130,12,5.91,1142,25.11,0.5,0.53
3,257,18,1130,12,5.91,1142,25.11,0.5,0.53
3,257,18,1130,12,5.91,1142,25.11,0.5,0.53
3,295,18,1145,24,11.84,1169,45.28,0.45,0.51
3,295,18,1145,24,11.84,1169,45.28,0.45,0.51
3,295,18,1145,24,11.84,1169,45.28,0.45,0.51
3,295,18,1145,24,11.84,1169,45.28,0.45,0.51
0,689,38,1269,4,2.01,1273,11.77,0.53,0.55
0,689,38,1269,4,2.01,1273,11.77,0.53,0.55
0,689,38,1269,4,2.01,1273,11.77,0.53,0.55
0,689,38,1269,4,2.01,1273,11.77,0.53,0.55
8,60,42,388,8,4.19,396,18.87,0.52,0.54
8,60,42,388,8,4.19,396,18.87,0.52,0.54
8,60,42,388,8,4.19,396,18.87,0.52,0.54
8,60,42,388,8,4.19,396,18.87,0.52,0.54
8,60,42,388,8,4.19,396,18.87,0.52,0.54
15,852,85,371,16,7.9,387,31.85,0.48,0.52
15,852,85,371,16,7.9,387,31.85,0.48,0.52
15,852,85,371,16,7.9,387,31.85,0.48,0.52
15,852,85,371,16,7.9,387,31.85,0.48,0.52
15,852,85,371,16,7.9,387,31.85,0.48,0.52
1,214,32,446,5,2.73,451,13.88,0.53,0.55
1,214,32,446,5,2.73,451,13.88,0.53,0.55
1,214,32,446,5,2.73,451,13.88,0.53,0.55
1,214,32,446,5,2.73,451,13.88,0.53,0.55
1,214,32,446,5,2.73,451,13.88,0.53,0.55
3,183,52,465,7,3.71,472,17.21,0.52,0.54
3,183,52,465,7,3.71,472,17.21,0.52,0.54
3,183,52,465,7,3.71,472,17.21,0.52,0.54
3,183,52,465,7,3.71,472,17.21,0.52,0.54
3,183,52,465,7,3.71,472,17.21,0.52,0.54
5,890,24,468,9,4.31,477,19.87,0.51,0.54
5,890,24,468,9,4.31,477,19.87,0.51,0.54
5,890,24,468,9,4.31,477,19.87,0.51,0.54
5,890,24,468,9,4.31,477,19.87,0.51,0.54
5,890,24,468,9,4.31,477,19.87,0.51,0.54
15,84,85,474,16,8.01,490,32.05,0.48,0.52
15,84,85,474,16,8.01,490,32.05,0.48,0.52
15,84,85,474,16,8.01,490,32.05,0.48,0.52
15,84,85,474,16,8.01,490,32.05,0.48,0.52
15,84,85,474,16,8.01,490,32.05,0.48,0.52
5,79,24,501,9,4.5,510,20.2,0.51,0.54
5,79,24,501,9,4.5,510,20.2,0.51,0.54
5,79,24,501,9,4.5,510,20.2,0.51,0.54
5,79,24,501,9,4.5,510,20.2,0.51,0.54
5,79,24,501,9,4.5,510,20.2,0.51,0.54
13,901,27,506,12,5.94,518,25.16,0.5,0.53
13,901,27,506,12,5.94,518,25.16,0.5,0.53
13,901,27,506,12,5.94,518,25.16,0.5,0.53
13,901,27,506,12,5.94,518,25.16,0.5,0.53
13,901,27,506,12,5.94,518,25.16,0.5,0.53
15,58,85,495,8,4.19,503,18.87,0.52,0.54
15,58,85,495,8,4.19,503,18.87,0.52,0.54
15,58,85,495,8,4.19,503,18.87,0.52,0.54
15,58,85,495,8,4.19,503,18.87,0.52,0.54
15,58,85,495,8,4.19,503,18.87,0.52,0.54
1,236,32,523,9,4.28,532,19.81,0.51,0.54
1,236,32,523,9,4.28,532,19.81,0.51,0.54
1,236,32,523,9,4.28,532,19.81,0.51,0.54
1,236,32,523,9,4.28,532,19.81,0.51,0.54
1,236,32,523,9,4.28,532,19.81,0.51,0.54
5,561,24,515,5,2.45,520,13.36,0.53,0.55
5,561,24,515,5,2.45,520,13.36,0.53,0.55
5,561,24,515,5,2.45,520,13.36,0.53,0.55
5,561,24,515,5,2.45,520,13.36,0.53,0.55
5,561,24,515,5,2.45,520,13.36,0.53,0.55
14,112,23,518,8,4.18,526,18.85,0.52,0.54
14,112,23,518,8,4.18,526,18.85,0.52,0.54
14,112,23,518,8,4.18,526,18.85,0.52,0.54
14,112,23,518,8,4.18,526,18.85,0.52,0.54
14,112,23,518,8,4.18,526,18.85,0.52,0.54
1,828,32,563,9,4.49,572,20.2,0.51,0.54
1,828,32,563,9,4.49,572,20.2,0.51,0.54
1,828,32,563,9,4.49,572,20.2,0.51,0.54
1,828,32,563,9,4.49,572,20.2,0.51,0.54
1,828,32,563,9,4.49,572,20.2,0.51,0.54
4,213,19,563,5,2.54,568,13.53,0.53,0.55
4,213,19,563,5,2.54,568,13.53,0.53,0.55
4,213,19,563,5,2.54,568,13.53,0.53,0.55
4,213,19,563,5,2.54,568,13.53,0.53,0.55
4,213,19,563,5,2.54,568,13.53,0.53,0.55
6,91,97,546,3,1.5,549,10.07,0.54,0.55
6,91,97,546,3,1.5,549,10.07,0.54,0.55
6,91,97,546,3,1.5,549,10.07,0.54,0.55
6,91,97,546,3,1.5,549,10.07,0.54,0.55
6,91,97,546,3,1.5,549,10.07,0.54,0.55
4,180,19,579,5,2.44,584,13.34,0.53,0.55
4,180,19,579,5,2.44,584,13.34,0.53,0.55
4,180,19,579,5,2.44,584,13.34,0.53,0.55
4,180,19,579,5,2.44,584,13.34,0.53,0.55
4,180,19,579,5,2.44,584,13.34,0.53,0.55
15,679,85,577,10,5.08,587,22.04,0.51,0.53
15,679,85,577,10,5.08,587,22.04,0.51,0.53
15,679,85,577,10,5.08,587,22.04,0.51,0.53
15,679,85,577,10,5.08,587,22.04,0.51,0.53
15,679,85,577,10,5.08,587,22.04,0.51,0.53
9,79,74,600,9,4.28,609,19.81,0.51,0.54
9,79,74,600,9,4.28,609,19.81,0.51,0.54
9,79,74,600,9,4.28,609,19.81,0.51,0.54
9,79,74,600,9,4.28,609,19.81,0.51,0.54
9,79,74,600,9,4.28,609,19.81,0.51,0.54
11,817,26,655,8,4.06,663,18.63,0.52,0.54
11,817,26,655,8,4.06,663,18.63,0.52,0.54
11,817,26,655,8,4.06,663,18.63,0.52,0.54
11,817,26,655,8,4.06,663,18.63,0.52,0.54
11,817,26,655,8,4.06,663,18.63,0.52,0.54
5,837,24,685,7,3.36,692,16.58,0.52,0.54
5,837,24,685,7,3.36,692,16.58,0.52,0.54
5,837,24,685,7,3.36,692,16.58,0.52,0.54
5,837,24,685,7,3.36,692,16.58,0.52,0.54
5,837,24,685,7,3.36,692,16.58,0.52,0.54
1,814,32,736,11,5.52,747,23.63,0.5,0.53
1,814,32,736,11,5.52,747,23.63,0.5,0.53
1,814,32,736,11,5.52,747,23.63,0.5,0.53
1,814,32,736,11,5.52,747,23.63,0.5,0.53
1,814,32,736,11,5.52,747,23.63,0.5,0.53
5,800,24,720,6,3.23,726,15.55,0.52,0.54
5,800,24,720,6,3.23,726,15.55,0.52,0.54
5,800,24,720,6,3.23,726,15.55,0.52,0.54
5,800,24,720,6,3.23,726,15.55,0.52,0.54
5,800,24,720,6,3.23,726,15.55,0.52,0.54
7,256,99,1013,16,8.12,1029,32.25,0.48,0.52
7,256,99,1013,16,8.12,1029,32.25,0.48,0.52
7,256,99,1013,16,8.12,1029,32.25,0.48,0.52
7,256,99,1013,16,8.12,1029,32.25,0.48,0.52
7,256,99,1013,16,8.12,1029,32.25,0.48,0.52
2,436,91,1032,12,6.01,1044,25.3,0.5,0.53
2,436,91,1032,12,6.01,1044,25.3,0.5,0.53
2,436,91,1032,12,6.01,1044,25.3,0.5,0.53
2,436,91,1032,12,6.01,1044,25.3,0.5,0.53
2,436,91,1032,12,6.01,1044,25.3,0.5,0.53
7,256,99,1048,1,0.61,1049,6.9,0.55,0.55
7,256,99,1048,1,0.61,1049,6.9,0.55,0.55
7,256,99,1048,1,0.61,1049,6.9,0.55,0.55
7,256,99,1048,1,0.61,1049,6.9,0.55,0.55
7,256,99,1048,1,0.61,1049,6.9,0.55,0.55
2,311,91,1064,5,2.35,1069,13.18,0.53,0.55
2,311,91,1064,5,2.35,1069,13.18,0.53,0.55
2,311,91,1064,5,2.35,1069,13.18,0.53,0.55
2,311,91,1064,5,2.35,1069,13.18,0.53,0.55
2,311,91,1064,5,2.35,1069,13.18,0.53,0.55
2,299,91,1090,15,7.64,1105,30.6,0.49,0.52
2,299,91,1090,15,7.64,1105,30.6,0.49,0.52
2,299,91,1090,15,7.64,1105,30.6,0.49,0.52
2,299,91,1090,15,7.64,1105,30.6,0.49,0.52
2,299,91,1090,15,7.64,1105,30.6,0.49,0.52
7,498,99,1095,17,8.39,1112,33.54,0.48,0.52
7,498,99,1095,17,8.39,1112,33.54,0.48,0.52
7,498,99,1095,17,8.39,1112,33.54,0.48,0.52
7,498,99,1095,17,8.39,1112,33.54,0.48,0.52
7,498,99,1095,17,8.39,1112,33.54,0.48,0.52
9,373,59,1105,10,5.01,1115,21.92,0.51,0.54
9,373,59,1105,10,5.01,1115,21.92,0.51,0.54
9,373,59,1105,10,5.01,1115,21.92,0.51,0.54
9,373,59,1105,10,5.01,1115,21.92,0.51,0.54
9,373,59,1105,10,5.01,1115,21.92,0.51,0.54
14,291,23,1085,10,4.97,1095,21.85,0.51,0.54
14,291,23,1085,10,4.97,1095,21.85,0.51,0.54
14,291,23,1085,10,4.97,1095,21.85,0.51,0.54
14,291,23,1085,10,4.97,1095,21.85,0.51,0.54
14,291,23,1085,10,4.97,1095,21.85,0.51,0.54
2,441,91,1113,15,7.4,1128,30.17,0.49,0.52
2,441,91,1113,15,7.4,1128,30.17,0.49,0.52
2,441,91,1113,15,7.4,1128,30.17,0.49,0.52
2,441,91,1113,15,7.4,1128,30.17,0.49,0.52
2,441,91,1113,15,7.4,1128,30.17,0.49,0.52
7,344,99,1117,15,7.71,1132,30.74,0.49,0.52
7,344,99,1117,15,7.71,1132,30.74,0.49,0.52
7,344,99,1117,15,7.71,1132,30.74,0.49,0.52
7,344,99,1117,15,7.71,1132,30.74,0.49,0.52
7,344,99,1117,15,7.71,1132,30.74,0.49,0.52
2,363,91,1143,19,9.35,1162,36.84,0.47000000000000003,0.52
2,363,91,1143,19,9.35,1162,36.84,0.47000000000000003,0.52
2,363,91,1143,19,9.35,1162,36.84,0.47000000000000003,0.52
2,363,91,1143,19,9.35,1162,36.84,0.47000000000000003,0.52
2,363,91,1143,19,9.35,1162,36.84,0.47000000000000003,0.52
9,856,59,1159,7,3.28,1166,16.43,0.52,0.54
9,856,59,1159,7,3.28,1166,16.43,0.52,0.54
9,856,59,1159,7,3.28,1166,16.43,0.52,0.54
9,856,59,1159,7,3.28,1166,16.43,0.52,0.54
9,856,59,1159,7,3.28,1166,16.43,0.52,0.54
7,681,99,1195,16,7.95,1211,31.96,0.48,0.52
7,681,99,1195,16,7.95,1211,31.96,0.48,0.52
7,681,99,1195,16,7.95,1211,31.96,0.48,0.52
7,681,99,1195,16,7.95,1211,31.96,0.48,0.52
7,681,99,1195,16,7.95,1211,31.96,0.48,0.52
9,835,59,1172,4,1.82,1176,11.43,0.53,0.55
9,835,59,1172,4,1.82,1176,11.43,0.53,0.55
9,835,59,1172,4,1.82,1176,11.43,0.53,0.55
9,835,59,1172,4,1.82,1176,11.43,0.53,0.55
9,835,59,1172,4,1.82,1176,11.43,0.53,0.55
2,740,91,1208,5,2.5100000000000002,1213,13.47,0.53,0.55
2,740,91,1208,5,2.5100000000000002,1213,13.47,0.53,0.55
2,740,91,1208,5,2.5100000000000002,1213,13.47,0.53,0.55
2,740,91,1208,5,2.5100000000000002,1213,13.47,0.53,0.55
2,740,91,1208,5,2.5100000000000002,1213,13.47,0.53,0.55
2,659,91,1242,6,2.82,1248,14.81,0.53,0.54
2,659,91,1242,6,2.82,1248,14.81,0.53,0.54
2,659,91,1242,6,2.82,1248,14.81,0.53,0.54
2,659,91,1242,6,2.82,1248,14.81,0.53,0.54
2,659,91,1242,6,2.82,1248,14.81,0.53,0.54
9,898,59,1232,12,6.21,1244,25.67,0.5,0.53
9,898,59,1232,12,6.21,1244,25.67,0.5,0.53
9,898,59,1232,12,6.21,1244,25.67,0.5,0.53
9,898,59,1232,12,6.21,1244,25.67,0.5,0.53
9,898,59,1232,12,6.21,1244,25.67,0.5,0.53
5,641,5,1279,8,3.99,1287,18.51,0.52,0.54
5,641,5,1279,8,3.99,1287,18.51,0.52,0.54
5,641,5,1279,8,3.99,1287,18.51,0.52,0.54
5,641,5,1279,8,3.99,1287,18.51,0.52,0.54
5,641,5,1279,8,3.99,1287,18.51,0.52,0.54
9,581,59,1273,8,3.9,1281,18.34,0.52,0.54
9,581,59,1273,8,3.9,1281,18.34,0.52,0.54
9,581,59,1273,8,3.9,1281,18.34,0.52,0.54
9,581,59,1273,8,3.9,1281,18.34,0.52,0.54
9,581,59,1273,8,3.9,1281,18.34,0.52,0.54
2,637,91,1296,13,6.72,1309,27.38,0.49,0.53
2,637,91,1296,13,6.72,1309,27.38,0.49,0.53
2,637,91,1296,13,6.72,1309,27.38,0.49,0.53
2,637,91,1296,13,6.72,1309,27.38,0.49,0.53
2,637,91,1296,13,6.72,1309,27.38,0.49,0.53
5,552,5,1331,14,6.89,1345,28.46,0.49,0.53
5,552,5,1331,14,6.89,1345,28.46,0.49,0.53
5,552,5,1331,14,6.89,1345,28.46,0.49,0.53
5,552,5,1331,14,6.89,1345,28.46,0.49,0.53
5,552,5,1331,14,6.89,1345,28.46,0.49,0.53
9,778,59,1339,8,3.95,1347,18.44,0.52,0.54
9,778,59,1339,8,3.95,1347,18.44,0.52,0.54
9,778,59,1339,8,3.95,1347,18.44,0.52,0.54
9,778,59,1339,8,3.95,1347,18.44,0.52,0.54
9,778,59,1339,8,3.95,1347,18.44,0.52,0.54
5,689,5,1355,8,4.03,1363,18.58,0.52,0.54
5,689,5,1355,8,4.03,1363,18.58,0.52,0.54
5,689,5,1355,8,4.03,1363,18.58,0.52,0.54
5,689,5,1355,8,4.03,1363,18.58,0.52,0.54
5,689,5,1355,8,4.03,1363,18.58,0.52,0.54
7,591,99,1372,9,4.65,1381,20.48,0.51,0.54
7,591,99,1372,9,4.65,1381,20.48,0.51,0.54
7,591,99,1372,9,4.65,1381,20.48,0.51,0.54
7,591,99,1372,9,4.65,1381,20.48,0.51,0.54
7,591,99,1372,9,4.65,1381,20.48,0.51,0.54
7,531,99,1384,7,3.28,1391,16.42,0.52,0.54
7,531,99,1384,7,3.28,1391,16.42,0.52,0.54
7,531,99,1384,7,3.28,1391,16.42,0.52,0.54
7,531,99,1384,7,3.28,1391,16.42,0.52,0.54
7,531,99,1384,7,3.28,1391,16.42,0.52,0.54
14,874,56,239,13,6.5,252,26.97,0.5,0.53
14,874,56,239,13,6.5,252,26.97,0.5,0.53
14,874,56,239,13,6.5,252,26.97,0.5,0.53
14,874,56,239,13,6.5,252,26.97,0.5,0.53
14,874,56,239,13,6.5,252,26.97,0.5,0.53
14,874,56,239,13,6.5,252,26.97,0.5,0.53
11,899,19,264,9,4.58,273,20.36,0.51,0.54
11,899,19,264,9,4.58,273,20.36,0.51,0.54
11,899,19,264,9,4.58,273,20.36,0.51,0.54
11,899,19,264,9,4.58,273,20.36,0.51,0.54
11,899,19,264,9,4.58,273,20.36,0.51,0.54
11,899,19,264,9,4.58,273,20.36,0.51,0.54
13,788,60,312,6,3.0,318,15.14,0.52,0.54
13,788,60,312,6,3.0,318,15.14,0.52,0.54
13,788,60,312,6,3.0,318,15.14,0.52,0.54
13,788,60,312,6,3.0,318,15.14,0.52,0.54
13,788,60,312,6,3.0,318,15.14,0.52,0.54
13,788,60,312,6,3.0,318,15.14,0.52,0.54
11,22,19,360,2,1.24,362,8.82,0.54,0.55
11,22,19,360,2,1.24,362,8.82,0.54,0.55
11,22,19,360,2,1.24,362,8.82,0.54,0.55
11,22,19,360,2,1.24,362,8.82,0.54,0.55
11,22,19,360,2,1.24,362,8.82,0.54,0.55
11,22,19,360,2,1.24,362,8.82,0.54,0.55
14,213,56,377,6,2.97,383,15.09,0.52,0.54
14,213,56,377,6,2.97,383,15.09,0.52,0.54
14,213,56,377,6,2.97,383,15.09,0.52,0.54
14,213,56,377,6,2.97,383,15.09,0.52,0.54
14,213,56,377,6,2.97,383,15.09,0.52,0.54
14,213,56,377,6,2.97,383,15.09,0.52,0.54
9,680,0,408,11,5.47,419,23.54,0.5,0.53
9,680,0,408,11,5.47,419,23.54,0.5,0.53
9,680,0,408,11,5.47,419,23.54,0.5,0.53
9,680,0,408,11,5.47,419,23.54,0.5,0.53
9,680,0,408,11,5.47,419,23.54,0.5,0.53
9,680,0,408,11,5.47,419,23.54,0.5,0.53
13,16,60,391,4,2.23,395,12.17,0.53,0.55
13,16,60,391,4,2.23,395,12.17,0.53,0.55
13,16,60,391,4,2.23,395,12.17,0.53,0.55
13,16,60,391,4,2.23,395,12.17,0.53,0.55
13,16,60,391,4,2.23,395,12.17,0.53,0.55
13,16,60,391,4,2.23,395,12.17,0.53,0.55
14,867,56,410,15,7.46,425,30.27,0.49,0.52
14,867,56,410,15,7.46,425,30.27,0.49,0.52
14,867,56,410,15,7.46,425,30.27,0.49,0.52
14,867,56,410,15,7.46,425,30.27,0.49,0.52
14,867,56,410,15,7.46,425,30.27,0.49,0.52
14,867,56,410,15,7.46,425,30.27,0.49,0.52
0,954,94,440,4,2.07,444,11.89,0.53,0.55
0,954,94,440,4,2.07,444,11.89,0.53,0.55
0,954,94,440,4,2.07,444,11.89,0.53,0.55
0,954,94,440,4,2.07,444,11.89,0.53,0.55
0,954,94,440,4,2.07,444,11.89,0.53,0.55
0,954,94,440,4,2.07,444,11.89,0.53,0.55
1,9,80,433,6,3.21,439,15.53,0.52,0.54
1,9,80,433,6,3.21,439,15.53,0.52,0.54
1,9,80,433,6,3.21,439,15.53,0.52,0.54
1,9,80,433,6,3.21,439,15.53,0.52,0.54
1,9,80,433,6,3.21,439,15.53,0.52,0.54
1,9,80,433,6,3.21,439,15.53,0.52,0.54
2,81,3,434,6,2.95,440,15.04,0.52,0.54
2,81,3,434,6,2.95,440,15.04,0.52,0.54
2,81,3,434,6,2.95,440,15.04,0.52,0.54
2,81,3,434,6,2.95,440,15.04,0.52,0.54
2,81,3,434,6,2.95,440,15.04,0.52,0.54
2,81,3,434,6,2.95,440,15.04,0.52,0.54
4,114,15,434,6,3.24,440,15.58,0.52,0.54
4,114,15,434,6,3.24,440,15.58,0.52,0.54
4,114,15,434,6,3.24,440,15.58,0.52,0.54
4,114,15,434,6,3.24,440,15.58,0.52,0.54
4,114,15,434,6,3.24,440,15.58,0.52,0.54
4,114,15,434,6,3.24,440,15.58,0.52,0.54
0,94,94,466,3,1.34,469,9.77,0.54,0.55
0,94,94,466,3,1.34,469,9.77,0.54,0.55
0,94,94,466,3,1.34,469,9.77,0.54,0.55
0,94,94,466,3,1.34,469,9.77,0.54,0.55
0,94,94,466,3,1.34,469,9.77,0.54,0.55
0,94,94,466,3,1.34,469,9.77,0.54,0.55
2,180,3,466,8,3.94,474,18.42,0.52,0.54
2,180,3,466,8,3.94,474,18.42,0.52,0.54
2,180,3,466,8,3.94,474,18.42,0.52,0.54
2,180,3,466,8,3.94,474,18.42,0.52,0.54
2,180,3,466,8,3.94,474,18.42,0.52,0.54
2,180,3,466,8,3.94,474,18.42,0.52,0.54
4,163,15,475,1,0.6900000000000001,476,7.03,0.54,0.55
4,163,15,475,1,0.6900000000000001,476,7.03,0.54,0.55
4,163,15,475,1,0.6900000000000001,476,7.03,0.54,0.55
4,163,15,475,1,0.6900000000000001,476,7.03,0.54,0.55
4,163,15,475,1,0.6900000000000001,476,7.03,0.54,0.55
4,163,15,475,1,0.6900000000000001,476,7.03,0.54,0.55
6,22,90,465,11,5.56,476,23.7,0.5,0.53
6,22,90,465,11,5.56,476,23.7,0.5,0.53
6,22,90,465,11,5.56,476,23.7,0.5,0.53
6,22,90,465,11,5.56,476,23.7,0.5,0.53
6,22,90,465,11,5.56,476,23.7,0.5,0.53
6,22,90,465,11,5.56,476,23.7,0.5,0.53
9,213,0,456,9,4.6,465,20.38,0.51,0.54
9,213,0,456,9,4.6,465,20.38,0.51,0.54
9,213,0,456,9,4.6,465,20.38,0.51,0.54
9,213,0,456,9,4.6,465,20.38,0.51,0.54
9,213,0,456,9,4.6,465,20.38,0.51,0.54
9,213,0,456,9,4.6,465,20.38,0.51,0.54
10,175,10,469,9,4.41,478,20.05,0.51,0.54
10,175,10,469,9,4.41,478,20.05,0.51,0.54
10,175,10,469,9,4.41,478,20.05,0.51,0.54
10,175,10,469,9,4.41,478,20.05,0.51,0.54
10,175,10,469,9,4.41,478,20.05,0.51,0.54
10,175,10,469,9,4.41,478,20.05,0.51,0.54
15,66,82,458,5,2.47,463,13.4,0.53,0.55
15,66,82,458,5,2.47,463,13.4,0.53,0.55
15,66,82,458,5,2.47,463,13.4,0.53,0.55
15,66,82,458,5,2.47,463,13.4,0.53,0.55
15,66,82,458,5,2.47,463,13.4,0.53,0.55
15,66,82,458,5,2.47,463,13.4,0.53,0.55
0,58,94,504,15,7.39,519,30.15,0.49,0.52
0,58,94,504,15,7.39,519,30.15,0.49,0.52
0,58,94,504,15,7.39,519,30.15,0.49,0.52
0,58,94,504,15,7.39,519,30.15,0.49,0.52
0,58,94,504,15,7.39,519,30.15,0.49,0.52
0,58,94,504,15,7.39,519,30.15,0.49,0.52
2,58,3,480,12,5.9,492,25.1,0.5,0.53
2,58,3,480,12,5.9,492,25.1,0.5,0.53
2,58,3,480,12,5.9,492,25.1,0.5,0.53
2,58,3,480,12,5.9,492,25.1,0.5,0.53
2,58,3,480,12,5.9,492,25.1,0.5,0.53
2,58,3,480,12,5.9,492,25.1,0.5,0.53
4,206,15,503,7,3.52,510,16.87,0.52,0.54
4,206,15,503,7,3.52,510,16.87,0.52,0.54
4,206,15,503,7,3.52,510,16.87,0.52,0.54
4,206,15,503,7,3.52,510,16.87,0.52,0.54
4,206,15,503,7,3.52,510,16.87,0.52,0.54
4,206,15,503,7,3.52,510,16.87,0.52,0.54
8,114,50,484,13,6.3,497,26.61,0.5,0.53
8,114,50,484,13,6.3,497,26.61,0.5,0.53
8,114,50,484,13,6.3,497,26.61,0.5,0.53
8,114,50,484,13,6.3,497,26.61,0.5,0.53
8,114,50,484,13,6.3,497,26.61,0.5,0.53
8,114,50,484,13,6.3,497,26.61,0.5,0.53
1,18,80,517,10,4.98,527,21.87,0.51,0.54
1,18,80,517,10,4.98,527,21.87,0.51,0.54
1,18,80,517,10,4.98,527,21.87,0.51,0.54
1,18,80,517,10,4.98,527,21.87,0.51,0.54
1,18,80,517,10,4.98,527,21.87,0.51,0.54
1,18,80,517,10,4.98,527,21.87,0.51,0.54
2,207,3,536,3,1.56,539,10.18,0.54,0.55
2,207,3,536,3,1.56,539,10.18,0.54,0.55
2,207,3,536,3,1.56,539,10.18,0.54,0.55
2,207,3,536,3,1.56,539,10.18,0.54,0.55
2,207,3,536,3,1.56,539,10.18,0.54,0.55
2,207,3,536,3,1.56,539,10.18,0.54,0.55
4,79,15,517,17,8.4,534,33.55,0.48,0.52
4,79,15,517,17,8.4,534,33.55,0.48,0.52
4,79,15,517,17,8.4,534,33.55,0.48,0.52
4,79,15,517,17,8.4,534,33.55,0.48,0.52
4,79,15,517,17,8.4,534,33.55,0.48,0.52
4,79,15,517,17,8.4,534,33.55,0.48,0.52
8,174,50,518,12,6.05,530,25.38,0.5,0.53
8,174,50,518,12,6.05,530,25.38,0.5,0.53
8,174,50,518,12,6.05,530,25.38,0.5,0.53
8,174,50,518,12,6.05,530,25.38,0.5,0.53
8,174,50,518,12,6.05,530,25.38,0.5,0.53
8,174,50,518,12,6.05,530,25.38,0.5,0.53
0,55,94,554,3,1.43,557,9.93,0.54,0.55
0,55,94,554,3,1.43,557,9.93,0.54,0.55
0,55,94,554,3,1.43,557,9.93,0.54,0.55
0,55,94,554,3,1.43,557,9.93,0.54,0.55
0,55,94,554,3,1.43,557,9.93,0.54,0.55
0,55,94,554,3,1.43,557,9.93,0.54,0.55
4,58,15,543,9,4.29,552,19.83,0.51,0.54
4,58,15,543,9,4.29,552,19.83,0.51,0.54
4,58,15,543,9,4.29,552,19.83,0.51,0.54
4,58,15,543,9,4.29,552,19.83,0.51,0.54
4,58,15,543,9,4.29,552,19.83,0.51,0.54
4,58,15,543,9,4.29,552,19.83,0.51,0.54
5,593,75,571,7,3.36,578,16.57,0.52,0.54
5,593,75,571,7,3.36,578,16.57,0.52,0.54
5,593,75,571,7,3.36,578,16.57,0.52,0.54
5,593,75,571,7,3.36,578,16.57,0.52,0.54
5,593,75,571,7,3.36,578,16.57,0.52,0.54
5,593,75,571,7,3.36,578,16.57,0.52,0.54
1,939,80,620,7,3.58,627,16.98,0.52,0.54
1,939,80,620,7,3.58,627,16.98,0.52,0.54
1,939,80,620,7,3.58,627,16.98,0.52,0.54
1,939,80,620,7,3.58,627,16.98,0.52,0.54
1,939,80,620,7,3.58,627,16.98,0.52,0.54
1,939,80,620,7,3.58,627,16.98,0.52,0.54
8,781,50,656,3,1.34,659,9.78,0.54,0.55
8,781,50,656,3,1.34,659,9.78,0.54,0.55
8,781,50,656,3,1.34,659,9.78,0.54,0.55
8,781,50,656,3,1.34,659,9.78,0.54,0.55
8,781,50,656,3,1.34,659,9.78,0.54,0.55
8,781,50,656,3,1.34,659,9.78,0.54,0.55
12,764,65,771,9,4.46,780,20.14,0.51,0.54
12,764,65,771,9,4.46,780,20.14,0.51,0.54
12,764,65,771,9,4.46,780,20.14,0.51,0.54
12,764,65,771,9,4.46,780,20.14,0.51,0.54
12,764,65,771,9,4.46,780,20.14,0.51,0.54
12,764,65,771,9,4.46,780,20.14,0.51,0.54
12,919,65,801,14,6.97,815,28.6,0.49,0.53
12,919,65,801,14,6.97,815,28.6,0.49,0.53
12,919,65,801,14,6.97,815,28.6,0.49,0.53
12,919,65,801,14,6.97,815,28.6,0.49,0.53
12,919,65,801,14,6.97,815,28.6,0.49,0.53
12,919,65,801,14,6.97,815,28.6,0.49,0.53
0,985,94,925,14,6.92,939,28.51,0.49,0.53
0,985,94,925,14,6.92,939,28.51,0.49,0.53
0,985,94,925,14,6.92,939,28.51,0.49,0.53
0,985,94,925,14,6.92,939,28.51,0.49,0.53
0,985,94,925,14,6.92,939,28.51,0.49,0.53
0,985,94,925,14,6.92,939,28.51,0.49,0.53
8,828,50,922,10,5.25,932,22.35,0.51,0.53
8,828,50,922,10,5.25,932,22.35,0.51,0.53
8,828,50,922,10,5.25,932,22.35,0.51,0.53
8,828,50,922,10,5.25,932,22.35,0.51,0.53
8,828,50,922,10,5.25,932,22.35,0.51,0.53
8,828,50,922,10,5.25,932,22.35,0.51,0.53
10,991,47,968,9,4.67,977,20.53,0.51,0.54
10,991,47,968,9,4.67,977,20.53,0.51,0.54
10,991,47,968,9,4.67,977,20.53,0.51,0.54
10,991,47,968,9,4.67,977,20.53,0.51,0.54
10,991,47,968,9,4.67,977,20.53,0.51,0.54
10,991,47,968,9,4.67,977,20.53,0.51,0.54
10,268,47,990,6,2.84,996,14.85,0.53,0.54
10,268,47,990,6,2.84,996,14.85,0.53,0.54
10,268,47,990,6,2.84,996,14.85,0.53,0.54
10,268,47,990,6,2.84,996,14.85,0.53,0.54
10,268,47,990,6,2.84,996,14.85,0.53,0.54
10,268,47,990,6,2.84,996,14.85,0.53,0.54
15,457,8,998,20,9.8,1018,38.43,0.47000000000000003,0.51
15,457,8,998,20,9.8,1018,38.43,0.47000000000000003,0.51
15,457,8,998,20,9.8,1018,38.43,0.47000000000000003,0.51
15,457,8,998,20,9.8,1018,38.43,0.47000000000000003,0.51
15,457,8,998,20,9.8,1018,38.43,0.47000000000000003,0.51
15,457,8,998,20,9.8,1018,38.43,0.47000000000000003,0.51
10,458,47,1025,11,5.37,1036,23.36,0.5,0.53
10,458,47,1025,11,5.37,1036,23.36,0.5,0.53
10,458,47,1025,11,5.37,1036,23.36,0.5,0.53
10,458,47,1025,11,5.37,1036,23.36,0.5,0.53
10,458,47,1025,11,5.37,1036,23.36,0.5,0.53
10,458,47,1025,11,5.37,1036,23.36,0.5,0.53
5,422,75,1078,7,3.46,1085,16.76,0.52,0.54
5,422,75,1078,7,3.46,1085,16.76,0.52,0.54
5,422,75,1078,7,3.46,1085,16.76,0.52,0.54
5,422,75,1078,7,3.46,1085,16.76,0.52,0.54
5,422,75,1078,7,3.46,1085,16.76,0.52,0.54
5,422,75,1078,7,3.46,1085,16.76,0.52,0.54
8,308,50,1072,11,5.57,1083,23.71,0.5,0.53
8,308,50,1072,11,5.57,1083,23.71,0.5,0.53
8,308,50,1072,11,5.57,1083,23.71,0.5,0.53
8,308,50,1072,11,5.57,1083,23.71,0.5,0.53
8,308,50,1072,11,5.57,1083,23.71,0.5,0.53
8,308,50,1072,11,5.57,1083,23.71,0.5,0.53
5,311,75,1091,4,2.18,1095,12.09,0.53,0.55
5,311,75,1091,4,2.18,1095,12.09,0.53,0.55
5,311,75,1091,4,2.18,1095,12.09,0.53,0.55
5,311,75,1091,4,2.18,1095,12.09,0.53,0.55
5,311,75,1091,4,2.18,1095,12.09,0.53,0.55
5,311,75,1091,4,2.18,1095,12.09,0.53,0.55
8,841,50,1096,7,3.57,1103,16.96,0.52,0.54
8,841,50,1096,7,3.57,1103,16.96,0.52,0.54
8,841,50,1096,7,3.57,1103,16.96,0.52,0.54
8,841,50,1096,7,3.57,1103,16.96,0.52,0.54
8,841,50,1096,7,3.57,1103,16.96,0.52,0.54
8,841,50,1096,7,3.57,1103,16.96,0.52,0.54
8,343,50,1115,15,7.54,1130,30.43,0.49,0.52
8,343,50,1115,15,7.54,1130,30.43,0.49,0.52
8,343,50,1115,15,7.54,1130,30.43,0.49,0.52
8,343,50,1115,15,7.54,1130,30.43,0.49,0.52
8,343,50,1115,15,7.54,1130,30.43,0.49,0.52
8,343,50,1115,15,7.54,1130,30.43,0.49,0.52
5,423,75,1169,11,5.75,1180,24.04,0.5,0.53
5,423,75,1169,11,5.75,1180,24.04,0.5,0.53
5,423,75,1169,11,5.75,1180,24.04,0.5,0.53
5,423,75,1169,11,5.75,1180,24.04,0.5,0.53
5,423,75,1169,11,5.75,1180,24.04,0.5,0.53
5,423,75,1169,11,5.75,1180,24.04,0.5,0.53
10,340,47,1189,6,3.06,1195,15.24,0.52,0.54
10,340,47,1189,6,3.06,1195,15.24,0.52,0.54
10,340,47,1189,6,3.06,1195,15.24,0.52,0.54
10,340,47,1189,6,3.06,1195,15.24,0.52,0.54
10,340,47,1189,6,3.06,1195,15.24,0.52,0.54
10,340,47,1189,6,3.06,1195,15.24,0.52,0.54
11,707,97,1200,7,3.56,1207,16.95,0.52,0.54
11,707,97,1200,7,3.56,1207,16.95,0.52,0.54
11,707,97,1200,7,3.56,1207,16.95,0.52,0.54
11,707,97,1200,7,3.56,1207,16.95,0.52,0.54
11,707,97,1200,7,3.56,1207,16.95,0.52,0.54
11,707,97,1200,7,3.56,1207,16.95,0.52,0.54
8,732,50,1254,10,4.97,1264,21.84,0.51,0.54
8,732,50,1254,10,4.97,1264,21.84,0.51,0.54
8,732,50,1254,10,4.97,1264,21.84,0.51,0.54
8,732,50,1254,10,4.97,1264,21.84,0.51,0.54
8,732,50,1254,10,4.97,1264,21.84,0.51,0.54
8,732,50,1254,10,4.97,1264,21.84,0.51,0.54
11,567,97,1240,12,5.9,1252,25.1,0.5,0.53
11,567,97,1240,12,5.9,1252,25.1,0.5,0.53
11,567,97,1240,12,5.9,1252,25.1,0.5,0.53
11,567,97,1240,12,5.9,1252,25.1,0.5,0.53
11,567,97,1240,12,5.9,1252,25.1,0.5,0.53
11,567,97,1240,12,5.9,1252,25.1,0.5,0.53
1,617,64,1306,3,1.51,1309,10.08,0.54,0.55
1,617,64,1306,3,1.51,1309,10.08,0.54,0.55
1,617,64,1306,3,1.51,1309,10.08,0.54,0.55
1,617,64,1306,3,1.51,1309,10.08,0.54,0.55
1,617,64,1306,3,1.51,1309,10.08,0.54,0.55
1,617,64,1306,3,1.51,1309,10.08,0.54,0.55
4,554,15,1332,12,5.89,1344,25.08,0.5,0.53
4,554,15,1332,12,5.89,1344,25.08,0.5,0.53
4,554,15,1332,12,5.89,1344,25.08,0.5,0.53
4,554,15,1332,12,5.89,1344,25.08,0.5,0.53
4,554,15,1332,12,5.89,1344,25.08,0.5,0.53
4,554,15,1332,12,5.89,1344,25.08,0.5,0.53
4,634,15,1409,7,3.44,1416,16.73,0.52,0.54
4,634,15,1409,7,3.44,1416,16.73,0.52,0.54
4,634,15,1409,7,3.44,1416,16.73,0.52,0.54
4,634,15,1409,7,3.44,1416,16.73,0.52,0.54
4,634,15,1409,7,3.44,1416,16.73,0.52,0.54
4,634,15,1409,7,3.44,1416,16.73,0.52,0.54
6,871,17,66,5,2.28,71,13.06,0.53,0.55
6,871,17,66,5,2.28,71,13.06,0.53,0.55
6,871,17,66,5,2.28,71,13.06,0.53,0.55
6,871,17,66,5,2.28,71,13.06,0.53,0.55
6,871,17,66,5,2.28,71,13.06,0.53,0.55
6,871,17,66,5,2.28,71,13.06,0.53,0.55
6,871,17,66,5,2.28,71,13.06,0.53,0.55
2,165,79,297,17,8.31,314,33.39,0.48,0.52
2,165,79,297,17,8.31,314,33.39,0.48,0.52
2,165,79,297,17,8.31,314,33.39,0.48,0.52
2,165,79,297,17,8.31,314,33.39,0.48,0.52
2,165,79,297,17,8.31,314,33.39,0.48,0.52
2,165,79,297,17,8.31,314,33.39,0.48,0.52
2,165,79,297,17,8.31,314,33.39,0.48,0.52
1,873,86,325,12,6.08,337,25.42,0.5,0.53
1,873,86,325,12,6.08,337,25.42,0.5,0.53
1,873,86,325,12,6.08,337,25.42,0.5,0.53
1,873,86,325,12,6.08,337,25.42,0.5,0.53
1,873,86,325,12,6.08,337,25.42,0.5,0.53
1,873,86,325,12,6.08,337,25.42,0.5,0.53
1,873,86,325,12,6.08,337,25.42,0.5,0.53
1,236,86,392,17,8.75,409,34.18,0.48,0.52
1,236,86,392,17,8.75,409,34.18,0.48,0.52
1,236,86,392,17,8.75,409,34.18,0.48,0.52
1,236,86,392,17,8.75,409,34.18,0.48,0.52
1,236,86,392,17,8.75,409,34.18,0.48,0.52
1,236,86,392,17,8.75,409,34.18,0.48,0.52
1,236,86,392,17,8.75,409,34.18,0.48,0.52
10,101,76,395,5,2.27,400,13.04,0.53,0.55
10,101,76,395,5,2.27,400,13.04,0.53,0.55
10,101,76,395,5,2.27,400,13.04,0.53,0.55
10,101,76,395,5,2.27,400,13.04,0.53,0.55
10,101,76,395,5,2.27,400,13.04,0.53,0.55
10,101,76,395,5,2.27,400,13.04,0.53,0.55
10,101,76,395,5,2.27,400,13.04,0.53,0.55
12,645,64,402,17,8.65,419,34.0,0.48,0.52
12,645,64,402,17,8.65,419,34.0,0.48,0.52
12,645,64,402,17,8.65,419,34.0,0.48,0.52
12,645,64,402,17,8.65,419,34.0,0.48,0.52
12,645,64,402,17,8.65,419,34.0,0.48,0.52
12,645,64,402,17,8.65,419,34.0,0.48,0.52
12,645,64,402,17,8.65,419,34.0,0.48,0.52
1,8,86,425,7,3.54,432,16.91,0.52,0.54
1,8,86,425,7,3.54,432,16.91,0.52,0.54
1,8,86,425,7,3.54,432,16.91,0.52,0.54
1,8,86,425,7,3.54,432,16.91,0.52,0.54
1,8,86,425,7,3.54,432,16.91,0.52,0.54
1,8,86,425,7,3.54,432,16.91,0.52,0.54
1,8,86,425,7,3.54,432,16.91,0.52,0.54
2,131,79,429,6,3.06,435,15.24,0.52,0.54
2,131,79,429,6,3.06,435,15.24,0.52,0.54
2,131,79,429,6,3.06,435,15.24,0.52,0.54
2,131,79,429,6,3.06,435,15.24,0.52,0.54
2,131,79,429,6,3.06,435,15.24,0.52,0.54
2,131,79,429,6,3.06,435,15.24,0.52,0.54
2,131,79,429,6,3.06,435,15.24,0.52,0.54
4,113,51,448,15,7.49,463,30.33,0.49,0.52
4,113,51,448,15,7.49,463,30.33,0.49,0.52
4,113,51,448,15,7.49,463,30.33,0.49,0.52
4,113,51,448,15,7.49,463,30.33,0.49,0.52
4,113,51,448,15,7.49,463,30.33,0.49,0.52
4,113,51,448,15,7.49,463,30.33,0.49,0.52
4,113,51,448,15,7.49,463,30.33,0.49,0.52
8,18,84,428,3,1.29,431,9.68,0.54,0.55
8,18,84,428,3,1.29,431,9.68,0.54,0.55
8,18,84,428,3,1.29,431,9.68,0.54,0.55
8,18,84,428,3,1.29,431,9.68,0.54,0.55
8,18,84,428,3,1.29,431,9.68,0.54,0.55
8,18,84,428,3,1.29,431,9.68,0.54,0.55
8,18,84,428,3,1.29,431,9.68,0.54,0.55
13,154,2,448,5,2.37,453,13.22,0.53,0.55
13,154,2,448,5,2.37,453,13.22,0.53,0.55
13,154,2,448,5,2.37,453,13.22,0.53,0.55
13,154,2,448,5,2.37,453,13.22,0.53,0.55
13,154,2,448,5,2.37,453,13.22,0.53,0.55
13,154,2,448,5,2.37,453,13.22,0.53,0.55
13,154,2,448,5,2.37,453,13.22,0.53,0.55
1,226,86,466,8,4.21,474,18.91,0.52,0.54
1,226,86,466,8,4.21,474,18.91,0.52,0.54
1,226,86,466,8,4.21,474,18.91,0.52,0.54
1,226,86,466,8,4.21,474,18.91,0.52,0.54
1,226,86,466,8,4.21,474,18.91,0.52,0.54
1,226,86,466,8,4.21,474,18.91,0.52,0.54
1,226,86,466,8,4.21,474,18.91,0.52,0.54
2,980,79,457,6,3.0,463,15.13,0.52,0.54
2,980,79,457,6,3.0,463,15.13,0.52,0.54
2,980,79,457,6,3.0,463,15.13,0.52,0.54
2,980,79,457,6,3.0,463,15.13,0.52,0.54
2,980,79,457,6,3.0,463,15.13,0.52,0.54
2,980,79,457,6,3.0,463,15.13,0.52,0.54
2,980,79,457,6,3.0,463,15.13,0.52,0.54
4,153,51,461,17,8.36,478,33.48,0.48,0.52
4,153,51,461,17,8.36,478,33.48,0.48,0.52
4,153,51,461,17,8.36,478,33.48,0.48,0.52
4,153,51,461,17,8.36,478,33.48,0.48,0.52
4,153,51,461,17,8.36,478,33.48,0.48,0.52
4,153,51,461,17,8.36,478,33.48,0.48,0.52
4,153,51,461,17,8.36,478,33.48,0.48,0.52
8,207,84,472,8,3.7600000000000002,480,18.08,0.52,0.54
8,207,84,472,8,3.7600000000000002,480,18.08,0.52,0.54
8,207,84,472,8,3.7600000000000002,480,18.08,0.52,0.54
8,207,84,472,8,3.7600000000000002,480,18.08,0.52,0.54
8,207,84,472,8,3.7600000000000002,480,18.08,0.52,0.54
8,207,84,472,8,3.7600000000000002,480,18.08,0.52,0.54
8,207,84,472,8,3.7600000000000002,480,18.08,0.52,0.54
11,920,44,456,4,1.99,460,11.75,0.53,0.55
11,920,44,456,4,1.99,460,11.75,0.53,0.55
11,920,44,456,4,1.99,460,11.75,0.53,0.55
11,920,44,456,4,1.99,460,11.75,0.53,0.55
11,920,44,456,4,1.99,460,11.75,0.53,0.55
11,920,44,456,4,1.99,460,11.75,0.53,0.55
11,920,44,456,4,1.99,460,11.75,0.53,0.55
8,58,84,480,12,5.99,492,25.26,0.5,0.53
8,58,84,480,12,5.99,492,25.26,0.5,0.53
8,58,84,480,12,5.99,492,25.26,0.5,0.53
8,58,84,480,12,5.99,492,25.26,0.5,0.53
8,58,84,480,12,5.99,492,25.26,0.5,0.53
8,58,84,480,12,5.99,492,25.26,0.5,0.53
8,58,84,480,12,5.99,492,25.26,0.5,0.53
11,898,44,499,4,2.2,503,12.13,0.53,0.55
11,898,44,499,4,2.2,503,12.13,0.53,0.55
11,898,44,499,4,2.2,503,12.13,0.53,0.55
11,898,44,499,4,2.2,503,12.13,0.53,0.55
11,898,44,499,4,2.2,503,12.13,0.53,0.55
11,898,44,499,4,2.2,503,12.13,0.53,0.55
11,898,44,499,4,2.2,503,12.13,0.53,0.55
13,187,2,486,8,4.22,494,18.92,0.52,0.54
13,187,2,486,8,4.22,494,18.92,0.52,0.54
13,187,2,486,8,4.22,494,18.92,0.52,0.54
13,187,2,486,8,4.22,494,18.92,0.52,0.54
13,187,2,486,8,4.22,494,18.92,0.52,0.54
13,187,2,486,8,4.22,494,18.92,0.52,0.54
13,187,2,486,8,4.22,494,18.92,0.52,0.54
14,14,56,503,2,0.88,505,8.15,0.54,0.55
14,14,56,503,2,0.88,505,8.15,0.54,0.55
14,14,56,503,2,0.88,505,8.15,0.54,0.55
14,14,56,503,2,0.88,505,8.15,0.54,0.55
14,14,56,503,2,0.88,505,8.15,0.54,0.55
14,14,56,503,2,0.88,505,8.15,0.54,0.55
14,14,56,503,2,0.88,505,8.15,0.54,0.55
1,237,86,519,9,4.45,528,20.13,0.51,0.54
1,237,86,519,9,4.45,528,20.13,0.51,0.54
1,237,86,519,9,4.45,528,20.13,0.51,0.54
1,237,86,519,9,4.45,528,20.13,0.51,0.54
1,237,86,519,9,4.45,528,20.13,0.51,0.54
1,237,86,519,9,4.45,528,20.13,0.51,0.54
1,237,86,519,9,4.45,528,20.13,0.51,0.54
2,173,79,539,5,2.29,544,13.07,0.53,0.55
2,173,79,539,5,2.29,544,13.07,0.53,0.55
2,173,79,539,5,2.29,544,13.07,0.53,0.55
2,173,79,539,5,2.29,544,13.07,0.53,0.55
2,173,79,539,5,2.29,544,13.07,0.53,0.55
2,173,79,539,5,2.29,544,13.07,0.53,0.55
2,173,79,539,5,2.29,544,13.07,0.53,0.55
5,94,58,511,9,4.3,520,19.84,0.51,0.54
5,94,58,511,9,4.3,520,19.84,0.51,0.54
5,94,58,511,9,4.3,520,19.84,0.51,0.54
5,94,58,511,9,4.3,520,19.84,0.51,0.54
5,94,58,511,9,4.3,520,19.84,0.51,0.54
5,94,58,511,9,4.3,520,19.84,0.51,0.54
5,94,58,511,9,4.3,520,19.84,0.51,0.54
11,168,44,514,18,9.21,532,35.8,0.47000000000000003,0.52
11,168,44,514,18,9.21,532,35.8,0.47000000000000003,0.52
11,168,44,514,18,9.21,532,35.8,0.47000000000000003,0.52
11,168,44,514,18,9.21,532,35.8,0.47000000000000003,0.52
11,168,44,514,18,9.21,532,35.8,0.47000000000000003,0.52
11,168,44,514,18,9.21,532,35.8,0.47000000000000003,0.52
11,168,44,514,18,9.21,532,35.8,0.47000000000000003,0.52
14,37,56,522,7,3.73,529,17.25,0.52,0.54
14,37,56,522,7,3.73,529,17.25,0.52,0.54
14,37,56,522,7,3.73,529,17.25,0.52,0.54
14,37,56,522,7,3.73,529,17.25,0.52,0.54
14,37,56,522,7,3.73,529,17.25,0.52,0.54
14,37,56,522,7,3.73,529,17.25,0.52,0.54
14,37,56,522,7,3.73,529,17.25,0.52,0.54
0,58,94,552,9,4.35,561,19.94,0.51,0.54
0,58,94,552,9,4.35,561,19.94,0.51,0.54
0,58,94,552,9,4.35,561,19.94,0.51,0.54
0,58,94,552,9,4.35,561,19.94,0.51,0.54
0,58,94,552,9,4.35,561,19.94,0.51,0.54
0,58,94,552,9,4.35,561,19.94,0.51,0.54
0,58,94,552,9,4.35,561,19.94,0.51,0.54
5,33,58,554,3,1.59,557,10.23,0.54,0.55
5,33,58,554,3,1.59,557,10.23,0.54,0.55
5,33,58,554,3,1.59,557,10.23,0.54,0.55
5,33,58,554,3,1.59,557,10.23,0.54,0.55
5,33,58,554,3,1.59,557,10.23,0.54,0.55
5,33,58,554,3,1.59,557,10.23,0.54,0.55
5,33,58,554,3,1.59,557,10.23,0.54,0.55
13,812,2,556,12,5.77,568,24.85,0.5,0.53
13,812,2,556,12,5.77,568,24.85,0.5,0.53
13,812,2,556,12,5.77,568,24.85,0.5,0.53
13,812,2,556,12,5.77,568,24.85,0.5,0.53
13,812,2,556,12,5.77,568,24.85,0.5,0.53
13,812,2,556,12,5.77,568,24.85,0.5,0.53
13,812,2,556,12,5.77,568,24.85,0.5,0.53
0,180,94,586,19,9.64,605,37.36,0.47000000000000003,0.52
0,180,94,586,19,9.64,605,37.36,0.47000000000000003,0.52
0,180,94,586,19,9.64,605,37.36,0.47000000000000003,0.52
0,180,94,586,19,9.64,605,37.36,0.47000000000000003,0.52
0,180,94,586,19,9.64,605,37.36,0.47000000000000003,0.52
0,180,94,586,19,9.64,605,37.36,0.47000000000000003,0.52
0,180,94,586,19,9.64,605,37.36,0.47000000000000003,0.52
2,58,79,593,4,2.19,597,12.11,0.53,0.55
2,58,79,593,4,2.19,597,12.11,0.53,0.55
2,58,79,593,4,2.19,597,12.11,0.53,0.55
2,58,79,593,4,2.19,597,12.11,0.53,0.55
2,58,79,593,4,2.19,597,12.11,0.53,0.55
2,58,79,593,4,2.19,597,12.11,0.53,0.55
2,58,79,593,4,2.19,597,12.11,0.53,0.55
11,958,44,649,12,6.07,661,25.4,0.5,0.53
11,958,44,649,12,6.07,661,25.4,0.5,0.53
11,958,44,649,12,6.07,661,25.4,0.5,0.53
11,958,44,649,12,6.07,661,25.4,0.5,0.53
11,958,44,649,12,6.07,661,25.4,0.5,0.53
11,958,44,649,12,6.07,661,25.4,0.5,0.53
11,958,44,649,12,6.07,661,25.4,0.5,0.53
9,919,38,664,8,4.01,672,18.53,0.52,0.54
9,919,38,664,8,4.01,672,18.53,0.52,0.54
9,919,38,664,8,4.01,672,18.53,0.52,0.54
9,919,38,664,8,4.01,672,18.53,0.52,0.54
9,919,38,664,8,4.01,672,18.53,0.52,0.54
9,919,38,664,8,4.01,672,18.53,0.52,0.54
9,919,38,664,8,4.01,672,18.53,0.52,0.54
12,778,8,774,8,3.79,782,18.15,0.52,0.54
12,778,8,774,8,3.79,782,18.15,0.52,0.54
12,778,8,774,8,3.79,782,18.15,0.52,0.54
12,778,8,774,8,3.79,782,18.15,0.52,0.54
12,778,8,774,8,3.79,782,18.15,0.52,0.54
12,778,8,774,8,3.79,782,18.15,0.52,0.54
12,778,8,774,8,3.79,782,18.15,0.52,0.54
12,990,8,809,3,1.49,812,10.06,0.54,0.55
12,990,8,809,3,1.49,812,10.06,0.54,0.55
12,990,8,809,3,1.49,812,10.06,0.54,0.55
12,990,8,809,3,1.49,812,10.06,0.54,0.55
12,990,8,809,3,1.49,812,10.06,0.54,0.55
12,990,8,809,3,1.49,812,10.06,0.54,0.55
12,990,8,809,3,1.49,812,10.06,0.54,0.55
1,938,27,1013,9,4.55,1022,20.31,0.51,0.54
1,938,27,1013,9,4.55,1022,20.31,0.51,0.54
1,938,27,1013,9,4.55,1022,20.31,0.51,0.54
1,938,27,1013,9,4.55,1022,20.31,0.51,0.54
1,938,27,1013,9,4.55,1022,20.31,0.51,0.54
1,938,27,1013,9,4.55,1022,20.31,0.51,0.54
1,938,27,1013,9,4.55,1022,20.31,0.51,0.54
3,824,15,992,14,7.12,1006,28.88,0.49,0.53
3,824,15,992,14,7.12,1006,28.88,0.49,0.53
3,824,15,992,14,7.12,1006,28.88,0.49,0.53
3,824,15,992,14,7.12,1006,28.88,0.49,0.53
3,824,15,992,14,7.12,1006,28.88,0.49,0.53
3,824,15,992,14,7.12,1006,28.88,0.49,0.53
3,824,15,992,14,7.12,1006,28.88,0.49,0.53
1,482,27,1028,6,3.1,1034,15.33,0.52,0.54
1,482,27,1028,6,3.1,1034,15.33,0.52,0.54
1,482,27,1028,6,3.1,1034,15.33,0.52,0.54
1,482,27,1028,6,3.1,1034,15.33,0.52,0.54
1,482,27,1028,6,3.1,1034,15.33,0.52,0.54
1,482,27,1028,6,3.1,1034,15.33,0.52,0.54
1,482,27,1028,6,3.1,1034,15.33,0.52,0.54
15,270,62,1033,17,8.67,1050,34.03,0.48,0.52
15,270,62,1033,17,8.67,1050,34.03,0.48,0.52
15,270,62,1033,17,8.67,1050,34.03,0.48,0.52
15,270,62,1033,17,8.67,1050,34.03,0.48,0.52
15,270,62,1033,17,8.67,1050,34.03,0.48,0.52
15,270,62,1033,17,8.67,1050,34.03,0.48,0.52
15,270,62,1033,17,8.67,1050,34.03,0.48,0.52
1,259,27,1103,9,4.55,1112,20.3,0.51,0.54
1,259,27,1103,9,4.55,1112,20.3,0.51,0.54
1,259,27,1103,9,4.55,1112,20.3,0.51,0.54
1,259,27,1103,9,4.55,1112,20.3,0.51,0.54
1,259,27,1103,9,4.55,1112,20.3,0.51,0.54
1,259,27,1103,9,4.55,1112,20.3,0.51,0.54
1,259,27,1103,9,4.55,1112,20.3,0.51,0.54
15,257,62,1102,16,8.15,1118,32.31,0.48,0.52
15,257,62,1102,16,8.15,1118,32.31,0.48,0.52
15,257,62,1102,16,8.15,1118,32.31,0.48,0.52
15,257,62,1102,16,8.15,1118,32.31,0.48,0.52
15,257,62,1102,16,8.15,1118,32.31,0.48,0.52
15,257,62,1102,16,8.15,1118,32.31,0.48,0.52
15,257,62,1102,16,8.15,1118,32.31,0.48,0.52
0,848,94,1133,9,4.7,1142,20.58,0.51,0.54
0,848,94,1133,9,4.7,1142,20.58,0.51,0.54
0,848,94,1133,9,4.7,1142,20.58,0.51,0.54
0,848,94,1133,9,4.7,1142,20.58,0.51,0.54
0,848,94,1133,9,4.7,1142,20.58,0.51,0.54
0,848,94,1133,9,4.7,1142,20.58,0.51,0.54
0,848,94,1133,9,4.7,1142,20.58,0.51,0.54
1,285,27,1121,8,4.19,1129,18.86,0.52,0.54
1,285,27,1121,8,4.19,1129,18.86,0.52,0.54
1,285,27,1121,8,4.19,1129,18.86,0.52,0.54
1,285,27,1121,8,4.19,1129,18.86,0.52,0.54
1,285,27,1121,8,4.19,1129,18.86,0.52,0.54
1,285,27,1121,8,4.19,1129,18.86,0.52,0.54
1,285,27,1121,8,4.19,1129,18.86,0.52,0.54
15,334,62,1134,21,10.45,1155,40.39,0.46,0.51
15,334,62,1134,21,10.45,1155,40.39,0.46,0.51
15,334,62,1134,21,10.45,1155,40.39,0.46,0.51
15,334,62,1134,21,10.45,1155,40.39,0.46,0.51
15,334,62,1134,21,10.45,1155,40.39,0.46,0.51
15,334,62,1134,21,10.45,1155,40.39,0.46,0.51
15,334,62,1134,21,10.45,1155,40.39,0.46,0.51
1,441,27,1143,12,6.02,1155,25.31,0.5,0.53
1,441,27,1143,12,6.02,1155,25.31,0.5,0.53
1,441,27,1143,12,6.02,1155,25.31,0.5,0.53
1,441,27,1143,12,6.02,1155,25.31,0.5,0.53
1,441,27,1143,12,6.02,1155,25.31,0.5,0.53
1,441,27,1143,12,6.02,1155,25.31,0.5,0.53
1,441,27,1143,12,6.02,1155,25.31,0.5,0.53
6,502,32,1236,4,2.24,1240,12.2,0.53,0.55
6,502,32,1236,4,2.24,1240,12.2,0.53,0.55
6,502,32,1236,4,2.24,1240,12.2,0.53,0.55
6,502,32,1236,4,2.24,1240,12.2,0.53,0.55
6,502,32,1236,4,2.24,1240,12.2,0.53,0.55
6,502,32,1236,4,2.24,1240,12.2,0.53,0.55
6,502,32,1236,4,2.24,1240,12.2,0.53,0.55
14,713,0,1360,11,5.51,1371,23.61,0.5,0.53
14,713,0,1360,11,5.51,1371,23.61,0.5,0.53
14,713,0,1360,11,5.51,1371,23.61,0.5,0.53
14,713,0,1360,11,5.51,1371,23.61,0.5,0.53
14,713,0,1360,11,5.51,1371,23.61,0.5,0.53
14,713,0,1360,11,5.51,1371,23.61,0.5,0.53
14,713,0,1360,11,5.51,1371,23.61,0.5,0.53
1,712,19,1399,7,3.61,1406,17.04,0.52,0.54
1,712,19,1399,7,3.61,1406,17.04,0.52,0.54
1,712,19,1399,7,3.61,1406,17.04,0.52,0.54
1,712,19,1399,7,3.61,1406,17.04,0.52,0.54
1,712,19,1399,7,3.61,1406,17.04,0.52,0.54
1,712,19,1399,7,3.61,1406,17.04,0.52,0.54
1,712,19,1399,7,3.61,1406,17.04,0.52,0.54
15,578,62,1385,9,4.68,1394,20.54,0.51,0.54
15,578,62,1385,9,4.68,1394,20.54,0.51,0.54
15,578,62,1385,9,4.68,1394,20.54,0.51,0.54
15,578,62,1385,9,4.68,1394,20.54,0.51,0.54
15,578,62,1385,9,4.68,1394,20.54,0.51,0.54
15,578,62,1385,9,4.68,1394,20.54,0.51,0.54
15,578,62,1385,9,4.68,1394,20.54,0.51,0.54
1,987,19,1417,17,8.74,1434,34.17,0.48,0.52
1,987,19,1417,17,8.74,1434,34.17,0.48,0.52
1,987,19,1417,17,8.74,1434,34.17,0.48,0.52
1,987,19,1417,17,8.74,1434,34.17,0.48,0.52
1,987,19,1417,17,8.74,1434,34.17,0.48,0.52
1,987,19,1417,17,8.74,1434,34.17,0.48,0.52
1,987,19,1417,17,8.74,1434,34.17,0.48,0.52
14,575,0,1419,3,1.51,1422,10.09,0.54,0.55
14,575,0,1419,3,1.51,1422,10.09,0.54,0.55
14,575,0,1419,3,1.51,1422,10.09,0.54,0.55
14,575,0,1419,3,1.51,1422,10.09,0.54,0.55
14,575,0,1419,3,1.51,1422,10.09,0.54,0.55
14,575,0,1419,3,1.51,1422,10.09,0.54,0.55
14,575,0,1419,3,1.51,1422,10.09,0.54,0.55
