square_index,rider_id,driver_idx,trip_start_timestamp,trip_duration,ride_miles,trip_end_timestamp,price_of_ride,rider_acceptance_prob,driver_acceptance_prob
14,991,52,72,8,4.21,80,18.91,0.52,0.54
9,940,25,215,3,1.55,218,10.16,0.54,0.55
14,823,52,312,3,1.46,315,10.0,0.54,0.55
14,936,52,337,10,4.85,347,21.64,0.51,0.54
11,1,36,367,16,7.82,383,31.72,0.48,0.52
11,228,36,399,5,2.32,404,13.12,0.53,0.55
14,106,52,403,15,7.28,418,29.95,0.49,0.53
2,162,31,423,19,9.29,442,36.72,0.47000000000000003,0.52
5,89,54,426,3,1.62,429,10.28,0.54,0.55
2,108,31,463,15,7.58,478,30.49,0.49,0.52
9,183,25,456,7,3.38,463,16.61,0.52,0.54
5,130,54,496,4,2.07,500,11.89,0.53,0.55
7,130,69,486,10,4.99,496,21.88,0.51,0.54
2,242,31,514,11,5.38,525,23.38,0.5,0.53
9,249,25,529,12,6.14,541,25.53,0.5,0.53
6,780,15,597,7,3.71,604,17.21,0.52,0.54
7,850,69,593,8,3.92,601,18.38,0.52,0.54
9,63,25,586,3,1.66,589,10.36,0.54,0.55
11,172,58,572,7,3.46,579,16.76,0.52,0.54
13,205,57,608,21,10.7,629,40.85,0.46,0.51
7,785,69,649,10,5.22,659,22.3,0.51,0.53
7,885,69,776,17,8.55,793,33.82,0.48,0.52
3,914,71,871,4,1.77,875,11.34,0.53,0.55
3,260,71,944,10,4.75,954,21.45,0.51,0.54
3,823,71,1003,18,8.75,1021,34.97,0.48,0.52
3,310,71,1046,15,7.52,1061,30.39,0.49,0.52
3,368,71,1069,15,7.42,1084,30.21,0.49,0.52
3,251,71,1086,10,4.86,1096,21.65,0.51,0.54
15,433,16,1104,18,8.99,1122,35.4,0.47000000000000003,0.52
3,787,71,1167,19,9.72,1186,37.5,0.47000000000000003,0.52
3,490,71,1188,13,6.33,1201,26.67,0.5,0.53
7,518,10,1300,16,8.04,1316,32.11,0.48,0.52
3,652,71,1343,7,3.5100000000000002,1350,16.84,0.52,0.54
3,747,71,1383,15,7.35,1398,30.08,0.49,0.52
2,887,44,219,18,9.04,237,35.49,0.47000000000000003,0.52
2,887,44,219,18,9.04,237,35.49,0.47000000000000003,0.52
0,111,82,402,19,9.65,421,37.39,0.47000000000000003,0.52
0,111,82,402,19,9.65,421,37.39,0.47000000000000003,0.52
1,199,54,428,16,8.01,444,32.05,0.48,0.52
1,199,54,428,16,8.01,444,32.05,0.48,0.52
2,162,44,444,6,3.07,450,15.27,0.52,0.54
2,162,44,444,6,3.07,450,15.27,0.52,0.54
7,133,1,447,1,0.32,448,6.36,0.55,0.55
7,133,1,447,1,0.32,448,6.36,0.55,0.55
9,148,0,434,4,1.81,438,11.41,0.53,0.55
9,148,0,434,4,1.81,438,11.41,0.53,0.55
2,219,44,475,11,5.32,486,23.26,0.5,0.53
2,219,44,475,11,5.32,486,23.26,0.5,0.53
3,180,33,453,21,10.32,474,40.17,0.46,0.51
3,180,33,453,21,10.32,474,40.17,0.46,0.51
6,881,34,479,7,3.34,486,16.54,0.52,0.54
6,881,34,479,7,3.34,486,16.54,0.52,0.54
9,212,0,463,4,1.75,467,11.31,0.53,0.55
9,212,0,463,4,1.75,467,11.31,0.53,0.55
13,121,18,453,9,4.41,462,20.05,0.51,0.54
13,121,18,453,9,4.41,462,20.05,0.51,0.54
2,8,44,502,2,0.91,504,8.22,0.54,0.55
2,8,44,502,2,0.91,504,8.22,0.54,0.55
3,774,33,487,12,6.12,499,25.5,0.5,0.53
3,774,33,487,12,6.12,499,25.5,0.5,0.53
5,138,36,486,10,5.16,496,22.19,0.51,0.53
5,138,36,486,10,5.16,496,22.19,0.51,0.53
9,30,0,495,13,6.69,508,27.32,0.49,0.53
9,30,0,495,13,6.69,508,27.32,0.49,0.53
2,69,44,521,13,6.49,534,26.96,0.5,0.53
2,69,44,521,13,6.49,534,26.96,0.5,0.53
3,96,33,523,11,5.33,534,23.28,0.5,0.53
3,96,33,523,11,5.33,534,23.28,0.5,0.53
6,118,34,552,4,2.12,556,11.99,0.53,0.55
6,118,34,552,4,2.12,556,11.99,0.53,0.55
9,203,0,543,7,3.65,550,17.11,0.52,0.54
9,203,0,543,7,3.65,550,17.11,0.52,0.54
5,940,36,598,6,3.14,604,15.4,0.52,0.54
5,940,36,598,6,3.14,604,15.4,0.52,0.54
6,12,34,594,14,7.19,608,29.01,0.49,0.53
6,12,34,594,14,7.19,608,29.01,0.49,0.53
6,80,34,607,8,3.86,615,18.27,0.52,0.54
6,80,34,607,8,3.86,615,18.27,0.52,0.54
9,58,0,619,7,3.4,626,16.65,0.52,0.54
9,58,0,619,7,3.4,626,16.65,0.52,0.54
6,961,34,778,8,3.88,786,18.3,0.52,0.54
6,961,34,778,8,3.88,786,18.3,0.52,0.54
6,940,34,783,5,2.69,788,13.8,0.53,0.55
6,940,34,783,5,2.69,788,13.8,0.53,0.55
6,927,34,838,12,6.11,850,25.48,0.5,0.53
6,927,34,838,12,6.11,850,25.48,0.5,0.53
4,836,43,841,19,9.41,860,36.94,0.47000000000000003,0.52
4,836,43,841,19,9.41,860,36.94,0.47000000000000003,0.52
4,803,43,892,12,5.9,904,25.11,0.5,0.53
4,803,43,892,12,5.9,904,25.11,0.5,0.53
10,274,76,964,7,3.39,971,16.63,0.52,0.54
10,274,76,964,7,3.39,971,16.63,0.52,0.54
12,387,71,1036,16,7.89,1052,31.83,0.48,0.52
12,387,71,1036,16,7.89,1052,31.83,0.48,0.52
13,288,93,1044,17,8.67,1061,34.04,0.48,0.52
13,288,93,1044,17,8.67,1061,34.04,0.48,0.52
1,328,89,1069,5,2.44,1074,13.34,0.53,0.55
1,328,89,1069,5,2.44,1074,13.34,0.53,0.55
6,492,34,1051,7,3.63,1058,17.07,0.52,0.54
6,492,34,1051,7,3.63,1058,17.07,0.52,0.54
13,438,93,1076,17,8.58,1093,33.88,0.48,0.52
13,438,93,1076,17,8.58,1093,33.88,0.48,0.52
15,329,51,1064,7,3.27,1071,16.41,0.52,0.54
15,329,51,1064,7,3.27,1071,16.41,0.52,0.54
6,461,34,1100,6,3.17,1106,15.45,0.52,0.54
6,461,34,1100,6,3.17,1106,15.45,0.52,0.54
13,311,93,1080,2,0.78,1082,7.98,0.54,0.55
13,311,93,1080,2,0.78,1082,7.98,0.54,0.55
15,289,51,1096,3,1.3,1099,9.71,0.54,0.55
15,289,51,1096,3,1.3,1099,9.71,0.54,0.55
1,425,89,1119,20,9.84,1139,38.5,0.47000000000000003,0.51
1,425,89,1119,20,9.84,1139,38.5,0.47000000000000003,0.51
6,913,34,1123,11,5.73,1134,24.01,0.5,0.53
6,913,34,1123,11,5.73,1134,24.01,0.5,0.53
11,292,45,1114,12,5.78,1126,24.88,0.5,0.53
11,292,45,1114,12,5.78,1126,24.88,0.5,0.53
13,379,93,1132,10,4.92,1142,21.75,0.51,0.54
13,379,93,1132,10,4.92,1142,21.75,0.51,0.54
15,260,51,1112,9,4.65,1121,20.48,0.51,0.54
15,260,51,1112,9,4.65,1121,20.48,0.51,0.54
15,444,51,1146,17,8.61,1163,33.92,0.48,0.52
15,444,51,1146,17,8.61,1163,33.92,0.48,0.52
6,641,34,1180,6,2.99,1186,15.13,0.52,0.54
6,641,34,1180,6,2.99,1186,15.13,0.52,0.54
15,645,51,1184,9,4.58,1193,20.36,0.51,0.54
15,645,51,1184,9,4.58,1193,20.36,0.51,0.54
1,583,89,1338,2,1.11,1340,8.57,0.54,0.55
1,583,89,1338,2,1.11,1340,8.57,0.54,0.55
7,939,45,158,1,0.7000000000000001,159,7.05,0.54,0.55
7,939,45,158,1,0.7000000000000001,159,7.05,0.54,0.55
7,939,45,158,1,0.7000000000000001,159,7.05,0.54,0.55
0,840,92,298,11,5.64,309,23.85,0.5,0.53
0,840,92,298,11,5.64,309,23.85,0.5,0.53
0,840,92,298,11,5.64,309,23.85,0.5,0.53
7,865,45,347,19,9.7,366,37.48,0.47000000000000003,0.52
7,865,45,347,19,9.7,366,37.48,0.47000000000000003,0.52
7,865,45,347,19,9.7,366,37.48,0.47000000000000003,0.52
15,848,84,349,13,6.57,362,27.09,0.49,0.53
15,848,84,349,13,6.57,362,27.09,0.49,0.53
15,848,84,349,13,6.57,362,27.09,0.49,0.53
6,833,79,387,8,4.21,395,18.9,0.52,0.54
6,833,79,387,8,4.21,395,18.9,0.52,0.54
6,833,79,387,8,4.21,395,18.9,0.52,0.54
8,214,69,386,6,2.91,392,14.98,0.53,0.54
8,214,69,386,6,2.91,392,14.98,0.53,0.54
8,214,69,386,6,2.91,392,14.98,0.53,0.54
15,179,84,395,13,6.3,408,26.61,0.5,0.53
15,179,84,395,13,6.3,408,26.61,0.5,0.53
15,179,84,395,13,6.3,408,26.61,0.5,0.53
0,823,92,447,11,5.63,458,23.83,0.5,0.53
0,823,92,447,11,5.63,458,23.83,0.5,0.53
0,823,92,447,11,5.63,458,23.83,0.5,0.53
2,14,6,442,8,4.21,450,18.89,0.52,0.54
2,14,6,442,8,4.21,450,18.89,0.52,0.54
2,14,6,442,8,4.21,450,18.89,0.52,0.54
4,226,60,446,4,1.85,450,11.48,0.53,0.55
4,226,60,446,4,1.85,450,11.48,0.53,0.55
4,226,60,446,4,1.85,450,11.48,0.53,0.55
15,16,84,441,3,1.62,444,10.29,0.54,0.55
15,16,84,441,3,1.62,444,10.29,0.54,0.55
15,16,84,441,3,1.62,444,10.29,0.54,0.55
2,8,6,458,13,6.68,471,27.29,0.49,0.53
2,8,6,458,13,6.68,471,27.29,0.49,0.53
2,8,6,458,13,6.68,471,27.29,0.49,0.53
3,153,90,468,9,4.75,477,20.66,0.51,0.54
3,153,90,468,9,4.75,477,20.66,0.51,0.54
3,153,90,468,9,4.75,477,20.66,0.51,0.54
4,138,60,469,14,6.8,483,28.29,0.49,0.53
4,138,60,469,14,6.8,483,28.29,0.49,0.53
4,138,60,469,14,6.8,483,28.29,0.49,0.53
9,179,30,469,5,2.45,474,13.36,0.53,0.55
9,179,30,469,5,2.45,474,13.36,0.53,0.55
9,179,30,469,5,2.45,474,13.36,0.53,0.55
12,145,91,463,11,5.71,474,23.98,0.5,0.53
12,145,91,463,11,5.71,474,23.98,0.5,0.53
12,145,91,463,11,5.71,474,23.98,0.5,0.53
15,206,84,475,5,2.48,480,13.42,0.53,0.55
15,206,84,475,5,2.48,480,13.42,0.53,0.55
15,206,84,475,5,2.48,480,13.42,0.53,0.55
1,8,59,500,4,2.12,504,11.98,0.53,0.55
1,8,59,500,4,2.12,504,11.98,0.53,0.55
1,8,59,500,4,2.12,504,11.98,0.53,0.55
2,53,6,501,8,3.87,509,18.29,0.52,0.54
2,53,6,501,8,3.87,509,18.29,0.52,0.54
2,53,6,501,8,3.87,509,18.29,0.52,0.54
14,193,33,493,15,7.37,508,30.11,0.49,0.52
14,193,33,493,15,7.37,508,30.11,0.49,0.52
14,193,33,493,15,7.37,508,30.11,0.49,0.52
0,247,92,514,17,8.45,531,33.64,0.48,0.52
0,247,92,514,17,8.45,531,33.64,0.48,0.52
0,247,92,514,17,8.45,531,33.64,0.48,0.52
1,935,59,538,9,4.52,547,20.25,0.51,0.54
1,935,59,538,9,4.52,547,20.25,0.51,0.54
1,935,59,538,9,4.52,547,20.25,0.51,0.54
2,58,6,517,16,7.8,533,31.67,0.48,0.52
2,58,6,517,16,7.8,533,31.67,0.48,0.52
2,58,6,517,16,7.8,533,31.67,0.48,0.52
3,167,90,529,1,0.32,530,6.37,0.55,0.55
3,167,90,529,1,0.32,530,6.37,0.55,0.55
3,167,90,529,1,0.32,530,6.37,0.55,0.55
4,141,60,523,6,2.82,529,14.82,0.53,0.54
4,141,60,523,6,2.82,529,14.82,0.53,0.54
4,141,60,523,6,2.82,529,14.82,0.53,0.54
11,141,5,523,11,5.51,534,23.62,0.5,0.53
11,141,5,523,11,5.51,534,23.62,0.5,0.53
11,141,5,523,11,5.51,534,23.62,0.5,0.53
15,142,84,536,19,9.38,555,36.89,0.47000000000000003,0.52
15,142,84,536,19,9.38,555,36.89,0.47000000000000003,0.52
15,142,84,536,19,9.38,555,36.89,0.47000000000000003,0.52
3,968,90,548,9,4.46,557,20.14,0.51,0.54
3,968,90,548,9,4.46,557,20.14,0.51,0.54
3,968,90,548,9,4.46,557,20.14,0.51,0.54
11,88,5,577,11,5.42,588,23.44,0.5,0.53
11,88,5,577,11,5.42,588,23.44,0.5,0.53
11,88,5,577,11,5.42,588,23.44,0.5,0.53
14,61,33,611,9,4.25,620,19.76,0.51,0.54
14,61,33,611,9,4.25,620,19.76,0.51,0.54
14,61,33,611,9,4.25,620,19.76,0.51,0.54
3,855,90,658,19,9.29,677,36.73,0.47000000000000003,0.52
3,855,90,658,19,9.29,677,36.73,0.47000000000000003,0.52
3,855,90,658,19,9.29,677,36.73,0.47000000000000003,0.52
3,861,90,748,8,4.08,756,18.67,0.52,0.54
3,861,90,748,8,4.08,756,18.67,0.52,0.54
3,861,90,748,8,4.08,756,18.67,0.52,0.54
4,972,60,885,13,6.42,898,26.83,0.5,0.53
4,972,60,885,13,6.42,898,26.83,0.5,0.53
4,972,60,885,13,6.42,898,26.83,0.5,0.53
12,297,91,1037,11,5.74,1048,24.02,0.5,0.53
12,297,91,1037,11,5.74,1048,24.02,0.5,0.53
12,297,91,1037,11,5.74,1048,24.02,0.5,0.53
12,269,91,1072,17,8.47,1089,33.68,0.48,0.52
12,269,91,1072,17,8.47,1089,33.68,0.48,0.52
12,269,91,1072,17,8.47,1089,33.68,0.48,0.52
12,283,91,1094,10,4.88,1104,21.69,0.51,0.54
12,283,91,1094,10,4.88,1104,21.69,0.51,0.54
12,283,91,1094,10,4.88,1104,21.69,0.51,0.54
12,785,91,1121,15,7.64,1136,30.6,0.49,0.52
12,785,91,1121,15,7.64,1136,30.6,0.49,0.52
12,785,91,1121,15,7.64,1136,30.6,0.49,0.52
3,382,13,1149,13,6.45,1162,26.88,0.5,0.53
3,382,13,1149,13,6.45,1162,26.88,0.5,0.53
3,382,13,1149,13,6.45,1162,26.88,0.5,0.53
12,583,91,1236,18,8.76,1254,34.99,0.48,0.52
12,583,91,1236,18,8.76,1254,34.99,0.48,0.52
12,583,91,1236,18,8.76,1254,34.99,0.48,0.52
12,640,91,1291,13,6.64,1304,27.23,0.49,0.53
12,640,91,1291,13,6.64,1304,27.23,0.49,0.53
12,640,91,1291,13,6.64,1304,27.23,0.49,0.53
1,682,51,1344,14,7.04,1358,28.73,0.49,0.53
1,682,51,1344,14,7.04,1358,28.73,0.49,0.53
1,682,51,1344,14,7.04,1358,28.73,0.49,0.53
1,647,51,1365,15,7.31,1380,30.01,0.49,0.52
1,647,51,1365,15,7.31,1380,30.01,0.49,0.52
1,647,51,1365,15,7.31,1380,30.01,0.49,0.52
1,745,51,1400,10,5.12,1410,22.12,0.51,0.53
1,745,51,1400,10,5.12,1410,22.12,0.51,0.53
1,745,51,1400,10,5.12,1410,22.12,0.51,0.53
3,708,98,1425,4,2.22,1429,12.16,0.53,0.55
3,708,98,1425,4,2.22,1429,12.16,0.53,0.55
3,708,98,1425,4,2.22,1429,12.16,0.53,0.55
1,781,38,71,9,4.51,80,20.23,0.51,0.54
1,781,38,71,9,4.51,80,20.23,0.51,0.54
1,781,38,71,9,4.51,80,20.23,0.51,0.54
1,781,38,71,9,4.51,80,20.23,0.51,0.54
11,752,26,202,15,7.26,217,29.92,0.49,0.53
11,752,26,202,15,7.26,217,29.92,0.49,0.53
11,752,26,202,15,7.26,217,29.92,0.49,0.53
11,752,26,202,15,7.26,217,29.92,0.49,0.53
10,805,43,267,13,6.44,280,26.87,0.5,0.53
10,805,43,267,13,6.44,280,26.87,0.5,0.53
10,805,43,267,13,6.44,280,26.87,0.5,0.53
10,805,43,267,13,6.44,280,26.87,0.5,0.53
1,954,38,281,6,3.01,287,15.16,0.52,0.54
1,954,38,281,6,3.01,287,15.16,0.52,0.54
1,954,38,281,6,3.01,287,15.16,0.52,0.54
1,954,38,281,6,3.01,287,15.16,0.52,0.54
1,817,38,313,4,2.03,317,11.82,0.53,0.55
1,817,38,313,4,2.03,317,11.82,0.53,0.55
1,817,38,313,4,2.03,317,11.82,0.53,0.55
1,817,38,313,4,2.03,317,11.82,0.53,0.55
8,184,61,504,13,6.45,517,26.88,0.5,0.53
8,184,61,504,13,6.45,517,26.88,0.5,0.53
8,184,61,504,13,6.45,517,26.88,0.5,0.53
8,184,61,504,13,6.45,517,26.88,0.5,0.53
11,48,91,492,17,8.45,509,33.64,0.48,0.52
11,48,91,492,17,8.45,509,33.64,0.48,0.52
11,48,91,492,17,8.45,509,33.64,0.48,0.52
11,48,91,492,17,8.45,509,33.64,0.48,0.52
11,171,91,531,11,5.73,542,24.01,0.5,0.53
11,171,91,531,11,5.73,542,24.01,0.5,0.53
11,171,91,531,11,5.73,542,24.01,0.5,0.53
11,171,91,531,11,5.73,542,24.01,0.5,0.53
0,50,75,550,9,4.65,559,20.49,0.51,0.54
0,50,75,550,9,4.65,559,20.49,0.51,0.54
0,50,75,550,9,4.65,559,20.49,0.51,0.54
0,50,75,550,9,4.65,559,20.49,0.51,0.54
4,236,48,550,1,0.33,551,6.37,0.55,0.55
4,236,48,550,1,0.33,551,6.37,0.55,0.55
4,236,48,550,1,0.33,551,6.37,0.55,0.55
4,236,48,550,1,0.33,551,6.37,0.55,0.55
8,120,61,564,2,1.03,566,8.43,0.54,0.55
8,120,61,564,2,1.03,566,8.43,0.54,0.55
8,120,61,564,2,1.03,566,8.43,0.54,0.55
8,120,61,564,2,1.03,566,8.43,0.54,0.55
11,246,91,568,8,4.24,576,18.95,0.52,0.54
11,246,91,568,8,4.24,576,18.95,0.52,0.54
11,246,91,568,8,4.24,576,18.95,0.52,0.54
11,246,91,568,8,4.24,576,18.95,0.52,0.54
8,910,61,588,18,9.21,606,35.81,0.47000000000000003,0.52
8,910,61,588,18,9.21,606,35.81,0.47000000000000003,0.52
8,910,61,588,18,9.21,606,35.81,0.47000000000000003,0.52
8,910,61,588,18,9.21,606,35.81,0.47000000000000003,0.52
8,912,61,621,6,3.04,627,15.21,0.52,0.54
8,912,61,621,6,3.04,627,15.21,0.52,0.54
8,912,61,621,6,3.04,627,15.21,0.52,0.54
8,912,61,621,6,3.04,627,15.21,0.52,0.54
1,940,77,709,10,5.13,719,22.13,0.51,0.53
1,940,77,709,10,5.13,719,22.13,0.51,0.53
1,940,77,709,10,5.13,719,22.13,0.51,0.53
1,940,77,709,10,5.13,719,22.13,0.51,0.53
8,819,61,965,0,0.1,965,5.17,0.55,0.56
8,819,61,965,0,0.1,965,5.17,0.55,0.56
8,819,61,965,0,0.1,965,5.17,0.55,0.56
8,819,61,965,0,0.1,965,5.17,0.55,0.56
4,337,86,1005,10,4.91,1015,21.74,0.51,0.54
4,337,86,1005,10,4.91,1015,21.74,0.51,0.54
4,337,86,1005,10,4.91,1015,21.74,0.51,0.54
4,337,86,1005,10,4.91,1015,21.74,0.51,0.54
11,394,49,992,8,3.88,1000,18.3,0.52,0.54
11,394,49,992,8,3.88,1000,18.3,0.52,0.54
11,394,49,992,8,3.88,1000,18.3,0.52,0.54
11,394,49,992,8,3.88,1000,18.3,0.52,0.54
8,269,61,1041,14,6.9,1055,28.47,0.49,0.53
8,269,61,1041,14,6.9,1055,28.47,0.49,0.53
8,269,61,1041,14,6.9,1055,28.47,0.49,0.53
8,269,61,1041,14,6.9,1055,28.47,0.49,0.53
10,265,70,1035,13,6.63,1048,27.21,0.49,0.53
10,265,70,1035,13,6.63,1048,27.21,0.49,0.53
10,265,70,1035,13,6.63,1048,27.21,0.49,0.53
10,265,70,1035,13,6.63,1048,27.21,0.49,0.53
11,254,49,1032,14,6.82,1046,28.32,0.49,0.53
11,254,49,1032,14,6.82,1046,28.32,0.49,0.53
11,254,49,1032,14,6.82,1046,28.32,0.49,0.53
11,254,49,1032,14,6.82,1046,28.32,0.49,0.53
4,290,86,1057,10,4.82,1067,21.58,0.51,0.54
4,290,86,1057,10,4.82,1067,21.58,0.51,0.54
4,290,86,1057,10,4.82,1067,21.58,0.51,0.54
4,290,86,1057,10,4.82,1067,21.58,0.51,0.54
8,258,61,1059,11,5.75,1070,24.04,0.5,0.53
8,258,61,1059,11,5.75,1070,24.04,0.5,0.53
8,258,61,1059,11,5.75,1070,24.04,0.5,0.53
8,258,61,1059,11,5.75,1070,24.04,0.5,0.53
10,426,70,1078,8,4.08,1086,18.66,0.52,0.54
10,426,70,1078,8,4.08,1086,18.66,0.52,0.54
10,426,70,1078,8,4.08,1086,18.66,0.52,0.54
10,426,70,1078,8,4.08,1086,18.66,0.52,0.54
11,773,49,1068,7,3.52,1075,16.87,0.52,0.54
11,773,49,1068,7,3.52,1075,16.87,0.52,0.54
11,773,49,1068,7,3.52,1075,16.87,0.52,0.54
11,773,49,1068,7,3.52,1075,16.87,0.52,0.54
14,269,40,1055,14,7.1,1069,28.84,0.49,0.53
14,269,40,1055,14,7.1,1069,28.84,0.49,0.53
14,269,40,1055,14,7.1,1069,28.84,0.49,0.53
14,269,40,1055,14,7.1,1069,28.84,0.49,0.53
8,446,61,1088,6,3.13,1094,15.37,0.52,0.54
8,446,61,1088,6,3.13,1094,15.37,0.52,0.54
8,446,61,1088,6,3.13,1094,15.37,0.52,0.54
8,446,61,1088,6,3.13,1094,15.37,0.52,0.54
10,368,70,1082,5,2.3,1087,13.08,0.53,0.55
10,368,70,1082,5,2.3,1087,13.08,0.53,0.55
10,368,70,1082,5,2.3,1087,13.08,0.53,0.55
10,368,70,1082,5,2.3,1087,13.08,0.53,0.55
11,301,49,1105,8,3.83,1113,18.21,0.52,0.54
11,301,49,1105,8,3.83,1113,18.21,0.52,0.54
11,301,49,1105,8,3.83,1113,18.21,0.52,0.54
11,301,49,1105,8,3.83,1113,18.21,0.52,0.54
14,444,40,1089,17,8.64,1106,33.99,0.48,0.52
14,444,40,1089,17,8.64,1106,33.99,0.48,0.52
14,444,40,1089,17,8.64,1106,33.99,0.48,0.52
14,444,40,1089,17,8.64,1106,33.99,0.48,0.52
8,499,61,1112,10,4.98,1122,21.87,0.51,0.54
8,499,61,1112,10,4.98,1122,21.87,0.51,0.54
8,499,61,1112,10,4.98,1122,21.87,0.51,0.54
8,499,61,1112,10,4.98,1122,21.87,0.51,0.54
10,407,70,1122,5,2.34,1127,13.15,0.53,0.55
10,407,70,1122,5,2.34,1127,13.15,0.53,0.55
10,407,70,1122,5,2.34,1127,13.15,0.53,0.55
10,407,70,1122,5,2.34,1127,13.15,0.53,0.55
11,253,49,1110,1,0.54,1111,6.77,0.55,0.55
11,253,49,1110,1,0.54,1111,6.77,0.55,0.55
11,253,49,1110,1,0.54,1111,6.77,0.55,0.55
11,253,49,1110,1,0.54,1111,6.77,0.55,0.55
1,263,77,1161,14,6.92,1175,28.52,0.49,0.53
1,263,77,1161,14,6.92,1175,28.52,0.49,0.53
1,263,77,1161,14,6.92,1175,28.52,0.49,0.53
1,263,77,1161,14,6.92,1175,28.52,0.49,0.53
11,420,49,1165,10,5.03,1175,21.95,0.51,0.54
11,420,49,1165,10,5.03,1175,21.95,0.51,0.54
11,420,49,1165,10,5.03,1175,21.95,0.51,0.54
11,420,49,1165,10,5.03,1175,21.95,0.51,0.54
8,399,61,1178,9,4.39,1187,20.01,0.51,0.54
8,399,61,1178,9,4.39,1187,20.01,0.51,0.54
8,399,61,1178,9,4.39,1187,20.01,0.51,0.54
8,399,61,1178,9,4.39,1187,20.01,0.51,0.54
1,843,77,1208,13,6.31,1221,26.63,0.5,0.53
1,843,77,1208,13,6.31,1221,26.63,0.5,0.53
1,843,77,1208,13,6.31,1221,26.63,0.5,0.53
1,843,77,1208,13,6.31,1221,26.63,0.5,0.53
4,785,86,1239,4,1.98,1243,11.72,0.53,0.55
4,785,86,1239,4,1.98,1243,11.72,0.53,0.55
4,785,86,1239,4,1.98,1243,11.72,0.53,0.55
4,785,86,1239,4,1.98,1243,11.72,0.53,0.55
14,589,40,1253,13,6.75,1266,27.42,0.49,0.53
14,589,40,1253,13,6.75,1266,27.42,0.49,0.53
14,589,40,1253,13,6.75,1266,27.42,0.49,0.53
14,589,40,1253,13,6.75,1266,27.42,0.49,0.53
8,596,61,1260,8,3.81,1268,18.18,0.52,0.54
8,596,61,1260,8,3.81,1268,18.18,0.52,0.54
8,596,61,1260,8,3.81,1268,18.18,0.52,0.54
8,596,61,1260,8,3.81,1268,18.18,0.52,0.54
1,697,77,1293,10,4.81,1303,21.55,0.51,0.54
1,697,77,1293,10,4.81,1303,21.55,0.51,0.54
1,697,77,1293,10,4.81,1303,21.55,0.51,0.54
1,697,77,1293,10,4.81,1303,21.55,0.51,0.54
4,597,86,1303,10,4.94,1313,21.79,0.51,0.54
4,597,86,1303,10,4.94,1313,21.79,0.51,0.54
4,597,86,1303,10,4.94,1313,21.79,0.51,0.54
4,597,86,1303,10,4.94,1313,21.79,0.51,0.54
10,577,70,1293,14,6.76,1307,28.23,0.49,0.53
10,577,70,1293,14,6.76,1307,28.23,0.49,0.53
10,577,70,1293,14,6.76,1307,28.23,0.49,0.53
10,577,70,1293,14,6.76,1307,28.23,0.49,0.53
1,532,77,1327,3,1.66,1330,10.36,0.54,0.55
1,532,77,1327,3,1.66,1330,10.36,0.54,0.55
1,532,77,1327,3,1.66,1330,10.36,0.54,0.55
1,532,77,1327,3,1.66,1330,10.36,0.54,0.55
1,639,77,1369,11,5.51,1380,23.61,0.5,0.53
1,639,77,1369,11,5.51,1380,23.61,0.5,0.53
1,639,77,1369,11,5.51,1380,23.61,0.5,0.53
1,639,77,1369,11,5.51,1380,23.61,0.5,0.53
4,545,86,1364,3,1.34,1367,9.78,0.54,0.55
4,545,86,1364,3,1.34,1367,9.78,0.54,0.55
4,545,86,1364,3,1.34,1367,9.78,0.54,0.55
4,545,86,1364,3,1.34,1367,9.78,0.54,0.55
11,959,10,1378,16,8.24,1394,32.47,0.48,0.52
11,959,10,1378,16,8.24,1394,32.47,0.48,0.52
11,959,10,1378,16,8.24,1394,32.47,0.48,0.52
11,959,10,1378,16,8.24,1394,32.47,0.48,0.52
7,772,93,52,4,1.79,56,11.37,0.53,0.55
7,772,93,52,4,1.79,56,11.37,0.53,0.55
7,772,93,52,4,1.79,56,11.37,0.53,0.55
7,772,93,52,4,1.79,56,11.37,0.53,0.55
7,772,93,52,4,1.79,56,11.37,0.53,0.55
1,834,64,209,6,2.81,215,14.79,0.53,0.54
1,834,64,209,6,2.81,215,14.79,0.53,0.54
1,834,64,209,6,2.81,215,14.79,0.53,0.54
1,834,64,209,6,2.81,215,14.79,0.53,0.54
1,834,64,209,6,2.81,215,14.79,0.53,0.54
1,832,64,212,3,1.44,215,9.95,0.54,0.55
1,832,64,212,3,1.44,215,9.95,0.54,0.55
1,832,64,212,3,1.44,215,9.95,0.54,0.55
1,832,64,212,3,1.44,215,9.95,0.54,0.55
1,832,64,212,3,1.44,215,9.95,0.54,0.55
11,968,22,348,17,8.25,365,33.28,0.48,0.52
11,968,22,348,17,8.25,365,33.28,0.48,0.52
11,968,22,348,17,8.25,365,33.28,0.48,0.52
11,968,22,348,17,8.25,365,33.28,0.48,0.52
11,968,22,348,17,8.25,365,33.28,0.48,0.52
1,16,64,390,8,4.09,398,18.68,0.52,0.54
1,16,64,390,8,4.09,398,18.68,0.52,0.54
1,16,64,390,8,4.09,398,18.68,0.52,0.54
1,16,64,390,8,4.09,398,18.68,0.52,0.54
1,16,64,390,8,4.09,398,18.68,0.52,0.54
0,48,34,443,11,5.72,454,23.99,0.5,0.53
0,48,34,443,11,5.72,454,23.99,0.5,0.53
0,48,34,443,11,5.72,454,23.99,0.5,0.53
0,48,34,443,11,5.72,454,23.99,0.5,0.53
0,48,34,443,11,5.72,454,23.99,0.5,0.53
8,807,11,438,3,1.62,441,10.28,0.54,0.55
8,807,11,438,3,1.62,441,10.28,0.54,0.55
8,807,11,438,3,1.62,441,10.28,0.54,0.55
8,807,11,438,3,1.62,441,10.28,0.54,0.55
8,807,11,438,3,1.62,441,10.28,0.54,0.55
0,61,34,474,12,5.96,486,25.21,0.5,0.53
0,61,34,474,12,5.96,486,25.21,0.5,0.53
0,61,34,474,12,5.96,486,25.21,0.5,0.53
0,61,34,474,12,5.96,486,25.21,0.5,0.53
0,61,34,474,12,5.96,486,25.21,0.5,0.53
1,10,64,474,2,1.22,476,8.77,0.54,0.55
1,10,64,474,2,1.22,476,8.77,0.54,0.55
1,10,64,474,2,1.22,476,8.77,0.54,0.55
1,10,64,474,2,1.22,476,8.77,0.54,0.55
1,10,64,474,2,1.22,476,8.77,0.54,0.55
8,131,11,465,7,3.57,472,16.96,0.52,0.54
8,131,11,465,7,3.57,472,16.96,0.52,0.54
8,131,11,465,7,3.57,472,16.96,0.52,0.54
8,131,11,465,7,3.57,472,16.96,0.52,0.54
8,131,11,465,7,3.57,472,16.96,0.52,0.54
10,8,48,459,16,8.14,475,32.29,0.48,0.52
10,8,48,459,16,8.14,475,32.29,0.48,0.52
10,8,48,459,16,8.14,475,32.29,0.48,0.52
10,8,48,459,16,8.14,475,32.29,0.48,0.52
10,8,48,459,16,8.14,475,32.29,0.48,0.52
8,59,11,506,15,7.63,521,30.58,0.49,0.52
8,59,11,506,15,7.63,521,30.58,0.49,0.52
8,59,11,506,15,7.63,521,30.58,0.49,0.52
8,59,11,506,15,7.63,521,30.58,0.49,0.52
8,59,11,506,15,7.63,521,30.58,0.49,0.52
10,798,48,483,16,7.77,499,31.63,0.48,0.52
10,798,48,483,16,7.77,499,31.63,0.48,0.52
10,798,48,483,16,7.77,499,31.63,0.48,0.52
10,798,48,483,16,7.77,499,31.63,0.48,0.52
10,798,48,483,16,7.77,499,31.63,0.48,0.52
1,781,64,524,9,4.25,533,19.76,0.51,0.54
1,781,64,524,9,4.25,533,19.76,0.51,0.54
1,781,64,524,9,4.25,533,19.76,0.51,0.54
1,781,64,524,9,4.25,533,19.76,0.51,0.54
1,781,64,524,9,4.25,533,19.76,0.51,0.54
15,108,37,542,8,4.11,550,18.72,0.52,0.54
15,108,37,542,8,4.11,550,18.72,0.52,0.54
15,108,37,542,8,4.11,550,18.72,0.52,0.54
15,108,37,542,8,4.11,550,18.72,0.52,0.54
15,108,37,542,8,4.11,550,18.72,0.52,0.54
0,980,34,581,12,5.88,593,25.05,0.5,0.53
0,980,34,581,12,5.88,593,25.05,0.5,0.53
0,980,34,581,12,5.88,593,25.05,0.5,0.53
0,980,34,581,12,5.88,593,25.05,0.5,0.53
0,980,34,581,12,5.88,593,25.05,0.5,0.53
15,214,37,604,21,10.74,625,40.93,0.46,0.51
15,214,37,604,21,10.74,625,40.93,0.46,0.51
15,214,37,604,21,10.74,625,40.93,0.46,0.51
15,214,37,604,21,10.74,625,40.93,0.46,0.51
15,214,37,604,21,10.74,625,40.93,0.46,0.51
1,242,64,630,13,6.37,643,26.74,0.5,0.53
1,242,64,630,13,6.37,643,26.74,0.5,0.53
1,242,64,630,13,6.37,643,26.74,0.5,0.53
1,242,64,630,13,6.37,643,26.74,0.5,0.53
1,242,64,630,13,6.37,643,26.74,0.5,0.53
4,819,27,744,5,2.7,749,13.81,0.53,0.55
4,819,27,744,5,2.7,749,13.81,0.53,0.55
4,819,27,744,5,2.7,749,13.81,0.53,0.55
4,819,27,744,5,2.7,749,13.81,0.53,0.55
4,819,27,744,5,2.7,749,13.81,0.53,0.55
14,922,51,803,12,5.91,815,25.12,0.5,0.53
14,922,51,803,12,5.91,815,25.12,0.5,0.53
14,922,51,803,12,5.91,815,25.12,0.5,0.53
14,922,51,803,12,5.91,815,25.12,0.5,0.53
14,922,51,803,12,5.91,815,25.12,0.5,0.53
4,781,90,938,16,7.76,954,31.6,0.48,0.52
4,781,90,938,16,7.76,954,31.6,0.48,0.52
4,781,90,938,16,7.76,954,31.6,0.48,0.52
4,781,90,938,16,7.76,954,31.6,0.48,0.52
4,781,90,938,16,7.76,954,31.6,0.48,0.52
12,802,42,947,18,9.23,965,35.84,0.47000000000000003,0.52
12,802,42,947,18,9.23,965,35.84,0.47000000000000003,0.52
12,802,42,947,18,9.23,965,35.84,0.47000000000000003,0.52
12,802,42,947,18,9.23,965,35.84,0.47000000000000003,0.52
12,802,42,947,18,9.23,965,35.84,0.47000000000000003,0.52
4,290,90,965,18,9.23,983,35.85,0.47000000000000003,0.52
4,290,90,965,18,9.23,983,35.85,0.47000000000000003,0.52
4,290,90,965,18,9.23,983,35.85,0.47000000000000003,0.52
4,290,90,965,18,9.23,983,35.85,0.47000000000000003,0.52
4,290,90,965,18,9.23,983,35.85,0.47000000000000003,0.52
10,306,77,971,7,3.42,978,16.68,0.52,0.54
10,306,77,971,7,3.42,978,16.68,0.52,0.54
10,306,77,971,7,3.42,978,16.68,0.52,0.54
10,306,77,971,7,3.42,978,16.68,0.52,0.54
10,306,77,971,7,3.42,978,16.68,0.52,0.54
11,465,22,966,2,0.9,968,8.19,0.54,0.55
11,465,22,966,2,0.9,968,8.19,0.54,0.55
11,465,22,966,2,0.9,968,8.19,0.54,0.55
11,465,22,966,2,0.9,968,8.19,0.54,0.55
11,465,22,966,2,0.9,968,8.19,0.54,0.55
4,339,90,998,18,8.91,1016,35.26,0.47000000000000003,0.52
4,339,90,998,18,8.91,1016,35.26,0.47000000000000003,0.52
4,339,90,998,18,8.91,1016,35.26,0.47000000000000003,0.52
4,339,90,998,18,8.91,1016,35.26,0.47000000000000003,0.52
4,339,90,998,18,8.91,1016,35.26,0.47000000000000003,0.52
10,299,77,997,5,2.75,1002,13.9,0.53,0.54
10,299,77,997,5,2.75,1002,13.9,0.53,0.54
10,299,77,997,5,2.75,1002,13.9,0.53,0.54
10,299,77,997,5,2.75,1002,13.9,0.53,0.54
10,299,77,997,5,2.75,1002,13.9,0.53,0.54
4,368,90,1034,9,4.67,1043,20.52,0.51,0.54
4,368,90,1034,9,4.67,1043,20.52,0.51,0.54
4,368,90,1034,9,4.67,1043,20.52,0.51,0.54
4,368,90,1034,9,4.67,1043,20.52,0.51,0.54
4,368,90,1034,9,4.67,1043,20.52,0.51,0.54
10,290,77,1023,5,2.33,1028,13.13,0.53,0.55
10,290,77,1023,5,2.33,1028,13.13,0.53,0.55
10,290,77,1023,5,2.33,1028,13.13,0.53,0.55
10,290,77,1023,5,2.33,1028,13.13,0.53,0.55
10,290,77,1023,5,2.33,1028,13.13,0.53,0.55
10,430,77,1073,1,0.47000000000000003,1074,6.63,0.55,0.55
10,430,77,1073,1,0.47000000000000003,1074,6.63,0.55,0.55
10,430,77,1073,1,0.47000000000000003,1074,6.63,0.55,0.55
10,430,77,1073,1,0.47000000000000003,1074,6.63,0.55,0.55
10,430,77,1073,1,0.47000000000000003,1074,6.63,0.55,0.55
14,253,63,1109,17,8.62,1126,33.95,0.48,0.52
14,253,63,1109,17,8.62,1126,33.95,0.48,0.52
14,253,63,1109,17,8.62,1126,33.95,0.48,0.52
14,253,63,1109,17,8.62,1126,33.95,0.48,0.52
14,253,63,1109,17,8.62,1126,33.95,0.48,0.52
14,427,63,1116,13,6.6,1129,27.15,0.49,0.53
14,427,63,1116,13,6.6,1129,27.15,0.49,0.53
14,427,63,1116,13,6.6,1129,27.15,0.49,0.53
14,427,63,1116,13,6.6,1129,27.15,0.49,0.53
14,427,63,1116,13,6.6,1129,27.15,0.49,0.53
11,695,22,1261,10,5.2,1271,22.27,0.51,0.53
11,695,22,1261,10,5.2,1271,22.27,0.51,0.53
11,695,22,1261,10,5.2,1271,22.27,0.51,0.53
11,695,22,1261,10,5.2,1271,22.27,0.51,0.53
11,695,22,1261,10,5.2,1271,22.27,0.51,0.53
11,683,22,1310,10,4.75,1320,21.45,0.51,0.54
11,683,22,1310,10,4.75,1320,21.45,0.51,0.54
11,683,22,1310,10,4.75,1320,21.45,0.51,0.54
11,683,22,1310,10,4.75,1320,21.45,0.51,0.54
11,683,22,1310,10,4.75,1320,21.45,0.51,0.54
1,587,97,1328,5,2.64,1333,13.7,0.53,0.55
1,587,97,1328,5,2.64,1333,13.7,0.53,0.55
1,587,97,1328,5,2.64,1333,13.7,0.53,0.55
1,587,97,1328,5,2.64,1333,13.7,0.53,0.55
1,587,97,1328,5,2.64,1333,13.7,0.53,0.55
1,597,97,1351,15,7.53,1366,30.41,0.49,0.52
1,597,97,1351,15,7.53,1366,30.41,0.49,0.52
1,597,97,1351,15,7.53,1366,30.41,0.49,0.52
1,597,97,1351,15,7.53,1366,30.41,0.49,0.52
1,597,97,1351,15,7.53,1366,30.41,0.49,0.52
1,583,97,1384,7,3.38,1391,16.62,0.52,0.54
1,583,97,1384,7,3.38,1391,16.62,0.52,0.54
1,583,97,1384,7,3.38,1391,16.62,0.52,0.54
1,583,97,1384,7,3.38,1391,16.62,0.52,0.54
1,583,97,1384,7,3.38,1391,16.62,0.52,0.54
3,509,44,1388,21,10.72,1409,40.89,0.46,0.51
3,509,44,1388,21,10.72,1409,40.89,0.46,0.51
3,509,44,1388,21,10.72,1409,40.89,0.46,0.51
3,509,44,1388,21,10.72,1409,40.89,0.46,0.51
3,509,44,1388,21,10.72,1409,40.89,0.46,0.51
1,792,97,1418,11,5.46,1429,23.52,0.5,0.53
1,792,97,1418,11,5.46,1429,23.52,0.5,0.53
1,792,97,1418,11,5.46,1429,23.52,0.5,0.53
1,792,97,1418,11,5.46,1429,23.52,0.5,0.53
1,792,97,1418,11,5.46,1429,23.52,0.5,0.53
0,876,89,26,16,7.96,42,31.96,0.48,0.52
0,876,89,26,16,7.96,42,31.96,0.48,0.52
0,876,89,26,16,7.96,42,31.96,0.48,0.52
0,876,89,26,16,7.96,42,31.96,0.48,0.52
0,876,89,26,16,7.96,42,31.96,0.48,0.52
0,876,89,26,16,7.96,42,31.96,0.48,0.52
2,894,99,15,7,3.36,22,16.57,0.52,0.54
2,894,99,15,7,3.36,22,16.57,0.52,0.54
2,894,99,15,7,3.36,22,16.57,0.52,0.54
2,894,99,15,7,3.36,22,16.57,0.52,0.54
2,894,99,15,7,3.36,22,16.57,0.52,0.54
2,894,99,15,7,3.36,22,16.57,0.52,0.54
15,860,95,122,8,4.12,130,18.74,0.52,0.54
15,860,95,122,8,4.12,130,18.74,0.52,0.54
15,860,95,122,8,4.12,130,18.74,0.52,0.54
15,860,95,122,8,4.12,130,18.74,0.52,0.54
15,860,95,122,8,4.12,130,18.74,0.52,0.54
15,860,95,122,8,4.12,130,18.74,0.52,0.54
0,762,89,261,17,8.52,278,33.78,0.48,0.52
0,762,89,261,17,8.52,278,33.78,0.48,0.52
0,762,89,261,17,8.52,278,33.78,0.48,0.52
0,762,89,261,17,8.52,278,33.78,0.48,0.52
0,762,89,261,17,8.52,278,33.78,0.48,0.52
0,762,89,261,17,8.52,278,33.78,0.48,0.52
7,752,78,274,8,4.08,282,18.66,0.52,0.54
7,752,78,274,8,4.08,282,18.66,0.52,0.54
7,752,78,274,8,4.08,282,18.66,0.52,0.54
7,752,78,274,8,4.08,282,18.66,0.52,0.54
7,752,78,274,8,4.08,282,18.66,0.52,0.54
7,752,78,274,8,4.08,282,18.66,0.52,0.54
7,138,78,342,16,7.8,358,31.68,0.48,0.52
7,138,78,342,16,7.8,358,31.68,0.48,0.52
7,138,78,342,16,7.8,358,31.68,0.48,0.52
7,138,78,342,16,7.8,358,31.68,0.48,0.52
7,138,78,342,16,7.8,358,31.68,0.48,0.52
7,138,78,342,16,7.8,358,31.68,0.48,0.52
9,818,72,337,14,6.83,351,28.34,0.49,0.53
9,818,72,337,14,6.83,351,28.34,0.49,0.53
9,818,72,337,14,6.83,351,28.34,0.49,0.53
9,818,72,337,14,6.83,351,28.34,0.49,0.53
9,818,72,337,14,6.83,351,28.34,0.49,0.53
9,818,72,337,14,6.83,351,28.34,0.49,0.53
15,824,95,346,11,5.44,357,23.49,0.5,0.53
15,824,95,346,11,5.44,357,23.49,0.5,0.53
15,824,95,346,11,5.44,357,23.49,0.5,0.53
15,824,95,346,11,5.44,357,23.49,0.5,0.53
15,824,95,346,11,5.44,357,23.49,0.5,0.53
15,824,95,346,11,5.44,357,23.49,0.5,0.53
9,46,72,380,11,5.68,391,23.91,0.5,0.53
9,46,72,380,11,5.68,391,23.91,0.5,0.53
9,46,72,380,11,5.68,391,23.91,0.5,0.53
9,46,72,380,11,5.68,391,23.91,0.5,0.53
9,46,72,380,11,5.68,391,23.91,0.5,0.53
9,46,72,380,11,5.68,391,23.91,0.5,0.53
15,820,95,367,14,6.98,381,28.62,0.49,0.53
15,820,95,367,14,6.98,381,28.62,0.49,0.53
15,820,95,367,14,6.98,381,28.62,0.49,0.53
15,820,95,367,14,6.98,381,28.62,0.49,0.53
15,820,95,367,14,6.98,381,28.62,0.49,0.53
15,820,95,367,14,6.98,381,28.62,0.49,0.53
15,215,95,404,18,9.13,422,35.65,0.47000000000000003,0.52
15,215,95,404,18,9.13,422,35.65,0.47000000000000003,0.52
15,215,95,404,18,9.13,422,35.65,0.47000000000000003,0.52
15,215,95,404,18,9.13,422,35.65,0.47000000000000003,0.52
15,215,95,404,18,9.13,422,35.65,0.47000000000000003,0.52
15,215,95,404,18,9.13,422,35.65,0.47000000000000003,0.52
0,44,89,437,15,7.64,452,30.61,0.49,0.52
0,44,89,437,15,7.64,452,30.61,0.49,0.52
0,44,89,437,15,7.64,452,30.61,0.49,0.52
0,44,89,437,15,7.64,452,30.61,0.49,0.52
0,44,89,437,15,7.64,452,30.61,0.49,0.52
0,44,89,437,15,7.64,452,30.61,0.49,0.52
7,72,78,423,5,2.37,428,13.21,0.53,0.55
7,72,78,423,5,2.37,428,13.21,0.53,0.55
7,72,78,423,5,2.37,428,13.21,0.53,0.55
7,72,78,423,5,2.37,428,13.21,0.53,0.55
7,72,78,423,5,2.37,428,13.21,0.53,0.55
7,72,78,423,5,2.37,428,13.21,0.53,0.55
8,65,42,440,4,1.81,444,11.42,0.53,0.55
8,65,42,440,4,1.81,444,11.42,0.53,0.55
8,65,42,440,4,1.81,444,11.42,0.53,0.55
8,65,42,440,4,1.81,444,11.42,0.53,0.55
8,65,42,440,4,1.81,444,11.42,0.53,0.55
8,65,42,440,4,1.81,444,11.42,0.53,0.55
9,151,72,435,7,3.43,442,16.7,0.52,0.54
9,151,72,435,7,3.43,442,16.7,0.52,0.54
9,151,72,435,7,3.43,442,16.7,0.52,0.54
9,151,72,435,7,3.43,442,16.7,0.52,0.54
9,151,72,435,7,3.43,442,16.7,0.52,0.54
9,151,72,435,7,3.43,442,16.7,0.52,0.54
0,28,89,452,7,3.58,459,16.98,0.52,0.54
0,28,89,452,7,3.58,459,16.98,0.52,0.54
0,28,89,452,7,3.58,459,16.98,0.52,0.54
0,28,89,452,7,3.58,459,16.98,0.52,0.54
0,28,89,452,7,3.58,459,16.98,0.52,0.54
0,28,89,452,7,3.58,459,16.98,0.52,0.54
4,84,90,479,11,5.5,490,23.59,0.5,0.53
4,84,90,479,11,5.5,490,23.59,0.5,0.53
4,84,90,479,11,5.5,490,23.59,0.5,0.53
4,84,90,479,11,5.5,490,23.59,0.5,0.53
4,84,90,479,11,5.5,490,23.59,0.5,0.53
4,84,90,479,11,5.5,490,23.59,0.5,0.53
7,203,78,476,17,8.74,493,34.17,0.48,0.52
7,203,78,476,17,8.74,493,34.17,0.48,0.52
7,203,78,476,17,8.74,493,34.17,0.48,0.52
7,203,78,476,17,8.74,493,34.17,0.48,0.52
7,203,78,476,17,8.74,493,34.17,0.48,0.52
7,203,78,476,17,8.74,493,34.17,0.48,0.52
8,12,42,451,16,8.24,467,32.48,0.48,0.52
8,12,42,451,16,8.24,467,32.48,0.48,0.52
8,12,42,451,16,8.24,467,32.48,0.48,0.52
8,12,42,451,16,8.24,467,32.48,0.48,0.52
8,12,42,451,16,8.24,467,32.48,0.48,0.52
8,12,42,451,16,8.24,467,32.48,0.48,0.52
9,63,72,450,8,4.12,458,18.73,0.52,0.54
9,63,72,450,8,4.12,458,18.73,0.52,0.54
9,63,72,450,8,4.12,458,18.73,0.52,0.54
9,63,72,450,8,4.12,458,18.73,0.52,0.54
9,63,72,450,8,4.12,458,18.73,0.52,0.54
9,63,72,450,8,4.12,458,18.73,0.52,0.54
0,56,89,507,18,8.9,525,35.23,0.47000000000000003,0.52
0,56,89,507,18,8.9,525,35.23,0.47000000000000003,0.52
0,56,89,507,18,8.9,525,35.23,0.47000000000000003,0.52
0,56,89,507,18,8.9,525,35.23,0.47000000000000003,0.52
0,56,89,507,18,8.9,525,35.23,0.47000000000000003,0.52
0,56,89,507,18,8.9,525,35.23,0.47000000000000003,0.52
4,93,90,500,7,3.39,507,16.62,0.52,0.54
4,93,90,500,7,3.39,507,16.62,0.52,0.54
4,93,90,500,7,3.39,507,16.62,0.52,0.54
4,93,90,500,7,3.39,507,16.62,0.52,0.54
4,93,90,500,7,3.39,507,16.62,0.52,0.54
4,93,90,500,7,3.39,507,16.62,0.52,0.54
7,78,78,499,14,7.19,513,29.01,0.49,0.53
7,78,78,499,14,7.19,513,29.01,0.49,0.53
7,78,78,499,14,7.19,513,29.01,0.49,0.53
7,78,78,499,14,7.19,513,29.01,0.49,0.53
7,78,78,499,14,7.19,513,29.01,0.49,0.53
7,78,78,499,14,7.19,513,29.01,0.49,0.53
0,210,89,514,14,7.06,528,28.77,0.49,0.53
0,210,89,514,14,7.06,528,28.77,0.49,0.53
0,210,89,514,14,7.06,528,28.77,0.49,0.53
0,210,89,514,14,7.06,528,28.77,0.49,0.53
0,210,89,514,14,7.06,528,28.77,0.49,0.53
0,210,89,514,14,7.06,528,28.77,0.49,0.53
1,45,46,523,15,7.68,538,30.67,0.49,0.52
1,45,46,523,15,7.68,538,30.67,0.49,0.52
1,45,46,523,15,7.68,538,30.67,0.49,0.52
1,45,46,523,15,7.68,538,30.67,0.49,0.52
1,45,46,523,15,7.68,538,30.67,0.49,0.52
1,45,46,523,15,7.68,538,30.67,0.49,0.52
1,242,46,544,17,8.38,561,33.51,0.48,0.52
1,242,46,544,17,8.38,561,33.51,0.48,0.52
1,242,46,544,17,8.38,561,33.51,0.48,0.52
1,242,46,544,17,8.38,561,33.51,0.48,0.52
1,242,46,544,17,8.38,561,33.51,0.48,0.52
1,242,46,544,17,8.38,561,33.51,0.48,0.52
4,189,90,547,6,3.23,553,15.56,0.52,0.54
4,189,90,547,6,3.23,553,15.56,0.52,0.54
4,189,90,547,6,3.23,553,15.56,0.52,0.54
4,189,90,547,6,3.23,553,15.56,0.52,0.54
4,189,90,547,6,3.23,553,15.56,0.52,0.54
4,189,90,547,6,3.23,553,15.56,0.52,0.54
14,93,40,560,19,9.27,579,36.69,0.47000000000000003,0.52
14,93,40,560,19,9.27,579,36.69,0.47000000000000003,0.52
14,93,40,560,19,9.27,579,36.69,0.47000000000000003,0.52
14,93,40,560,19,9.27,579,36.69,0.47000000000000003,0.52
14,93,40,560,19,9.27,579,36.69,0.47000000000000003,0.52
14,93,40,560,19,9.27,579,36.69,0.47000000000000003,0.52
1,809,46,594,3,1.43,597,9.95,0.54,0.55
1,809,46,594,3,1.43,597,9.95,0.54,0.55
1,809,46,594,3,1.43,597,9.95,0.54,0.55
1,809,46,594,3,1.43,597,9.95,0.54,0.55
1,809,46,594,3,1.43,597,9.95,0.54,0.55
1,809,46,594,3,1.43,597,9.95,0.54,0.55
12,992,22,625,4,2.18,629,12.09,0.53,0.55
12,992,22,625,4,2.18,629,12.09,0.53,0.55
12,992,22,625,4,2.18,629,12.09,0.53,0.55
12,992,22,625,4,2.18,629,12.09,0.53,0.55
12,992,22,625,4,2.18,629,12.09,0.53,0.55
12,992,22,625,4,2.18,629,12.09,0.53,0.55
11,790,73,684,12,6.13,696,25.51,0.5,0.53
11,790,73,684,12,6.13,696,25.51,0.5,0.53
11,790,73,684,12,6.13,696,25.51,0.5,0.53
11,790,73,684,12,6.13,696,25.51,0.5,0.53
11,790,73,684,12,6.13,696,25.51,0.5,0.53
11,790,73,684,12,6.13,696,25.51,0.5,0.53
2,898,38,837,7,3.75,844,17.28,0.52,0.54
2,898,38,837,7,3.75,844,17.28,0.52,0.54
2,898,38,837,7,3.75,844,17.28,0.52,0.54
2,898,38,837,7,3.75,844,17.28,0.52,0.54
2,898,38,837,7,3.75,844,17.28,0.52,0.54
2,898,38,837,7,3.75,844,17.28,0.52,0.54
15,446,15,1018,12,6.08,1030,25.42,0.5,0.53
15,446,15,1018,12,6.08,1030,25.42,0.5,0.53
15,446,15,1018,12,6.08,1030,25.42,0.5,0.53
15,446,15,1018,12,6.08,1030,25.42,0.5,0.53
15,446,15,1018,12,6.08,1030,25.42,0.5,0.53
15,446,15,1018,12,6.08,1030,25.42,0.5,0.53
7,265,74,1044,11,5.68,1055,23.91,0.5,0.53
7,265,74,1044,11,5.68,1055,23.91,0.5,0.53
7,265,74,1044,11,5.68,1055,23.91,0.5,0.53
7,265,74,1044,11,5.68,1055,23.91,0.5,0.53
7,265,74,1044,11,5.68,1055,23.91,0.5,0.53
7,265,74,1044,11,5.68,1055,23.91,0.5,0.53
8,411,26,1038,10,4.92,1048,21.76,0.51,0.54
8,411,26,1038,10,4.92,1048,21.76,0.51,0.54
8,411,26,1038,10,4.92,1048,21.76,0.51,0.54
8,411,26,1038,10,4.92,1048,21.76,0.51,0.54
8,411,26,1038,10,4.92,1048,21.76,0.51,0.54
8,411,26,1038,10,4.92,1048,21.76,0.51,0.54
10,406,85,1040,4,1.99,1044,11.75,0.53,0.55
10,406,85,1040,4,1.99,1044,11.75,0.53,0.55
10,406,85,1040,4,1.99,1044,11.75,0.53,0.55
10,406,85,1040,4,1.99,1044,11.75,0.53,0.55
10,406,85,1040,4,1.99,1044,11.75,0.53,0.55
10,406,85,1040,4,1.99,1044,11.75,0.53,0.55
7,482,74,1067,10,5.18,1077,22.23,0.51,0.53
7,482,74,1067,10,5.18,1077,22.23,0.51,0.53
7,482,74,1067,10,5.18,1077,22.23,0.51,0.53
7,482,74,1067,10,5.18,1077,22.23,0.51,0.53
7,482,74,1067,10,5.18,1077,22.23,0.51,0.53
7,482,74,1067,10,5.18,1077,22.23,0.51,0.53
7,421,74,1081,2,0.9500000000000001,1083,8.29,0.54,0.55
7,421,74,1081,2,0.9500000000000001,1083,8.29,0.54,0.55
7,421,74,1081,2,0.9500000000000001,1083,8.29,0.54,0.55
7,421,74,1081,2,0.9500000000000001,1083,8.29,0.54,0.55
7,421,74,1081,2,0.9500000000000001,1083,8.29,0.54,0.55
7,421,74,1081,2,0.9500000000000001,1083,8.29,0.54,0.55
8,338,26,1082,10,5.09,1092,22.06,0.51,0.53
8,338,26,1082,10,5.09,1092,22.06,0.51,0.53
8,338,26,1082,10,5.09,1092,22.06,0.51,0.53
8,338,26,1082,10,5.09,1092,22.06,0.51,0.53
8,338,26,1082,10,5.09,1092,22.06,0.51,0.53
8,338,26,1082,10,5.09,1092,22.06,0.51,0.53
11,253,73,1103,2,0.86,1105,8.13,0.54,0.55
11,253,73,1103,2,0.86,1105,8.13,0.54,0.55
11,253,73,1103,2,0.86,1105,8.13,0.54,0.55
11,253,73,1103,2,0.86,1105,8.13,0.54,0.55
11,253,73,1103,2,0.86,1105,8.13,0.54,0.55
11,253,73,1103,2,0.86,1105,8.13,0.54,0.55
8,449,26,1134,7,3.6,1141,17.01,0.52,0.54
8,449,26,1134,7,3.6,1141,17.01,0.52,0.54
8,449,26,1134,7,3.6,1141,17.01,0.52,0.54
8,449,26,1134,7,3.6,1141,17.01,0.52,0.54
8,449,26,1134,7,3.6,1141,17.01,0.52,0.54
8,449,26,1134,7,3.6,1141,17.01,0.52,0.54
11,351,73,1130,7,3.73,1137,17.26,0.52,0.54
11,351,73,1130,7,3.73,1137,17.26,0.52,0.54
11,351,73,1130,7,3.73,1137,17.26,0.52,0.54
11,351,73,1130,7,3.73,1137,17.26,0.52,0.54
11,351,73,1130,7,3.73,1137,17.26,0.52,0.54
11,351,73,1130,7,3.73,1137,17.26,0.52,0.54
11,283,73,1153,2,0.96,1155,8.31,0.54,0.55
11,283,73,1153,2,0.96,1155,8.31,0.54,0.55
11,283,73,1153,2,0.96,1155,8.31,0.54,0.55
11,283,73,1153,2,0.96,1155,8.31,0.54,0.55
11,283,73,1153,2,0.96,1155,8.31,0.54,0.55
11,283,73,1153,2,0.96,1155,8.31,0.54,0.55
1,435,30,1228,5,2.67,1233,13.76,0.53,0.55
1,435,30,1228,5,2.67,1233,13.76,0.53,0.55
1,435,30,1228,5,2.67,1233,13.76,0.53,0.55
1,435,30,1228,5,2.67,1233,13.76,0.53,0.55
1,435,30,1228,5,2.67,1233,13.76,0.53,0.55
1,435,30,1228,5,2.67,1233,13.76,0.53,0.55
6,505,52,1217,11,5.59,1228,23.75,0.5,0.53
6,505,52,1217,11,5.59,1228,23.75,0.5,0.53
6,505,52,1217,11,5.59,1228,23.75,0.5,0.53
6,505,52,1217,11,5.59,1228,23.75,0.5,0.53
6,505,52,1217,11,5.59,1228,23.75,0.5,0.53
6,505,52,1217,11,5.59,1228,23.75,0.5,0.53
8,715,26,1201,10,4.92,1211,21.75,0.51,0.54
8,715,26,1201,10,4.92,1211,21.75,0.51,0.54
8,715,26,1201,10,4.92,1211,21.75,0.51,0.54
8,715,26,1201,10,4.92,1211,21.75,0.51,0.54
8,715,26,1201,10,4.92,1211,21.75,0.51,0.54
8,715,26,1201,10,4.92,1211,21.75,0.51,0.54
11,959,73,1236,13,6.48,1249,26.94,0.5,0.53
11,959,73,1236,13,6.48,1249,26.94,0.5,0.53
11,959,73,1236,13,6.48,1249,26.94,0.5,0.53
11,959,73,1236,13,6.48,1249,26.94,0.5,0.53
11,959,73,1236,13,6.48,1249,26.94,0.5,0.53
11,959,73,1236,13,6.48,1249,26.94,0.5,0.53
6,541,52,1264,7,3.56,1271,16.94,0.52,0.54
6,541,52,1264,7,3.56,1271,16.94,0.52,0.54
6,541,52,1264,7,3.56,1271,16.94,0.52,0.54
6,541,52,1264,7,3.56,1271,16.94,0.52,0.54
6,541,52,1264,7,3.56,1271,16.94,0.52,0.54
6,541,52,1264,7,3.56,1271,16.94,0.52,0.54
11,551,73,1268,10,5.21,1278,22.28,0.51,0.53
11,551,73,1268,10,5.21,1278,22.28,0.51,0.53
11,551,73,1268,10,5.21,1278,22.28,0.51,0.53
11,551,73,1268,10,5.21,1278,22.28,0.51,0.53
11,551,73,1268,10,5.21,1278,22.28,0.51,0.53
11,551,73,1268,10,5.21,1278,22.28,0.51,0.53
1,785,30,1313,13,6.39,1326,26.77,0.5,0.53
1,785,30,1313,13,6.39,1326,26.77,0.5,0.53
1,785,30,1313,13,6.39,1326,26.77,0.5,0.53
1,785,30,1313,13,6.39,1326,26.77,0.5,0.53
1,785,30,1313,13,6.39,1326,26.77,0.5,0.53
1,785,30,1313,13,6.39,1326,26.77,0.5,0.53
6,345,52,1296,8,4.0,1304,18.52,0.52,0.54
6,345,52,1296,8,4.0,1304,18.52,0.52,0.54
6,345,52,1296,8,4.0,1304,18.52,0.52,0.54
6,345,52,1296,8,4.0,1304,18.52,0.52,0.54
6,345,52,1296,8,4.0,1304,18.52,0.52,0.54
6,345,52,1296,8,4.0,1304,18.52,0.52,0.54
1,745,30,1336,12,5.9,1348,25.1,0.5,0.53
1,745,30,1336,12,5.9,1348,25.1,0.5,0.53
1,745,30,1336,12,5.9,1348,25.1,0.5,0.53
1,745,30,1336,12,5.9,1348,25.1,0.5,0.53
1,745,30,1336,12,5.9,1348,25.1,0.5,0.53
1,745,30,1336,12,5.9,1348,25.1,0.5,0.53
10,583,32,1338,11,5.4,1349,23.41,0.5,0.53
10,583,32,1338,11,5.4,1349,23.41,0.5,0.53
10,583,32,1338,11,5.4,1349,23.41,0.5,0.53
10,583,32,1338,11,5.4,1349,23.41,0.5,0.53
10,583,32,1338,11,5.4,1349,23.41,0.5,0.53
10,583,32,1338,11,5.4,1349,23.41,0.5,0.53
11,694,73,1336,14,6.9,1350,28.48,0.49,0.53
11,694,73,1336,14,6.9,1350,28.48,0.49,0.53
11,694,73,1336,14,6.9,1350,28.48,0.49,0.53
11,694,73,1336,14,6.9,1350,28.48,0.49,0.53
11,694,73,1336,14,6.9,1350,28.48,0.49,0.53
11,694,73,1336,14,6.9,1350,28.48,0.49,0.53
10,744,32,1355,14,7.02,1369,28.7,0.49,0.53
10,744,32,1355,14,7.02,1369,28.7,0.49,0.53
10,744,32,1355,14,7.02,1369,28.7,0.49,0.53
10,744,32,1355,14,7.02,1369,28.7,0.49,0.53
10,744,32,1355,14,7.02,1369,28.7,0.49,0.53
10,744,32,1355,14,7.02,1369,28.7,0.49,0.53
10,622,32,1399,8,4.14,1407,18.77,0.52,0.54
10,622,32,1399,8,4.14,1407,18.77,0.52,0.54
10,622,32,1399,8,4.14,1407,18.77,0.52,0.54
10,622,32,1399,8,4.14,1407,18.77,0.52,0.54
10,622,32,1399,8,4.14,1407,18.77,0.52,0.54
10,622,32,1399,8,4.14,1407,18.77,0.52,0.54
15,956,94,268,18,9.03,286,35.48,0.47000000000000003,0.52
15,956,94,268,18,9.03,286,35.48,0.47000000000000003,0.52
15,956,94,268,18,9.03,286,35.48,0.47000000000000003,0.52
15,956,94,268,18,9.03,286,35.48,0.47000000000000003,0.52
15,956,94,268,18,9.03,286,35.48,0.47000000000000003,0.52
15,956,94,268,18,9.03,286,35.48,0.47000000000000003,0.52
15,956,94,268,18,9.03,286,35.48,0.47000000000000003,0.52
10,801,85,301,2,1.15,303,8.66,0.54,0.55
10,801,85,301,2,1.15,303,8.66,0.54,0.55
10,801,85,301,2,1.15,303,8.66,0.54,0.55
10,801,85,301,2,1.15,303,8.66,0.54,0.55
10,801,85,301,2,1.15,303,8.66,0.54,0.55
10,801,85,301,2,1.15,303,8.66,0.54,0.55
10,801,85,301,2,1.15,303,8.66,0.54,0.55
7,134,21,379,6,2.88,385,14.92,0.53,0.54
7,134,21,379,6,2.88,385,14.92,0.53,0.54
7,134,21,379,6,2.88,385,14.92,0.53,0.54
7,134,21,379,6,2.88,385,14.92,0.53,0.54
7,134,21,379,6,2.88,385,14.92,0.53,0.54
7,134,21,379,6,2.88,385,14.92,0.53,0.54
7,134,21,379,6,2.88,385,14.92,0.53,0.54
15,889,94,360,4,2.17,364,12.07,0.53,0.55
15,889,94,360,4,2.17,364,12.07,0.53,0.55
15,889,94,360,4,2.17,364,12.07,0.53,0.55
15,889,94,360,4,2.17,364,12.07,0.53,0.55
15,889,94,360,4,2.17,364,12.07,0.53,0.55
15,889,94,360,4,2.17,364,12.07,0.53,0.55
15,889,94,360,4,2.17,364,12.07,0.53,0.55
0,222,71,447,22,11.17,469,42.48,0.46,0.51
0,222,71,447,22,11.17,469,42.48,0.46,0.51
0,222,71,447,22,11.17,469,42.48,0.46,0.51
0,222,71,447,22,11.17,469,42.48,0.46,0.51
0,222,71,447,22,11.17,469,42.48,0.46,0.51
0,222,71,447,22,11.17,469,42.48,0.46,0.51
0,222,71,447,22,11.17,469,42.48,0.46,0.51
3,141,75,439,8,3.79,447,18.13,0.52,0.54
3,141,75,439,8,3.79,447,18.13,0.52,0.54
3,141,75,439,8,3.79,447,18.13,0.52,0.54
3,141,75,439,8,3.79,447,18.13,0.52,0.54
3,141,75,439,8,3.79,447,18.13,0.52,0.54
3,141,75,439,8,3.79,447,18.13,0.52,0.54
3,141,75,439,8,3.79,447,18.13,0.52,0.54
7,56,21,429,9,4.62,438,20.43,0.51,0.54
7,56,21,429,9,4.62,438,20.43,0.51,0.54
7,56,21,429,9,4.62,438,20.43,0.51,0.54
7,56,21,429,9,4.62,438,20.43,0.51,0.54
7,56,21,429,9,4.62,438,20.43,0.51,0.54
7,56,21,429,9,4.62,438,20.43,0.51,0.54
7,56,21,429,9,4.62,438,20.43,0.51,0.54
9,143,97,440,4,1.99,444,11.74,0.53,0.55
9,143,97,440,4,1.99,444,11.74,0.53,0.55
9,143,97,440,4,1.99,444,11.74,0.53,0.55
9,143,97,440,4,1.99,444,11.74,0.53,0.55
9,143,97,440,4,1.99,444,11.74,0.53,0.55
9,143,97,440,4,1.99,444,11.74,0.53,0.55
9,143,97,440,4,1.99,444,11.74,0.53,0.55
10,793,85,434,4,1.99,438,11.74,0.53,0.55
10,793,85,434,4,1.99,438,11.74,0.53,0.55
10,793,85,434,4,1.99,438,11.74,0.53,0.55
10,793,85,434,4,1.99,438,11.74,0.53,0.55
10,793,85,434,4,1.99,438,11.74,0.53,0.55
10,793,85,434,4,1.99,438,11.74,0.53,0.55
10,793,85,434,4,1.99,438,11.74,0.53,0.55
11,101,1,432,5,2.45,437,13.36,0.53,0.55
11,101,1,432,5,2.45,437,13.36,0.53,0.55
11,101,1,432,5,2.45,437,13.36,0.53,0.55
11,101,1,432,5,2.45,437,13.36,0.53,0.55
11,101,1,432,5,2.45,437,13.36,0.53,0.55
11,101,1,432,5,2.45,437,13.36,0.53,0.55
11,101,1,432,5,2.45,437,13.36,0.53,0.55
3,143,75,460,18,8.76,478,34.98,0.48,0.52
3,143,75,460,18,8.76,478,34.98,0.48,0.52
3,143,75,460,18,8.76,478,34.98,0.48,0.52
3,143,75,460,18,8.76,478,34.98,0.48,0.52
3,143,75,460,18,8.76,478,34.98,0.48,0.52
3,143,75,460,18,8.76,478,34.98,0.48,0.52
3,143,75,460,18,8.76,478,34.98,0.48,0.52
4,176,59,475,12,6.09,487,25.44,0.5,0.53
4,176,59,475,12,6.09,487,25.44,0.5,0.53
4,176,59,475,12,6.09,487,25.44,0.5,0.53
4,176,59,475,12,6.09,487,25.44,0.5,0.53
4,176,59,475,12,6.09,487,25.44,0.5,0.53
4,176,59,475,12,6.09,487,25.44,0.5,0.53
4,176,59,475,12,6.09,487,25.44,0.5,0.53
7,242,21,459,15,7.58,474,30.5,0.49,0.52
7,242,21,459,15,7.58,474,30.5,0.49,0.52
7,242,21,459,15,7.58,474,30.5,0.49,0.52
7,242,21,459,15,7.58,474,30.5,0.49,0.52
7,242,21,459,15,7.58,474,30.5,0.49,0.52
7,242,21,459,15,7.58,474,30.5,0.49,0.52
7,242,21,459,15,7.58,474,30.5,0.49,0.52
9,90,97,472,6,3.1,478,15.33,0.52,0.54
9,90,97,472,6,3.1,478,15.33,0.52,0.54
9,90,97,472,6,3.1,478,15.33,0.52,0.54
9,90,97,472,6,3.1,478,15.33,0.52,0.54
9,90,97,472,6,3.1,478,15.33,0.52,0.54
9,90,97,472,6,3.1,478,15.33,0.52,0.54
9,90,97,472,6,3.1,478,15.33,0.52,0.54
10,94,85,462,9,4.64,471,20.46,0.51,0.54
10,94,85,462,9,4.64,471,20.46,0.51,0.54
10,94,85,462,9,4.64,471,20.46,0.51,0.54
10,94,85,462,9,4.64,471,20.46,0.51,0.54
10,94,85,462,9,4.64,471,20.46,0.51,0.54
10,94,85,462,9,4.64,471,20.46,0.51,0.54
10,94,85,462,9,4.64,471,20.46,0.51,0.54
11,195,1,463,8,3.96,471,18.45,0.52,0.54
11,195,1,463,8,3.96,471,18.45,0.52,0.54
11,195,1,463,8,3.96,471,18.45,0.52,0.54
11,195,1,463,8,3.96,471,18.45,0.52,0.54
11,195,1,463,8,3.96,471,18.45,0.52,0.54
11,195,1,463,8,3.96,471,18.45,0.52,0.54
11,195,1,463,8,3.96,471,18.45,0.52,0.54
12,1,6,454,13,6.66,467,27.26,0.49,0.53
12,1,6,454,13,6.66,467,27.26,0.49,0.53
12,1,6,454,13,6.66,467,27.26,0.49,0.53
12,1,6,454,13,6.66,467,27.26,0.49,0.53
12,1,6,454,13,6.66,467,27.26,0.49,0.53
12,1,6,454,13,6.66,467,27.26,0.49,0.53
12,1,6,454,13,6.66,467,27.26,0.49,0.53
7,212,21,503,8,4.16,511,18.81,0.52,0.54
7,212,21,503,8,4.16,511,18.81,0.52,0.54
7,212,21,503,8,4.16,511,18.81,0.52,0.54
7,212,21,503,8,4.16,511,18.81,0.52,0.54
7,212,21,503,8,4.16,511,18.81,0.52,0.54
7,212,21,503,8,4.16,511,18.81,0.52,0.54
7,212,21,503,8,4.16,511,18.81,0.52,0.54
9,231,97,498,12,5.96,510,25.21,0.5,0.53
9,231,97,498,12,5.96,510,25.21,0.5,0.53
9,231,97,498,12,5.96,510,25.21,0.5,0.53
9,231,97,498,12,5.96,510,25.21,0.5,0.53
9,231,97,498,12,5.96,510,25.21,0.5,0.53
9,231,97,498,12,5.96,510,25.21,0.5,0.53
9,231,97,498,12,5.96,510,25.21,0.5,0.53
10,0,85,501,5,2.6,506,13.62,0.53,0.55
10,0,85,501,5,2.6,506,13.62,0.53,0.55
10,0,85,501,5,2.6,506,13.62,0.53,0.55
10,0,85,501,5,2.6,506,13.62,0.53,0.55
10,0,85,501,5,2.6,506,13.62,0.53,0.55
10,0,85,501,5,2.6,506,13.62,0.53,0.55
10,0,85,501,5,2.6,506,13.62,0.53,0.55
12,249,6,509,6,3.12,515,15.35,0.52,0.54
12,249,6,509,6,3.12,515,15.35,0.52,0.54
12,249,6,509,6,3.12,515,15.35,0.52,0.54
12,249,6,509,6,3.12,515,15.35,0.52,0.54
12,249,6,509,6,3.12,515,15.35,0.52,0.54
12,249,6,509,6,3.12,515,15.35,0.52,0.54
12,249,6,509,6,3.12,515,15.35,0.52,0.54
13,808,27,497,10,5.1,507,22.09,0.51,0.53
13,808,27,497,10,5.1,507,22.09,0.51,0.53
13,808,27,497,10,5.1,507,22.09,0.51,0.53
13,808,27,497,10,5.1,507,22.09,0.51,0.53
13,808,27,497,10,5.1,507,22.09,0.51,0.53
13,808,27,497,10,5.1,507,22.09,0.51,0.53
13,808,27,497,10,5.1,507,22.09,0.51,0.53
0,61,71,519,7,3.6,526,17.01,0.52,0.54
0,61,71,519,7,3.6,526,17.01,0.52,0.54
0,61,71,519,7,3.6,526,17.01,0.52,0.54
0,61,71,519,7,3.6,526,17.01,0.52,0.54
0,61,71,519,7,3.6,526,17.01,0.52,0.54
0,61,71,519,7,3.6,526,17.01,0.52,0.54
0,61,71,519,7,3.6,526,17.01,0.52,0.54
7,940,21,520,14,6.85,534,28.39,0.49,0.53
7,940,21,520,14,6.85,534,28.39,0.49,0.53
7,940,21,520,14,6.85,534,28.39,0.49,0.53
7,940,21,520,14,6.85,534,28.39,0.49,0.53
7,940,21,520,14,6.85,534,28.39,0.49,0.53
7,940,21,520,14,6.85,534,28.39,0.49,0.53
7,940,21,520,14,6.85,534,28.39,0.49,0.53
9,203,97,532,9,4.42,541,20.06,0.51,0.54
9,203,97,532,9,4.42,541,20.06,0.51,0.54
9,203,97,532,9,4.42,541,20.06,0.51,0.54
9,203,97,532,9,4.42,541,20.06,0.51,0.54
9,203,97,532,9,4.42,541,20.06,0.51,0.54
9,203,97,532,9,4.42,541,20.06,0.51,0.54
9,203,97,532,9,4.42,541,20.06,0.51,0.54
10,43,85,518,11,5.46,529,23.52,0.5,0.53
10,43,85,518,11,5.46,529,23.52,0.5,0.53
10,43,85,518,11,5.46,529,23.52,0.5,0.53
10,43,85,518,11,5.46,529,23.52,0.5,0.53
10,43,85,518,11,5.46,529,23.52,0.5,0.53
10,43,85,518,11,5.46,529,23.52,0.5,0.53
10,43,85,518,11,5.46,529,23.52,0.5,0.53
11,650,1,528,17,8.54,545,33.8,0.48,0.52
11,650,1,528,17,8.54,545,33.8,0.48,0.52
11,650,1,528,17,8.54,545,33.8,0.48,0.52
11,650,1,528,17,8.54,545,33.8,0.48,0.52
11,650,1,528,17,8.54,545,33.8,0.48,0.52
11,650,1,528,17,8.54,545,33.8,0.48,0.52
11,650,1,528,17,8.54,545,33.8,0.48,0.52
0,57,71,558,8,4.21,566,18.9,0.52,0.54
0,57,71,558,8,4.21,566,18.9,0.52,0.54
0,57,71,558,8,4.21,566,18.9,0.52,0.54
0,57,71,558,8,4.21,566,18.9,0.52,0.54
0,57,71,558,8,4.21,566,18.9,0.52,0.54
0,57,71,558,8,4.21,566,18.9,0.52,0.54
0,57,71,558,8,4.21,566,18.9,0.52,0.54
3,189,75,565,8,3.9,573,18.33,0.52,0.54
3,189,75,565,8,3.9,573,18.33,0.52,0.54
3,189,75,565,8,3.9,573,18.33,0.52,0.54
3,189,75,565,8,3.9,573,18.33,0.52,0.54
3,189,75,565,8,3.9,573,18.33,0.52,0.54
3,189,75,565,8,3.9,573,18.33,0.52,0.54
3,189,75,565,8,3.9,573,18.33,0.52,0.54
4,885,59,567,16,8.17,583,32.35,0.48,0.52
4,885,59,567,16,8.17,583,32.35,0.48,0.52
4,885,59,567,16,8.17,583,32.35,0.48,0.52
4,885,59,567,16,8.17,583,32.35,0.48,0.52
4,885,59,567,16,8.17,583,32.35,0.48,0.52
4,885,59,567,16,8.17,583,32.35,0.48,0.52
4,885,59,567,16,8.17,583,32.35,0.48,0.52
9,47,97,552,13,6.38,565,26.76,0.5,0.53
9,47,97,552,13,6.38,565,26.76,0.5,0.53
9,47,97,552,13,6.38,565,26.76,0.5,0.53
9,47,97,552,13,6.38,565,26.76,0.5,0.53
9,47,97,552,13,6.38,565,26.76,0.5,0.53
9,47,97,552,13,6.38,565,26.76,0.5,0.53
9,47,97,552,13,6.38,565,26.76,0.5,0.53
10,47,85,545,9,4.34,554,19.91,0.51,0.54
10,47,85,545,9,4.34,554,19.91,0.51,0.54
10,47,85,545,9,4.34,554,19.91,0.51,0.54
10,47,85,545,9,4.34,554,19.91,0.51,0.54
10,47,85,545,9,4.34,554,19.91,0.51,0.54
10,47,85,545,9,4.34,554,19.91,0.51,0.54
10,47,85,545,9,4.34,554,19.91,0.51,0.54
0,48,71,598,13,6.53,611,27.03,0.49,0.53
0,48,71,598,13,6.53,611,27.03,0.49,0.53
0,48,71,598,13,6.53,611,27.03,0.49,0.53
0,48,71,598,13,6.53,611,27.03,0.49,0.53
0,48,71,598,13,6.53,611,27.03,0.49,0.53
0,48,71,598,13,6.53,611,27.03,0.49,0.53
0,48,71,598,13,6.53,611,27.03,0.49,0.53
3,141,75,597,8,3.94,605,18.42,0.52,0.54
3,141,75,597,8,3.94,605,18.42,0.52,0.54
3,141,75,597,8,3.94,605,18.42,0.52,0.54
3,141,75,597,8,3.94,605,18.42,0.52,0.54
3,141,75,597,8,3.94,605,18.42,0.52,0.54
3,141,75,597,8,3.94,605,18.42,0.52,0.54
3,141,75,597,8,3.94,605,18.42,0.52,0.54
9,862,97,595,10,4.9,605,21.72,0.51,0.54
9,862,97,595,10,4.9,605,21.72,0.51,0.54
9,862,97,595,10,4.9,605,21.72,0.51,0.54
9,862,97,595,10,4.9,605,21.72,0.51,0.54
9,862,97,595,10,4.9,605,21.72,0.51,0.54
9,862,97,595,10,4.9,605,21.72,0.51,0.54
9,862,97,595,10,4.9,605,21.72,0.51,0.54
12,93,6,594,16,7.94,610,31.93,0.48,0.52
12,93,6,594,16,7.94,610,31.93,0.48,0.52
12,93,6,594,16,7.94,610,31.93,0.48,0.52
12,93,6,594,16,7.94,610,31.93,0.48,0.52
12,93,6,594,16,7.94,610,31.93,0.48,0.52
12,93,6,594,16,7.94,610,31.93,0.48,0.52
12,93,6,594,16,7.94,610,31.93,0.48,0.52
13,44,27,570,17,8.34,587,33.44,0.48,0.52
13,44,27,570,17,8.34,587,33.44,0.48,0.52
13,44,27,570,17,8.34,587,33.44,0.48,0.52
13,44,27,570,17,8.34,587,33.44,0.48,0.52
13,44,27,570,17,8.34,587,33.44,0.48,0.52
13,44,27,570,17,8.34,587,33.44,0.48,0.52
13,44,27,570,17,8.34,587,33.44,0.48,0.52
5,934,83,781,7,3.68,788,17.15,0.52,0.54
5,934,83,781,7,3.68,788,17.15,0.52,0.54
5,934,83,781,7,3.68,788,17.15,0.52,0.54
5,934,83,781,7,3.68,788,17.15,0.52,0.54
5,934,83,781,7,3.68,788,17.15,0.52,0.54
5,934,83,781,7,3.68,788,17.15,0.52,0.54
5,934,83,781,7,3.68,788,17.15,0.52,0.54
4,496,16,1022,16,8.2,1038,32.4,0.48,0.52
4,496,16,1022,16,8.2,1038,32.4,0.48,0.52
4,496,16,1022,16,8.2,1038,32.4,0.48,0.52
4,496,16,1022,16,8.2,1038,32.4,0.48,0.52
4,496,16,1022,16,8.2,1038,32.4,0.48,0.52
4,496,16,1022,16,8.2,1038,32.4,0.48,0.52
4,496,16,1022,16,8.2,1038,32.4,0.48,0.52
5,294,83,1046,12,5.87,1058,25.05,0.5,0.53
5,294,83,1046,12,5.87,1058,25.05,0.5,0.53
5,294,83,1046,12,5.87,1058,25.05,0.5,0.53
5,294,83,1046,12,5.87,1058,25.05,0.5,0.53
5,294,83,1046,12,5.87,1058,25.05,0.5,0.53
5,294,83,1046,12,5.87,1058,25.05,0.5,0.53
5,294,83,1046,12,5.87,1058,25.05,0.5,0.53
5,310,83,1075,6,3.13,1081,15.38,0.52,0.54
5,310,83,1075,6,3.13,1081,15.38,0.52,0.54
5,310,83,1075,6,3.13,1081,15.38,0.52,0.54
5,310,83,1075,6,3.13,1081,15.38,0.52,0.54
5,310,83,1075,6,3.13,1081,15.38,0.52,0.54
5,310,83,1075,6,3.13,1081,15.38,0.52,0.54
5,310,83,1075,6,3.13,1081,15.38,0.52,0.54
6,409,57,1061,6,2.7600000000000002,1067,14.69,0.53,0.54
6,409,57,1061,6,2.7600000000000002,1067,14.69,0.53,0.54
6,409,57,1061,6,2.7600000000000002,1067,14.69,0.53,0.54
6,409,57,1061,6,2.7600000000000002,1067,14.69,0.53,0.54
6,409,57,1061,6,2.7600000000000002,1067,14.69,0.53,0.54
6,409,57,1061,6,2.7600000000000002,1067,14.69,0.53,0.54
6,409,57,1061,6,2.7600000000000002,1067,14.69,0.53,0.54
9,353,97,1067,9,4.46,1076,20.14,0.51,0.54
9,353,97,1067,9,4.46,1076,20.14,0.51,0.54
9,353,97,1067,9,4.46,1076,20.14,0.51,0.54
9,353,97,1067,9,4.46,1076,20.14,0.51,0.54
9,353,97,1067,9,4.46,1076,20.14,0.51,0.54
9,353,97,1067,9,4.46,1076,20.14,0.51,0.54
9,353,97,1067,9,4.46,1076,20.14,0.51,0.54
3,290,95,1097,16,7.91,1113,31.88,0.48,0.52
3,290,95,1097,16,7.91,1113,31.88,0.48,0.52
3,290,95,1097,16,7.91,1113,31.88,0.48,0.52
3,290,95,1097,16,7.91,1113,31.88,0.48,0.52
3,290,95,1097,16,7.91,1113,31.88,0.48,0.52
3,290,95,1097,16,7.91,1113,31.88,0.48,0.52
3,290,95,1097,16,7.91,1113,31.88,0.48,0.52
6,303,57,1108,10,4.86,1118,21.65,0.51,0.54
6,303,57,1108,10,4.86,1118,21.65,0.51,0.54
6,303,57,1108,10,4.86,1118,21.65,0.51,0.54
6,303,57,1108,10,4.86,1118,21.65,0.51,0.54
6,303,57,1108,10,4.86,1118,21.65,0.51,0.54
6,303,57,1108,10,4.86,1118,21.65,0.51,0.54
6,303,57,1108,10,4.86,1118,21.65,0.51,0.54
3,807,95,1122,10,4.87,1132,21.67,0.51,0.54
3,807,95,1122,10,4.87,1132,21.67,0.51,0.54
3,807,95,1122,10,4.87,1132,21.67,0.51,0.54
3,807,95,1122,10,4.87,1132,21.67,0.51,0.54
3,807,95,1122,10,4.87,1132,21.67,0.51,0.54
3,807,95,1122,10,4.87,1132,21.67,0.51,0.54
3,807,95,1122,10,4.87,1132,21.67,0.51,0.54
6,774,57,1166,13,6.51,1179,26.98,0.5,0.53
6,774,57,1166,13,6.51,1179,26.98,0.5,0.53
6,774,57,1166,13,6.51,1179,26.98,0.5,0.53
6,774,57,1166,13,6.51,1179,26.98,0.5,0.53
6,774,57,1166,13,6.51,1179,26.98,0.5,0.53
6,774,57,1166,13,6.51,1179,26.98,0.5,0.53
6,774,57,1166,13,6.51,1179,26.98,0.5,0.53
15,468,49,1155,3,1.36,1158,9.82,0.54,0.55
15,468,49,1155,3,1.36,1158,9.82,0.54,0.55
15,468,49,1155,3,1.36,1158,9.82,0.54,0.55
15,468,49,1155,3,1.36,1158,9.82,0.54,0.55
15,468,49,1155,3,1.36,1158,9.82,0.54,0.55
15,468,49,1155,3,1.36,1158,9.82,0.54,0.55
15,468,49,1155,3,1.36,1158,9.82,0.54,0.55
15,579,49,1250,1,0.38,1251,6.48,0.55,0.55
15,579,49,1250,1,0.38,1251,6.48,0.55,0.55
15,579,49,1250,1,0.38,1251,6.48,0.55,0.55
15,579,49,1250,1,0.38,1251,6.48,0.55,0.55
15,579,49,1250,1,0.38,1251,6.48,0.55,0.55
15,579,49,1250,1,0.38,1251,6.48,0.55,0.55
15,579,49,1250,1,0.38,1251,6.48,0.55,0.55
15,688,49,1319,14,7.09,1333,28.82,0.49,0.53
15,688,49,1319,14,7.09,1333,28.82,0.49,0.53
15,688,49,1319,14,7.09,1333,28.82,0.49,0.53
15,688,49,1319,14,7.09,1333,28.82,0.49,0.53
15,688,49,1319,14,7.09,1333,28.82,0.49,0.53
15,688,49,1319,14,7.09,1333,28.82,0.49,0.53
15,688,49,1319,14,7.09,1333,28.82,0.49,0.53
15,887,49,1371,15,7.57,1386,30.49,0.49,0.52
15,887,49,1371,15,7.57,1386,30.49,0.49,0.52
15,887,49,1371,15,7.57,1386,30.49,0.49,0.52
15,887,49,1371,15,7.57,1386,30.49,0.49,0.52
15,887,49,1371,15,7.57,1386,30.49,0.49,0.52
15,887,49,1371,15,7.57,1386,30.49,0.49,0.52
15,887,49,1371,15,7.57,1386,30.49,0.49,0.52
