square_index,rider_id,driver_idx,trip_start_timestamp,trip_duration,ride_miles,trip_end_timestamp,price_of_ride,rider_acceptance_prob,driver_acceptance_prob
6,914,80,210,14,7.24,224,29.1,0.49,0.53
7,853,28,239,10,4.79,249,21.52,0.51,0.54
2,800,87,298,18,8.92,316,35.28,0.47000000000000003,0.52
5,945,15,329,1,0.6900000000000001,330,7.03,0.54,0.55
6,869,80,344,9,4.72,353,20.61,0.51,0.54
5,232,15,382,2,0.76,384,7.94,0.54,0.55
6,95,80,370,13,6.38,383,26.75,0.5,0.53
6,26,80,398,13,6.72,411,27.37,0.49,0.53
8,102,44,426,17,8.73,443,34.14,0.48,0.52
15,8,68,475,6,2.9,481,14.96,0.53,0.54
10,202,1,493,7,3.43,500,16.71,0.52,0.54
15,115,68,501,3,1.44,504,9.96,0.54,0.55
8,182,44,515,18,9.04,533,35.49,0.47000000000000003,0.52
15,190,68,526,10,5.1,536,22.08,0.51,0.53
15,214,68,544,8,4.23,552,18.93,0.52,0.54
3,968,63,593,21,10.3,614,40.13,0.46,0.51
10,202,1,578,5,2.37,583,13.21,0.53,0.55
15,1,68,580,10,5.2,590,22.27,0.51,0.53
10,212,1,609,13,6.62,622,27.19,0.49,0.53
8,804,44,677,15,7.61,692,30.55,0.49,0.52
3,949,63,696,3,1.33,699,9.75,0.54,0.55
6,793,80,896,8,4.18,904,18.85,0.52,0.54
12,953,93,874,16,7.96,890,31.96,0.48,0.52
6,836,80,968,5,2.54,973,13.53,0.53,0.55
12,341,93,979,15,7.37,994,30.11,0.49,0.52
3,272,63,1028,15,7.67,1043,30.65,0.49,0.52
6,361,80,1036,7,3.71,1043,17.22,0.52,0.54
12,331,93,1044,4,1.75,1048,11.31,0.53,0.55
2,419,7,1074,10,4.92,1084,21.75,0.51,0.54
3,266,63,1059,7,3.3,1066,16.47,0.52,0.54
6,279,80,1069,4,1.78,1073,11.36,0.53,0.55
3,498,63,1109,9,4.35,1118,19.93,0.51,0.54
6,304,80,1093,6,2.84,1099,14.85,0.53,0.54
12,263,93,1096,14,7.13,1110,28.9,0.49,0.53
1,406,97,1118,11,5.28,1129,23.18,0.5,0.53
3,289,63,1126,13,6.39,1139,26.77,0.5,0.53
5,317,90,1118,12,6.0,1130,25.28,0.5,0.53
6,443,80,1139,4,2.12,1143,11.98,0.53,0.55
3,464,63,1142,4,1.82,1146,11.43,0.53,0.55
5,395,90,1140,8,4.04,1148,18.59,0.52,0.54
12,549,93,1204,16,8.09,1220,32.2,0.48,0.52
3,517,63,1256,7,3.3,1263,16.47,0.52,0.54
12,559,93,1270,5,2.26,1275,13.01,0.53,0.55
3,661,63,1305,20,10.05,1325,38.89,0.47000000000000003,0.51
12,716,93,1345,10,4.86,1355,21.64,0.51,0.54
7,537,62,1378,8,4.08,1386,18.67,0.52,0.54
12,650,93,1354,14,7.06,1368,28.78,0.49,0.53
4,788,36,227,10,5.03,237,21.95,0.51,0.54
4,788,36,227,10,5.03,237,21.95,0.51,0.54
8,136,68,377,13,6.66,390,27.26,0.49,0.53
8,136,68,377,13,6.66,390,27.26,0.49,0.53
4,130,36,413,7,3.61,420,17.04,0.52,0.54
4,130,36,413,7,3.61,420,17.04,0.52,0.54
6,185,16,396,11,5.74,407,24.02,0.5,0.53
6,185,16,396,11,5.74,407,24.02,0.5,0.53
9,136,37,417,7,3.42,424,16.69,0.52,0.54
9,136,37,417,7,3.42,424,16.69,0.52,0.54
4,98,36,433,11,5.45,444,23.49,0.5,0.53
4,98,36,433,11,5.45,444,23.49,0.5,0.53
8,39,68,432,2,0.92,434,8.23,0.54,0.55
8,39,68,432,2,0.92,434,8.23,0.54,0.55
10,102,97,422,8,4.23,430,18.94,0.52,0.54
10,102,97,422,8,4.23,430,18.94,0.52,0.54
13,78,89,438,17,8.4,455,33.55,0.48,0.52
13,78,89,438,17,8.4,455,33.55,0.48,0.52
5,136,94,474,9,4.47,483,20.16,0.51,0.54
5,136,94,474,9,4.47,483,20.16,0.51,0.54
8,152,68,472,12,6.17,484,25.59,0.5,0.53
8,152,68,472,12,6.17,484,25.59,0.5,0.53
7,118,82,488,3,1.36,491,9.82,0.54,0.55
7,118,82,488,3,1.36,491,9.82,0.54,0.55
8,32,68,494,12,5.96,506,25.22,0.5,0.53
8,32,68,494,12,5.96,506,25.22,0.5,0.53
10,125,97,505,9,4.5,514,20.21,0.51,0.54
10,125,97,505,9,4.5,514,20.21,0.51,0.54
12,38,7,501,8,3.88,509,18.31,0.52,0.54
12,38,7,501,8,3.88,509,18.31,0.52,0.54
13,125,89,481,18,9.08,499,35.56,0.47000000000000003,0.52
13,125,89,481,18,9.08,499,35.56,0.47000000000000003,0.52
5,229,94,537,4,2.14,541,12.01,0.53,0.55
5,229,94,537,4,2.14,541,12.01,0.53,0.55
7,99,82,512,1,0.49,513,6.67,0.55,0.55
7,99,82,512,1,0.49,513,6.67,0.55,0.55
8,180,68,513,13,6.56,526,27.07,0.49,0.53
8,180,68,513,13,6.56,526,27.07,0.49,0.53
12,191,7,513,20,9.82,533,38.47,0.47000000000000003,0.51
12,191,7,513,20,9.82,533,38.47,0.47000000000000003,0.51
13,85,89,529,6,3.06,535,15.25,0.52,0.54
13,85,89,529,6,3.06,535,15.25,0.52,0.54
8,177,68,555,12,6.13,567,25.51,0.5,0.53
8,177,68,555,12,6.13,567,25.51,0.5,0.53
8,52,68,597,13,6.57,610,27.09,0.49,0.53
8,52,68,597,13,6.57,610,27.09,0.49,0.53
12,869,7,581,6,2.89,587,14.94,0.53,0.54
12,869,7,581,6,2.89,587,14.94,0.53,0.54
14,804,17,604,13,6.63,617,27.21,0.49,0.53
14,804,17,604,13,6.63,617,27.21,0.49,0.53
10,913,97,926,15,7.43,941,30.23,0.49,0.52
10,913,97,926,15,7.43,941,30.23,0.49,0.52
10,443,97,1008,13,6.47,1021,26.92,0.5,0.53
10,443,97,1008,13,6.47,1021,26.92,0.5,0.53
1,318,65,1020,11,5.65,1031,23.86,0.5,0.53
1,318,65,1020,11,5.65,1031,23.86,0.5,0.53
10,313,97,1062,9,4.27,1071,19.79,0.51,0.54
10,313,97,1062,9,4.27,1071,19.79,0.51,0.54
11,318,61,1059,7,3.27,1066,16.41,0.52,0.54
11,318,61,1059,7,3.27,1066,16.41,0.52,0.54
1,452,65,1095,5,2.37,1100,13.21,0.53,0.55
1,452,65,1095,5,2.37,1100,13.21,0.53,0.55
11,289,61,1082,5,2.66,1087,13.74,0.53,0.55
11,289,61,1082,5,2.66,1087,13.74,0.53,0.55
1,360,65,1114,2,1.01,1116,8.39,0.54,0.55
1,360,65,1114,2,1.01,1116,8.39,0.54,0.55
10,350,97,1125,4,2.18,1129,12.08,0.53,0.55
10,350,97,1125,4,2.18,1129,12.08,0.53,0.55
11,450,61,1127,10,5.15,1137,22.17,0.51,0.53
11,450,61,1127,10,5.15,1137,22.17,0.51,0.53
12,407,25,1117,20,10.24,1137,39.23,0.46,0.51
12,407,25,1117,20,10.24,1137,39.23,0.46,0.51
15,940,29,1114,13,6.45,1127,26.88,0.5,0.53
15,940,29,1114,13,6.45,1127,26.88,0.5,0.53
10,970,97,1145,9,4.52,1154,20.25,0.51,0.54
10,970,97,1145,9,4.52,1154,20.25,0.51,0.54
15,940,29,1173,14,7.07,1187,28.79,0.49,0.53
15,940,29,1173,14,7.07,1187,28.79,0.49,0.53
10,929,97,1236,8,3.96,1244,18.45,0.52,0.54
10,929,97,1236,8,3.96,1244,18.45,0.52,0.54
10,553,97,1277,3,1.72,1280,10.47,0.54,0.55
10,553,97,1277,3,1.72,1280,10.47,0.54,0.55
1,572,42,1300,5,2.26,1305,13.02,0.53,0.55
1,572,42,1300,5,2.26,1305,13.02,0.53,0.55
10,532,97,1310,7,3.75,1317,17.28,0.52,0.54
10,532,97,1310,7,3.75,1317,17.28,0.52,0.54
1,616,42,1346,4,2.22,1350,12.16,0.53,0.55
1,616,42,1346,4,2.22,1350,12.16,0.53,0.55
10,546,97,1341,12,6.22,1353,25.68,0.5,0.53
10,546,97,1341,12,6.22,1353,25.68,0.5,0.53
10,746,97,1371,4,1.85,1375,11.49,0.53,0.55
10,746,97,1371,4,1.85,1375,11.49,0.53,0.55
12,631,25,1401,16,8.22,1417,32.45,0.48,0.52
12,631,25,1401,16,8.22,1417,32.45,0.48,0.52
1,670,42,1413,17,8.36,1430,33.47,0.48,0.52
1,670,42,1413,17,8.36,1430,33.47,0.48,0.52
7,946,72,144,7,3.32,151,16.5,0.52,0.54
7,946,72,144,7,3.32,151,16.5,0.52,0.54
7,946,72,144,7,3.32,151,16.5,0.52,0.54
7,846,72,156,7,3.37,163,16.6,0.52,0.54
7,846,72,156,7,3.37,163,16.6,0.52,0.54
7,846,72,156,7,3.37,163,16.6,0.52,0.54
5,925,63,263,10,5.1,273,22.07,0.51,0.53
5,925,63,263,10,5.1,273,22.07,0.51,0.53
5,925,63,263,10,5.1,273,22.07,0.51,0.53
7,925,72,276,19,9.53,295,37.17,0.47000000000000003,0.52
7,925,72,276,19,9.53,295,37.17,0.47000000000000003,0.52
7,925,72,276,19,9.53,295,37.17,0.47000000000000003,0.52
7,63,72,340,9,4.64,349,20.46,0.51,0.54
7,63,72,340,9,4.64,349,20.46,0.51,0.54
7,63,72,340,9,4.64,349,20.46,0.51,0.54
5,202,63,366,14,7.2,380,29.03,0.49,0.53
5,202,63,366,14,7.2,380,29.03,0.49,0.53
5,202,63,366,14,7.2,380,29.03,0.49,0.53
15,912,41,375,10,4.78,385,21.51,0.51,0.54
15,912,41,375,10,4.78,385,21.51,0.51,0.54
15,912,41,375,10,4.78,385,21.51,0.51,0.54
3,160,27,401,15,7.51,416,30.36,0.49,0.52
3,160,27,401,15,7.51,416,30.36,0.49,0.52
3,160,27,401,15,7.51,416,30.36,0.49,0.52
5,32,63,398,10,4.89,408,21.7,0.51,0.54
5,32,63,398,10,4.89,408,21.7,0.51,0.54
5,32,63,398,10,4.89,408,21.7,0.51,0.54
15,188,41,415,14,7.19,429,29.0,0.49,0.53
15,188,41,415,14,7.19,429,29.0,0.49,0.53
15,188,41,415,14,7.19,429,29.0,0.49,0.53
3,191,27,420,11,5.31,431,23.25,0.5,0.53
3,191,27,420,11,5.31,431,23.25,0.5,0.53
3,191,27,420,11,5.31,431,23.25,0.5,0.53
11,835,14,430,8,3.85,438,18.25,0.52,0.54
11,835,14,430,8,3.85,438,18.25,0.52,0.54
11,835,14,430,8,3.85,438,18.25,0.52,0.54
12,984,70,431,15,7.64,446,30.61,0.49,0.52
12,984,70,431,15,7.64,446,30.61,0.49,0.52
12,984,70,431,15,7.64,446,30.61,0.49,0.52
3,191,27,462,18,8.76,480,34.99,0.48,0.52
3,191,27,462,18,8.76,480,34.99,0.48,0.52
3,191,27,462,18,8.76,480,34.99,0.48,0.52
11,46,14,469,8,4.24,477,18.95,0.52,0.54
11,46,14,469,8,4.24,477,18.95,0.52,0.54
11,46,14,469,8,4.24,477,18.95,0.52,0.54
3,168,27,507,5,2.54,512,13.53,0.53,0.55
3,168,27,507,5,2.54,512,13.53,0.53,0.55
3,168,27,507,5,2.54,512,13.53,0.53,0.55
4,8,99,501,9,4.41,510,20.04,0.51,0.54
4,8,99,501,9,4.41,510,20.04,0.51,0.54
4,8,99,501,9,4.41,510,20.04,0.51,0.54
7,1,72,508,16,7.91,524,31.87,0.48,0.52
7,1,72,508,16,7.91,524,31.87,0.48,0.52
7,1,72,508,16,7.91,524,31.87,0.48,0.52
8,166,83,489,8,4.19,497,18.87,0.52,0.54
8,166,83,489,8,4.19,497,18.87,0.52,0.54
8,166,83,489,8,4.19,497,18.87,0.52,0.54
11,5,14,506,6,2.77,512,14.72,0.53,0.54
11,5,14,506,6,2.77,512,14.72,0.53,0.54
11,5,14,506,6,2.77,512,14.72,0.53,0.54
14,136,1,502,7,3.4,509,16.64,0.52,0.54
14,136,1,502,7,3.4,509,16.64,0.52,0.54
14,136,1,502,7,3.4,509,16.64,0.52,0.54
1,224,53,538,9,4.54,547,20.29,0.51,0.54
1,224,53,538,9,4.54,547,20.29,0.51,0.54
1,224,53,538,9,4.54,547,20.29,0.51,0.54
14,62,1,537,10,4.99,547,21.88,0.51,0.54
14,62,1,537,10,4.99,547,21.88,0.51,0.54
14,62,1,537,10,4.99,547,21.88,0.51,0.54
7,115,72,558,9,4.69,567,20.56,0.51,0.54
7,115,72,558,9,4.69,567,20.56,0.51,0.54
7,115,72,558,9,4.69,567,20.56,0.51,0.54
8,20,83,540,8,3.94,548,18.42,0.52,0.54
8,20,83,540,8,3.94,548,18.42,0.52,0.54
8,20,83,540,8,3.94,548,18.42,0.52,0.54
10,125,77,547,5,2.59,552,13.61,0.53,0.55
10,125,77,547,5,2.59,552,13.61,0.53,0.55
10,125,77,547,5,2.59,552,13.61,0.53,0.55
8,54,83,580,13,6.62,593,27.19,0.49,0.53
8,54,83,580,13,6.62,593,27.19,0.49,0.53
8,54,83,580,13,6.62,593,27.19,0.49,0.53
11,217,14,591,7,3.56,598,16.93,0.52,0.54
11,217,14,591,7,3.56,598,16.93,0.52,0.54
11,217,14,591,7,3.56,598,16.93,0.52,0.54
3,178,27,606,16,7.79,622,31.65,0.48,0.52
3,178,27,606,16,7.79,622,31.65,0.48,0.52
3,178,27,606,16,7.79,622,31.65,0.48,0.52
7,827,72,638,3,1.47,641,10.01,0.54,0.55
7,827,72,638,3,1.47,641,10.01,0.54,0.55
7,827,72,638,3,1.47,641,10.01,0.54,0.55
14,821,1,635,7,3.25,642,16.38,0.52,0.54
14,821,1,635,7,3.25,642,16.38,0.52,0.54
14,821,1,635,7,3.25,642,16.38,0.52,0.54
5,888,24,754,5,2.64,759,13.7,0.53,0.55
5,888,24,754,5,2.64,759,13.7,0.53,0.55
5,888,24,754,5,2.64,759,13.7,0.53,0.55
11,968,14,783,12,6.01,795,25.3,0.5,0.53
11,968,14,783,12,6.01,795,25.3,0.5,0.53
11,968,14,783,12,6.01,795,25.3,0.5,0.53
2,355,6,1078,4,1.76,1082,11.33,0.53,0.55
2,355,6,1078,4,1.76,1082,11.33,0.53,0.55
2,355,6,1078,4,1.76,1082,11.33,0.53,0.55
2,338,6,1109,14,6.86,1123,28.41,0.49,0.53
2,338,6,1109,14,6.86,1123,28.41,0.49,0.53
2,338,6,1109,14,6.86,1123,28.41,0.49,0.53
2,919,6,1122,7,3.43,1129,16.7,0.52,0.54
2,919,6,1122,7,3.43,1129,16.7,0.52,0.54
2,919,6,1122,7,3.43,1129,16.7,0.52,0.54
0,364,51,1148,9,4.72,1157,20.61,0.51,0.54
0,364,51,1148,9,4.72,1157,20.61,0.51,0.54
0,364,51,1148,9,4.72,1157,20.61,0.51,0.54
0,393,51,1181,11,5.6,1192,23.78,0.5,0.53
0,393,51,1181,11,5.6,1192,23.78,0.5,0.53
0,393,51,1181,11,5.6,1192,23.78,0.5,0.53
4,997,43,1170,9,4.58,1179,20.36,0.51,0.54
4,997,43,1170,9,4.58,1179,20.36,0.51,0.54
4,997,43,1170,9,4.58,1179,20.36,0.51,0.54
4,517,43,1319,16,8.01,1335,32.06,0.48,0.52
4,517,43,1319,16,8.01,1335,32.06,0.48,0.52
4,517,43,1319,16,8.01,1335,32.06,0.48,0.52
4,727,43,1320,11,5.65,1331,23.86,0.5,0.53
4,727,43,1320,11,5.65,1331,23.86,0.5,0.53
4,727,43,1320,11,5.65,1331,23.86,0.5,0.53
4,679,43,1369,13,6.54,1382,27.05,0.49,0.53
4,679,43,1369,13,6.54,1382,27.05,0.49,0.53
4,679,43,1369,13,6.54,1382,27.05,0.49,0.53
4,785,43,1410,9,4.31,1419,19.86,0.51,0.54
4,785,43,1410,9,4.31,1419,19.86,0.51,0.54
4,785,43,1410,9,4.31,1419,19.86,0.51,0.54
8,605,69,1425,19,9.26,1444,36.67,0.47000000000000003,0.52
8,605,69,1425,19,9.26,1444,36.67,0.47000000000000003,0.52
8,605,69,1425,19,9.26,1444,36.67,0.47000000000000003,0.52
2,969,43,30,16,8.19,46,32.39,0.48,0.52
2,969,43,30,16,8.19,46,32.39,0.48,0.52
2,969,43,30,16,8.19,46,32.39,0.48,0.52
2,969,43,30,16,8.19,46,32.39,0.48,0.52
2,957,43,84,4,2.0,88,11.77,0.53,0.55
2,957,43,84,4,2.0,88,11.77,0.53,0.55
2,957,43,84,4,2.0,88,11.77,0.53,0.55
2,957,43,84,4,2.0,88,11.77,0.53,0.55
1,790,18,370,10,5.22,380,22.31,0.51,0.53
1,790,18,370,10,5.22,380,22.31,0.51,0.53
1,790,18,370,10,5.22,380,22.31,0.51,0.53
1,790,18,370,10,5.22,380,22.31,0.51,0.53
10,913,97,388,1,0.39,389,6.5,0.55,0.55
10,913,97,388,1,0.39,389,6.5,0.55,0.55
10,913,97,388,1,0.39,389,6.5,0.55,0.55
10,913,97,388,1,0.39,389,6.5,0.55,0.55
1,235,18,433,13,6.69,446,27.31,0.49,0.53
1,235,18,433,13,6.69,446,27.31,0.49,0.53
1,235,18,433,13,6.69,446,27.31,0.49,0.53
1,235,18,433,13,6.69,446,27.31,0.49,0.53
5,73,42,424,8,4.24,432,18.95,0.52,0.54
5,73,42,424,8,4.24,432,18.95,0.52,0.54
5,73,42,424,8,4.24,432,18.95,0.52,0.54
5,73,42,424,8,4.24,432,18.95,0.52,0.54
1,91,18,454,12,6.11,466,25.48,0.5,0.53
1,91,18,454,12,6.11,466,25.48,0.5,0.53
1,91,18,454,12,6.11,466,25.48,0.5,0.53
1,91,18,454,12,6.11,466,25.48,0.5,0.53
5,96,42,457,10,4.75,467,21.45,0.51,0.54
5,96,42,457,10,4.75,467,21.45,0.51,0.54
5,96,42,457,10,4.75,467,21.45,0.51,0.54
5,96,42,457,10,4.75,467,21.45,0.51,0.54
6,90,10,473,10,5.0,483,21.89,0.51,0.54
6,90,10,473,10,5.0,483,21.89,0.51,0.54
6,90,10,473,10,5.0,483,21.89,0.51,0.54
6,90,10,473,10,5.0,483,21.89,0.51,0.54
3,25,13,508,10,4.84,518,21.61,0.51,0.54
3,25,13,508,10,4.84,518,21.61,0.51,0.54
3,25,13,508,10,4.84,518,21.61,0.51,0.54
3,25,13,508,10,4.84,518,21.61,0.51,0.54
5,91,42,504,2,0.75,506,7.93,0.54,0.55
5,91,42,504,2,0.75,506,7.93,0.54,0.55
5,91,42,504,2,0.75,506,7.93,0.54,0.55
5,91,42,504,2,0.75,506,7.93,0.54,0.55
14,202,63,490,13,6.75,503,27.42,0.49,0.53
14,202,63,490,13,6.75,503,27.42,0.49,0.53
14,202,63,490,13,6.75,503,27.42,0.49,0.53
14,202,63,490,13,6.75,503,27.42,0.49,0.53
3,5,13,534,5,2.61,539,13.65,0.53,0.55
3,5,13,534,5,2.61,539,13.65,0.53,0.55
3,5,13,534,5,2.61,539,13.65,0.53,0.55
3,5,13,534,5,2.61,539,13.65,0.53,0.55
5,125,42,532,4,2.24,536,12.19,0.53,0.55
5,125,42,532,4,2.24,536,12.19,0.53,0.55
5,125,42,532,4,2.24,536,12.19,0.53,0.55
5,125,42,532,4,2.24,536,12.19,0.53,0.55
14,69,63,535,13,6.51,548,26.99,0.5,0.53
14,69,63,535,13,6.51,548,26.99,0.5,0.53
14,69,63,535,13,6.51,548,26.99,0.5,0.53
14,69,63,535,13,6.51,548,26.99,0.5,0.53
3,67,13,555,13,6.43,568,26.84,0.5,0.53
3,67,13,555,13,6.43,568,26.84,0.5,0.53
3,67,13,555,13,6.43,568,26.84,0.5,0.53
3,67,13,555,13,6.43,568,26.84,0.5,0.53
4,160,89,542,5,2.52,547,13.49,0.53,0.55
4,160,89,542,5,2.52,547,13.49,0.53,0.55
4,160,89,542,5,2.52,547,13.49,0.53,0.55
4,160,89,542,5,2.52,547,13.49,0.53,0.55
12,989,57,542,14,6.85,556,28.39,0.49,0.53
12,989,57,542,14,6.85,556,28.39,0.49,0.53
12,989,57,542,14,6.85,556,28.39,0.49,0.53
12,989,57,542,14,6.85,556,28.39,0.49,0.53
14,133,63,544,13,6.57,557,27.09,0.49,0.53
14,133,63,544,13,6.57,557,27.09,0.49,0.53
14,133,63,544,13,6.57,557,27.09,0.49,0.53
14,133,63,544,13,6.57,557,27.09,0.49,0.53
15,997,40,580,17,8.32,597,33.4,0.48,0.52
15,997,40,580,17,8.32,597,33.4,0.48,0.52
15,997,40,580,17,8.32,597,33.4,0.48,0.52
15,997,40,580,17,8.32,597,33.4,0.48,0.52
5,897,42,607,8,3.95,615,18.43,0.52,0.54
5,897,42,607,8,3.95,615,18.43,0.52,0.54
5,897,42,607,8,3.95,615,18.43,0.52,0.54
5,897,42,607,8,3.95,615,18.43,0.52,0.54
15,51,40,623,19,9.56,642,37.21,0.47000000000000003,0.52
15,51,40,623,19,9.56,642,37.21,0.47000000000000003,0.52
15,51,40,623,19,9.56,642,37.21,0.47000000000000003,0.52
15,51,40,623,19,9.56,642,37.21,0.47000000000000003,0.52
5,815,42,742,10,4.77,752,21.48,0.51,0.54
5,815,42,742,10,4.77,752,21.48,0.51,0.54
5,815,42,742,10,4.77,752,21.48,0.51,0.54
5,815,42,742,10,4.77,752,21.48,0.51,0.54
5,957,42,789,3,1.67,792,10.37,0.54,0.55
5,957,42,789,3,1.67,792,10.37,0.54,0.55
5,957,42,789,3,1.67,792,10.37,0.54,0.55
5,957,42,789,3,1.67,792,10.37,0.54,0.55
10,925,64,930,10,5.15,940,22.17,0.51,0.53
10,925,64,930,10,5.15,940,22.17,0.51,0.53
10,925,64,930,10,5.15,940,22.17,0.51,0.53
10,925,64,930,10,5.15,940,22.17,0.51,0.53
13,424,92,944,15,7.41,959,30.18,0.49,0.52
13,424,92,944,15,7.41,959,30.18,0.49,0.52
13,424,92,944,15,7.41,959,30.18,0.49,0.52
13,424,92,944,15,7.41,959,30.18,0.49,0.52
0,365,68,1002,19,9.39,1021,36.91,0.47000000000000003,0.52
0,365,68,1002,19,9.39,1021,36.91,0.47000000000000003,0.52
0,365,68,1002,19,9.39,1021,36.91,0.47000000000000003,0.52
0,365,68,1002,19,9.39,1021,36.91,0.47000000000000003,0.52
14,318,63,1016,10,4.98,1026,21.86,0.51,0.54
14,318,63,1016,10,4.98,1026,21.86,0.51,0.54
14,318,63,1016,10,4.98,1026,21.86,0.51,0.54
14,318,63,1016,10,4.98,1026,21.86,0.51,0.54
15,482,40,994,16,8.01,1010,32.06,0.48,0.52
15,482,40,994,16,8.01,1010,32.06,0.48,0.52
15,482,40,994,16,8.01,1010,32.06,0.48,0.52
15,482,40,994,16,8.01,1010,32.06,0.48,0.52
14,258,63,1032,6,3.22,1038,15.54,0.52,0.54
14,258,63,1032,6,3.22,1038,15.54,0.52,0.54
14,258,63,1032,6,3.22,1038,15.54,0.52,0.54
14,258,63,1032,6,3.22,1038,15.54,0.52,0.54
15,467,40,1042,13,6.44,1055,26.86,0.5,0.53
15,467,40,1042,13,6.44,1055,26.86,0.5,0.53
15,467,40,1042,13,6.44,1055,26.86,0.5,0.53
15,467,40,1042,13,6.44,1055,26.86,0.5,0.53
0,302,68,1060,15,7.65,1075,30.62,0.49,0.52
0,302,68,1060,15,7.65,1075,30.62,0.49,0.52
0,302,68,1060,15,7.65,1075,30.62,0.49,0.52
0,302,68,1060,15,7.65,1075,30.62,0.49,0.52
14,485,63,1070,2,1.21,1072,8.76,0.54,0.55
14,485,63,1070,2,1.21,1072,8.76,0.54,0.55
14,485,63,1070,2,1.21,1072,8.76,0.54,0.55
14,485,63,1070,2,1.21,1072,8.76,0.54,0.55
0,365,68,1084,9,4.62,1093,20.43,0.51,0.54
0,365,68,1084,9,4.62,1093,20.43,0.51,0.54
0,365,68,1084,9,4.62,1093,20.43,0.51,0.54
0,365,68,1084,9,4.62,1093,20.43,0.51,0.54
10,341,64,1101,9,4.54,1110,20.28,0.51,0.54
10,341,64,1101,9,4.54,1110,20.28,0.51,0.54
10,341,64,1101,9,4.54,1110,20.28,0.51,0.54
10,341,64,1101,9,4.54,1110,20.28,0.51,0.54
14,393,63,1091,11,5.28,1102,23.19,0.5,0.53
14,393,63,1091,11,5.28,1102,23.19,0.5,0.53
14,393,63,1091,11,5.28,1102,23.19,0.5,0.53
14,393,63,1091,11,5.28,1102,23.19,0.5,0.53
14,266,63,1131,8,3.85,1139,18.25,0.52,0.54
14,266,63,1131,8,3.85,1139,18.25,0.52,0.54
14,266,63,1131,8,3.85,1139,18.25,0.52,0.54
14,266,63,1131,8,3.85,1139,18.25,0.52,0.54
15,261,40,1130,18,9.19,1148,35.76,0.47000000000000003,0.52
15,261,40,1130,18,9.19,1148,35.76,0.47000000000000003,0.52
15,261,40,1130,18,9.19,1148,35.76,0.47000000000000003,0.52
15,261,40,1130,18,9.19,1148,35.76,0.47000000000000003,0.52
10,940,64,1142,3,1.27,1145,9.66,0.54,0.55
10,940,64,1142,3,1.27,1145,9.66,0.54,0.55
10,940,64,1142,3,1.27,1145,9.66,0.54,0.55
10,940,64,1142,3,1.27,1145,9.66,0.54,0.55
14,459,63,1162,16,8.1,1178,32.22,0.48,0.52
14,459,63,1162,16,8.1,1178,32.22,0.48,0.52
14,459,63,1162,16,8.1,1178,32.22,0.48,0.52
14,459,63,1162,16,8.1,1178,32.22,0.48,0.52
14,818,63,1194,9,4.68,1203,20.54,0.51,0.54
14,818,63,1194,9,4.68,1203,20.54,0.51,0.54
14,818,63,1194,9,4.68,1203,20.54,0.51,0.54
14,818,63,1194,9,4.68,1203,20.54,0.51,0.54
14,519,63,1219,11,5.71,1230,23.98,0.5,0.53
14,519,63,1219,11,5.71,1230,23.98,0.5,0.53
14,519,63,1219,11,5.71,1230,23.98,0.5,0.53
14,519,63,1219,11,5.71,1230,23.98,0.5,0.53
14,648,63,1272,12,6.14,1284,25.53,0.5,0.53
14,648,63,1272,12,6.14,1284,25.53,0.5,0.53
14,648,63,1272,12,6.14,1284,25.53,0.5,0.53
14,648,63,1272,12,6.14,1284,25.53,0.5,0.53
14,571,63,1323,8,4.02,1331,18.55,0.52,0.54
14,571,63,1323,8,4.02,1331,18.55,0.52,0.54
14,571,63,1323,8,4.02,1331,18.55,0.52,0.54
14,571,63,1323,8,4.02,1331,18.55,0.52,0.54
14,501,63,1372,6,2.82,1378,14.8,0.53,0.54
14,501,63,1372,6,2.82,1378,14.8,0.53,0.54
14,501,63,1372,6,2.82,1378,14.8,0.53,0.54
14,501,63,1372,6,2.82,1378,14.8,0.53,0.54
0,779,50,169,9,4.55,178,20.3,0.51,0.54
0,779,50,169,9,4.55,178,20.3,0.51,0.54
0,779,50,169,9,4.55,178,20.3,0.51,0.54
0,779,50,169,9,4.55,178,20.3,0.51,0.54
0,779,50,169,9,4.55,178,20.3,0.51,0.54
5,964,13,163,11,5.65,174,23.87,0.5,0.53
5,964,13,163,11,5.65,174,23.87,0.5,0.53
5,964,13,163,11,5.65,174,23.87,0.5,0.53
5,964,13,163,11,5.65,174,23.87,0.5,0.53
5,964,13,163,11,5.65,174,23.87,0.5,0.53
8,865,3,155,8,4.08,163,18.66,0.52,0.54
8,865,3,155,8,4.08,163,18.66,0.52,0.54
8,865,3,155,8,4.08,163,18.66,0.52,0.54
8,865,3,155,8,4.08,163,18.66,0.52,0.54
8,865,3,155,8,4.08,163,18.66,0.52,0.54
0,920,50,313,10,4.94,323,21.79,0.51,0.54
0,920,50,313,10,4.94,323,21.79,0.51,0.54
0,920,50,313,10,4.94,323,21.79,0.51,0.54
0,920,50,313,10,4.94,323,21.79,0.51,0.54
0,920,50,313,10,4.94,323,21.79,0.51,0.54
8,83,3,416,11,5.61,427,23.79,0.5,0.53
8,83,3,416,11,5.61,427,23.79,0.5,0.53
8,83,3,416,11,5.61,427,23.79,0.5,0.53
8,83,3,416,11,5.61,427,23.79,0.5,0.53
8,83,3,416,11,5.61,427,23.79,0.5,0.53
0,56,50,443,11,5.74,454,24.02,0.5,0.53
0,56,50,443,11,5.74,454,24.02,0.5,0.53
0,56,50,443,11,5.74,454,24.02,0.5,0.53
0,56,50,443,11,5.74,454,24.02,0.5,0.53
0,56,50,443,11,5.74,454,24.02,0.5,0.53
1,236,85,432,9,4.37,441,19.98,0.51,0.54
1,236,85,432,9,4.37,441,19.98,0.51,0.54
1,236,85,432,9,4.37,441,19.98,0.51,0.54
1,236,85,432,9,4.37,441,19.98,0.51,0.54
1,236,85,432,9,4.37,441,19.98,0.51,0.54
2,957,17,426,12,5.89,438,25.09,0.5,0.53
2,957,17,426,12,5.89,438,25.09,0.5,0.53
2,957,17,426,12,5.89,438,25.09,0.5,0.53
2,957,17,426,12,5.89,438,25.09,0.5,0.53
2,957,17,426,12,5.89,438,25.09,0.5,0.53
4,165,67,430,13,6.35,443,26.7,0.5,0.53
4,165,67,430,13,6.35,443,26.7,0.5,0.53
4,165,67,430,13,6.35,443,26.7,0.5,0.53
4,165,67,430,13,6.35,443,26.7,0.5,0.53
4,165,67,430,13,6.35,443,26.7,0.5,0.53
8,78,3,428,12,6.06,440,25.4,0.5,0.53
8,78,3,428,12,6.06,440,25.4,0.5,0.53
8,78,3,428,12,6.06,440,25.4,0.5,0.53
8,78,3,428,12,6.06,440,25.4,0.5,0.53
8,78,3,428,12,6.06,440,25.4,0.5,0.53
2,49,17,476,7,3.48,483,16.79,0.52,0.54
2,49,17,476,7,3.48,483,16.79,0.52,0.54
2,49,17,476,7,3.48,483,16.79,0.52,0.54
2,49,17,476,7,3.48,483,16.79,0.52,0.54
2,49,17,476,7,3.48,483,16.79,0.52,0.54
5,90,13,474,4,1.87,478,11.53,0.53,0.55
5,90,13,474,4,1.87,478,11.53,0.53,0.55
5,90,13,474,4,1.87,478,11.53,0.53,0.55
5,90,13,474,4,1.87,478,11.53,0.53,0.55
5,90,13,474,4,1.87,478,11.53,0.53,0.55
6,891,53,465,4,2.16,469,12.04,0.53,0.55
6,891,53,465,4,2.16,469,12.04,0.53,0.55
6,891,53,465,4,2.16,469,12.04,0.53,0.55
6,891,53,465,4,2.16,469,12.04,0.53,0.55
6,891,53,465,4,2.16,469,12.04,0.53,0.55
12,181,37,479,12,6.15,491,25.56,0.5,0.53
12,181,37,479,12,6.15,491,25.56,0.5,0.53
12,181,37,479,12,6.15,491,25.56,0.5,0.53
12,181,37,479,12,6.15,491,25.56,0.5,0.53
12,181,37,479,12,6.15,491,25.56,0.5,0.53
0,19,50,498,12,6.12,510,25.51,0.5,0.53
0,19,50,498,12,6.12,510,25.51,0.5,0.53
0,19,50,498,12,6.12,510,25.51,0.5,0.53
0,19,50,498,12,6.12,510,25.51,0.5,0.53
0,19,50,498,12,6.12,510,25.51,0.5,0.53
3,78,61,486,6,3.09,492,15.3,0.52,0.54
3,78,61,486,6,3.09,492,15.3,0.52,0.54
3,78,61,486,6,3.09,492,15.3,0.52,0.54
3,78,61,486,6,3.09,492,15.3,0.52,0.54
3,78,61,486,6,3.09,492,15.3,0.52,0.54
4,31,67,506,8,3.85,514,18.25,0.52,0.54
4,31,67,506,8,3.85,514,18.25,0.52,0.54
4,31,67,506,8,3.85,514,18.25,0.52,0.54
4,31,67,506,8,3.85,514,18.25,0.52,0.54
4,31,67,506,8,3.85,514,18.25,0.52,0.54
5,100,13,499,3,1.52,502,10.1,0.54,0.55
5,100,13,499,3,1.52,502,10.1,0.54,0.55
5,100,13,499,3,1.52,502,10.1,0.54,0.55
5,100,13,499,3,1.52,502,10.1,0.54,0.55
5,100,13,499,3,1.52,502,10.1,0.54,0.55
7,879,24,498,6,3.02,504,15.18,0.52,0.54
7,879,24,498,6,3.02,504,15.18,0.52,0.54
7,879,24,498,6,3.02,504,15.18,0.52,0.54
7,879,24,498,6,3.02,504,15.18,0.52,0.54
7,879,24,498,6,3.02,504,15.18,0.52,0.54
14,38,63,489,18,8.83,507,35.11,0.47000000000000003,0.52
14,38,63,489,18,8.83,507,35.11,0.47000000000000003,0.52
14,38,63,489,18,8.83,507,35.11,0.47000000000000003,0.52
14,38,63,489,18,8.83,507,35.11,0.47000000000000003,0.52
14,38,63,489,18,8.83,507,35.11,0.47000000000000003,0.52
0,180,50,530,15,7.34,545,30.05,0.49,0.52
0,180,50,530,15,7.34,545,30.05,0.49,0.52
0,180,50,530,15,7.34,545,30.05,0.49,0.52
0,180,50,530,15,7.34,545,30.05,0.49,0.52
0,180,50,530,15,7.34,545,30.05,0.49,0.52
1,106,85,538,7,3.48,545,16.8,0.52,0.54
1,106,85,538,7,3.48,545,16.8,0.52,0.54
1,106,85,538,7,3.48,545,16.8,0.52,0.54
1,106,85,538,7,3.48,545,16.8,0.52,0.54
1,106,85,538,7,3.48,545,16.8,0.52,0.54
4,90,67,525,7,3.49,532,16.82,0.52,0.54
4,90,67,525,7,3.49,532,16.82,0.52,0.54
4,90,67,525,7,3.49,532,16.82,0.52,0.54
4,90,67,525,7,3.49,532,16.82,0.52,0.54
4,90,67,525,7,3.49,532,16.82,0.52,0.54
5,202,13,512,7,3.7,519,17.19,0.52,0.54
5,202,13,512,7,3.7,519,17.19,0.52,0.54
5,202,13,512,7,3.7,519,17.19,0.52,0.54
5,202,13,512,7,3.7,519,17.19,0.52,0.54
5,202,13,512,7,3.7,519,17.19,0.52,0.54
7,121,24,515,16,7.91,531,31.88,0.48,0.52
7,121,24,515,16,7.91,531,31.88,0.48,0.52
7,121,24,515,16,7.91,531,31.88,0.48,0.52
7,121,24,515,16,7.91,531,31.88,0.48,0.52
7,121,24,515,16,7.91,531,31.88,0.48,0.52
9,29,22,518,9,4.66,527,20.5,0.51,0.54
9,29,22,518,9,4.66,527,20.5,0.51,0.54
9,29,22,518,9,4.66,527,20.5,0.51,0.54
9,29,22,518,9,4.66,527,20.5,0.51,0.54
9,29,22,518,9,4.66,527,20.5,0.51,0.54
14,232,63,520,14,7.25,534,29.11,0.49,0.53
14,232,63,520,14,7.25,534,29.11,0.49,0.53
14,232,63,520,14,7.25,534,29.11,0.49,0.53
14,232,63,520,14,7.25,534,29.11,0.49,0.53
14,232,63,520,14,7.25,534,29.11,0.49,0.53
0,80,50,558,20,10.05,578,38.9,0.47000000000000003,0.51
0,80,50,558,20,10.05,578,38.9,0.47000000000000003,0.51
0,80,50,558,20,10.05,578,38.9,0.47000000000000003,0.51
0,80,50,558,20,10.05,578,38.9,0.47000000000000003,0.51
0,80,50,558,20,10.05,578,38.9,0.47000000000000003,0.51
1,38,85,551,9,4.64,560,20.46,0.51,0.54
1,38,85,551,9,4.64,560,20.46,0.51,0.54
1,38,85,551,9,4.64,560,20.46,0.51,0.54
1,38,85,551,9,4.64,560,20.46,0.51,0.54
1,38,85,551,9,4.64,560,20.46,0.51,0.54
3,236,61,565,11,5.64,576,23.85,0.5,0.53
3,236,61,565,11,5.64,576,23.85,0.5,0.53
3,236,61,565,11,5.64,576,23.85,0.5,0.53
3,236,61,565,11,5.64,576,23.85,0.5,0.53
3,236,61,565,11,5.64,576,23.85,0.5,0.53
4,957,67,572,8,3.91,580,18.36,0.52,0.54
4,957,67,572,8,3.91,580,18.36,0.52,0.54
4,957,67,572,8,3.91,580,18.36,0.52,0.54
4,957,67,572,8,3.91,580,18.36,0.52,0.54
4,957,67,572,8,3.91,580,18.36,0.52,0.54
5,925,13,571,9,4.59,580,20.37,0.51,0.54
5,925,13,571,9,4.59,580,20.37,0.51,0.54
5,925,13,571,9,4.59,580,20.37,0.51,0.54
5,925,13,571,9,4.59,580,20.37,0.51,0.54
5,925,13,571,9,4.59,580,20.37,0.51,0.54
7,846,24,617,18,8.81,635,35.07,0.47000000000000003,0.52
7,846,24,617,18,8.81,635,35.07,0.47000000000000003,0.52
7,846,24,617,18,8.81,635,35.07,0.47000000000000003,0.52
7,846,24,617,18,8.81,635,35.07,0.47000000000000003,0.52
7,846,24,617,18,8.81,635,35.07,0.47000000000000003,0.52
13,89,87,601,4,2.18,605,12.09,0.53,0.55
13,89,87,601,4,2.18,605,12.09,0.53,0.55
13,89,87,601,4,2.18,605,12.09,0.53,0.55
13,89,87,601,4,2.18,605,12.09,0.53,0.55
13,89,87,601,4,2.18,605,12.09,0.53,0.55
13,874,87,630,17,8.54,647,33.81,0.48,0.52
13,874,87,630,17,8.54,647,33.81,0.48,0.52
13,874,87,630,17,8.54,647,33.81,0.48,0.52
13,874,87,630,17,8.54,647,33.81,0.48,0.52
13,874,87,630,17,8.54,647,33.81,0.48,0.52
7,779,24,666,11,5.4,677,23.4,0.5,0.53
7,779,24,666,11,5.4,677,23.4,0.5,0.53
7,779,24,666,11,5.4,677,23.4,0.5,0.53
7,779,24,666,11,5.4,677,23.4,0.5,0.53
7,779,24,666,11,5.4,677,23.4,0.5,0.53
7,880,24,703,5,2.4,708,13.27,0.53,0.55
7,880,24,703,5,2.4,708,13.27,0.53,0.55
7,880,24,703,5,2.4,708,13.27,0.53,0.55
7,880,24,703,5,2.4,708,13.27,0.53,0.55
7,880,24,703,5,2.4,708,13.27,0.53,0.55
15,785,76,726,3,1.45,729,9.98,0.54,0.55
15,785,76,726,3,1.45,729,9.98,0.54,0.55
15,785,76,726,3,1.45,729,9.98,0.54,0.55
15,785,76,726,3,1.45,729,9.98,0.54,0.55
15,785,76,726,3,1.45,729,9.98,0.54,0.55
6,795,72,889,5,2.4,894,13.27,0.53,0.55
6,795,72,889,5,2.4,894,13.27,0.53,0.55
6,795,72,889,5,2.4,894,13.27,0.53,0.55
6,795,72,889,5,2.4,894,13.27,0.53,0.55
6,795,72,889,5,2.4,894,13.27,0.53,0.55
5,341,13,920,9,4.38,929,19.99,0.51,0.54
5,341,13,920,9,4.38,929,19.99,0.51,0.54
5,341,13,920,9,4.38,929,19.99,0.51,0.54
5,341,13,920,9,4.38,929,19.99,0.51,0.54
5,341,13,920,9,4.38,929,19.99,0.51,0.54
11,439,20,1014,10,5.03,1024,21.96,0.51,0.53
11,439,20,1014,10,5.03,1024,21.96,0.51,0.53
11,439,20,1014,10,5.03,1024,21.96,0.51,0.53
11,439,20,1014,10,5.03,1024,21.96,0.51,0.53
11,439,20,1014,10,5.03,1024,21.96,0.51,0.53
4,459,90,1053,10,4.81,1063,21.55,0.51,0.54
4,459,90,1053,10,4.81,1063,21.55,0.51,0.54
4,459,90,1053,10,4.81,1063,21.55,0.51,0.54
4,459,90,1053,10,4.81,1063,21.55,0.51,0.54
4,459,90,1053,10,4.81,1063,21.55,0.51,0.54
4,270,90,1081,17,8.69,1098,34.08,0.48,0.52
4,270,90,1081,17,8.69,1098,34.08,0.48,0.52
4,270,90,1081,17,8.69,1098,34.08,0.48,0.52
4,270,90,1081,17,8.69,1098,34.08,0.48,0.52
4,270,90,1081,17,8.69,1098,34.08,0.48,0.52
15,485,38,1106,7,3.34,1113,16.54,0.52,0.54
15,485,38,1106,7,3.34,1113,16.54,0.52,0.54
15,485,38,1106,7,3.34,1113,16.54,0.52,0.54
15,485,38,1106,7,3.34,1113,16.54,0.52,0.54
15,485,38,1106,7,3.34,1113,16.54,0.52,0.54
15,289,38,1110,15,7.59,1125,30.51,0.49,0.52
15,289,38,1110,15,7.59,1125,30.51,0.49,0.52
15,289,38,1110,15,7.59,1125,30.51,0.49,0.52
15,289,38,1110,15,7.59,1125,30.51,0.49,0.52
15,289,38,1110,15,7.59,1125,30.51,0.49,0.52
15,637,38,1191,18,8.78,1209,35.02,0.47000000000000003,0.52
15,637,38,1191,18,8.78,1209,35.02,0.47000000000000003,0.52
15,637,38,1191,18,8.78,1209,35.02,0.47000000000000003,0.52
15,637,38,1191,18,8.78,1209,35.02,0.47000000000000003,0.52
15,637,38,1191,18,8.78,1209,35.02,0.47000000000000003,0.52
15,732,38,1237,4,2.25,1241,12.21,0.53,0.55
15,732,38,1237,4,2.25,1241,12.21,0.53,0.55
15,732,38,1237,4,2.25,1241,12.21,0.53,0.55
15,732,38,1237,4,2.25,1241,12.21,0.53,0.55
15,732,38,1237,4,2.25,1241,12.21,0.53,0.55
15,621,38,1349,7,3.39,1356,16.63,0.52,0.54
15,621,38,1349,7,3.39,1356,16.63,0.52,0.54
15,621,38,1349,7,3.39,1356,16.63,0.52,0.54
15,621,38,1349,7,3.39,1356,16.63,0.52,0.54
15,621,38,1349,7,3.39,1356,16.63,0.52,0.54
14,524,63,1376,8,3.97,1384,18.47,0.52,0.54
14,524,63,1376,8,3.97,1384,18.47,0.52,0.54
14,524,63,1376,8,3.97,1384,18.47,0.52,0.54
14,524,63,1376,8,3.97,1384,18.47,0.52,0.54
14,524,63,1376,8,3.97,1384,18.47,0.52,0.54
15,741,38,1373,4,1.99,1377,11.74,0.53,0.55
15,741,38,1373,4,1.99,1377,11.74,0.53,0.55
15,741,38,1373,4,1.99,1377,11.74,0.53,0.55
15,741,38,1373,4,1.99,1377,11.74,0.53,0.55
15,741,38,1373,4,1.99,1377,11.74,0.53,0.55
9,937,91,74,6,3.16,80,15.44,0.52,0.54
9,937,91,74,6,3.16,80,15.44,0.52,0.54
9,937,91,74,6,3.16,80,15.44,0.52,0.54
9,937,91,74,6,3.16,80,15.44,0.52,0.54
9,937,91,74,6,3.16,80,15.44,0.52,0.54
9,937,91,74,6,3.16,80,15.44,0.52,0.54
10,938,47,318,7,3.45,325,16.74,0.52,0.54
10,938,47,318,7,3.45,325,16.74,0.52,0.54
10,938,47,318,7,3.45,325,16.74,0.52,0.54
10,938,47,318,7,3.45,325,16.74,0.52,0.54
10,938,47,318,7,3.45,325,16.74,0.52,0.54
10,938,47,318,7,3.45,325,16.74,0.52,0.54
3,910,76,369,6,3.24,375,15.57,0.52,0.54
3,910,76,369,6,3.24,375,15.57,0.52,0.54
3,910,76,369,6,3.24,375,15.57,0.52,0.54
3,910,76,369,6,3.24,375,15.57,0.52,0.54
3,910,76,369,6,3.24,375,15.57,0.52,0.54
3,910,76,369,6,3.24,375,15.57,0.52,0.54
15,143,29,360,2,1.23,362,8.81,0.54,0.55
15,143,29,360,2,1.23,362,8.81,0.54,0.55
15,143,29,360,2,1.23,362,8.81,0.54,0.55
15,143,29,360,2,1.23,362,8.81,0.54,0.55
15,143,29,360,2,1.23,362,8.81,0.54,0.55
15,143,29,360,2,1.23,362,8.81,0.54,0.55
8,95,28,394,17,8.49,411,33.71,0.48,0.52
8,95,28,394,17,8.49,411,33.71,0.48,0.52
8,95,28,394,17,8.49,411,33.71,0.48,0.52
8,95,28,394,17,8.49,411,33.71,0.48,0.52
8,95,28,394,17,8.49,411,33.71,0.48,0.52
8,95,28,394,17,8.49,411,33.71,0.48,0.52
15,236,29,410,13,6.37,423,26.73,0.5,0.53
15,236,29,410,13,6.37,423,26.73,0.5,0.53
15,236,29,410,13,6.37,423,26.73,0.5,0.53
15,236,29,410,13,6.37,423,26.73,0.5,0.53
15,236,29,410,13,6.37,423,26.73,0.5,0.53
15,236,29,410,13,6.37,423,26.73,0.5,0.53
5,91,65,421,6,2.95,427,15.04,0.52,0.54
5,91,65,421,6,2.95,427,15.04,0.52,0.54
5,91,65,421,6,2.95,427,15.04,0.52,0.54
5,91,65,421,6,2.95,427,15.04,0.52,0.54
5,91,65,421,6,2.95,427,15.04,0.52,0.54
5,91,65,421,6,2.95,427,15.04,0.52,0.54
7,134,37,440,14,7.02,454,28.71,0.49,0.53
7,134,37,440,14,7.02,454,28.71,0.49,0.53
7,134,37,440,14,7.02,454,28.71,0.49,0.53
7,134,37,440,14,7.02,454,28.71,0.49,0.53
7,134,37,440,14,7.02,454,28.71,0.49,0.53
7,134,37,440,14,7.02,454,28.71,0.49,0.53
3,187,76,451,15,7.53,466,30.41,0.49,0.52
3,187,76,451,15,7.53,466,30.41,0.49,0.52
3,187,76,451,15,7.53,466,30.41,0.49,0.52
3,187,76,451,15,7.53,466,30.41,0.49,0.52
3,187,76,451,15,7.53,466,30.41,0.49,0.52
3,187,76,451,15,7.53,466,30.41,0.49,0.52
7,212,37,458,9,4.67,467,20.53,0.51,0.54
7,212,37,458,9,4.67,467,20.53,0.51,0.54
7,212,37,458,9,4.67,467,20.53,0.51,0.54
7,212,37,458,9,4.67,467,20.53,0.51,0.54
7,212,37,458,9,4.67,467,20.53,0.51,0.54
7,212,37,458,9,4.67,467,20.53,0.51,0.54
1,169,54,486,17,8.74,503,34.17,0.48,0.52
1,169,54,486,17,8.74,503,34.17,0.48,0.52
1,169,54,486,17,8.74,503,34.17,0.48,0.52
1,169,54,486,17,8.74,503,34.17,0.48,0.52
1,169,54,486,17,8.74,503,34.17,0.48,0.52
1,169,54,486,17,8.74,503,34.17,0.48,0.52
6,145,36,482,5,2.41,487,13.28,0.53,0.55
6,145,36,482,5,2.41,487,13.28,0.53,0.55
6,145,36,482,5,2.41,487,13.28,0.53,0.55
6,145,36,482,5,2.41,487,13.28,0.53,0.55
6,145,36,482,5,2.41,487,13.28,0.53,0.55
6,145,36,482,5,2.41,487,13.28,0.53,0.55
15,998,29,502,19,9.26,521,36.66,0.47000000000000003,0.52
15,998,29,502,19,9.26,521,36.66,0.47000000000000003,0.52
15,998,29,502,19,9.26,521,36.66,0.47000000000000003,0.52
15,998,29,502,19,9.26,521,36.66,0.47000000000000003,0.52
15,998,29,502,19,9.26,521,36.66,0.47000000000000003,0.52
15,998,29,502,19,9.26,521,36.66,0.47000000000000003,0.52
1,31,54,524,15,7.71,539,30.72,0.49,0.52
1,31,54,524,15,7.71,539,30.72,0.49,0.52
1,31,54,524,15,7.71,539,30.72,0.49,0.52
1,31,54,524,15,7.71,539,30.72,0.49,0.52
1,31,54,524,15,7.71,539,30.72,0.49,0.52
1,31,54,524,15,7.71,539,30.72,0.49,0.52
12,121,56,515,9,4.67,524,20.52,0.51,0.54
12,121,56,515,9,4.67,524,20.52,0.51,0.54
12,121,56,515,9,4.67,524,20.52,0.51,0.54
12,121,56,515,9,4.67,524,20.52,0.51,0.54
12,121,56,515,9,4.67,524,20.52,0.51,0.54
12,121,56,515,9,4.67,524,20.52,0.51,0.54
10,130,9,540,3,1.61,543,10.26,0.54,0.55
10,130,9,540,3,1.61,543,10.26,0.54,0.55
10,130,9,540,3,1.61,543,10.26,0.54,0.55
10,130,9,540,3,1.61,543,10.26,0.54,0.55
10,130,9,540,3,1.61,543,10.26,0.54,0.55
10,130,9,540,3,1.61,543,10.26,0.54,0.55
1,833,54,579,5,2.61,584,13.65,0.53,0.55
1,833,54,579,5,2.61,584,13.65,0.53,0.55
1,833,54,579,5,2.61,584,13.65,0.53,0.55
1,833,54,579,5,2.61,584,13.65,0.53,0.55
1,833,54,579,5,2.61,584,13.65,0.53,0.55
1,833,54,579,5,2.61,584,13.65,0.53,0.55
15,217,29,576,13,6.59,589,27.13,0.49,0.53
15,217,29,576,13,6.59,589,27.13,0.49,0.53
15,217,29,576,13,6.59,589,27.13,0.49,0.53
15,217,29,576,13,6.59,589,27.13,0.49,0.53
15,217,29,576,13,6.59,589,27.13,0.49,0.53
15,217,29,576,13,6.59,589,27.13,0.49,0.53
15,779,29,862,16,8.04,878,32.12,0.48,0.52
15,779,29,862,16,8.04,878,32.12,0.48,0.52
15,779,29,862,16,8.04,878,32.12,0.48,0.52
15,779,29,862,16,8.04,878,32.12,0.48,0.52
15,779,29,862,16,8.04,878,32.12,0.48,0.52
15,779,29,862,16,8.04,878,32.12,0.48,0.52
15,802,29,951,13,6.35,964,26.69,0.5,0.53
15,802,29,951,13,6.35,964,26.69,0.5,0.53
15,802,29,951,13,6.35,964,26.69,0.5,0.53
15,802,29,951,13,6.35,964,26.69,0.5,0.53
15,802,29,951,13,6.35,964,26.69,0.5,0.53
15,802,29,951,13,6.35,964,26.69,0.5,0.53
1,964,54,1015,2,1.16,1017,8.67,0.54,0.55
1,964,54,1015,2,1.16,1017,8.67,0.54,0.55
1,964,54,1015,2,1.16,1017,8.67,0.54,0.55
1,964,54,1015,2,1.16,1017,8.67,0.54,0.55
1,964,54,1015,2,1.16,1017,8.67,0.54,0.55
1,964,54,1015,2,1.16,1017,8.67,0.54,0.55
13,437,80,1046,18,9.14,1064,35.67,0.47000000000000003,0.52
13,437,80,1046,18,9.14,1064,35.67,0.47000000000000003,0.52
13,437,80,1046,18,9.14,1064,35.67,0.47000000000000003,0.52
13,437,80,1046,18,9.14,1064,35.67,0.47000000000000003,0.52
13,437,80,1046,18,9.14,1064,35.67,0.47000000000000003,0.52
13,437,80,1046,18,9.14,1064,35.67,0.47000000000000003,0.52
10,297,9,1067,4,2.07,1071,11.88,0.53,0.55
10,297,9,1067,4,2.07,1071,11.88,0.53,0.55
10,297,9,1067,4,2.07,1071,11.88,0.53,0.55
10,297,9,1067,4,2.07,1071,11.88,0.53,0.55
10,297,9,1067,4,2.07,1071,11.88,0.53,0.55
10,297,9,1067,4,2.07,1071,11.88,0.53,0.55
11,390,32,1079,3,1.6300000000000001,1082,10.31,0.54,0.55
11,390,32,1079,3,1.6300000000000001,1082,10.31,0.54,0.55
11,390,32,1079,3,1.6300000000000001,1082,10.31,0.54,0.55
11,390,32,1079,3,1.6300000000000001,1082,10.31,0.54,0.55
11,390,32,1079,3,1.6300000000000001,1082,10.31,0.54,0.55
11,390,32,1079,3,1.6300000000000001,1082,10.31,0.54,0.55
13,358,80,1065,19,9.64,1084,37.36,0.47000000000000003,0.52
13,358,80,1065,19,9.64,1084,37.36,0.47000000000000003,0.52
13,358,80,1065,19,9.64,1084,37.36,0.47000000000000003,0.52
13,358,80,1065,19,9.64,1084,37.36,0.47000000000000003,0.52
13,358,80,1065,19,9.64,1084,37.36,0.47000000000000003,0.52
13,358,80,1065,19,9.64,1084,37.36,0.47000000000000003,0.52
1,357,54,1086,16,8.1,1102,32.22,0.48,0.52
1,357,54,1086,16,8.1,1102,32.22,0.48,0.52
1,357,54,1086,16,8.1,1102,32.22,0.48,0.52
1,357,54,1086,16,8.1,1102,32.22,0.48,0.52
1,357,54,1086,16,8.1,1102,32.22,0.48,0.52
1,357,54,1086,16,8.1,1102,32.22,0.48,0.52
13,358,80,1107,3,1.45,1110,9.97,0.54,0.55
13,358,80,1107,3,1.45,1110,9.97,0.54,0.55
13,358,80,1107,3,1.45,1110,9.97,0.54,0.55
13,358,80,1107,3,1.45,1110,9.97,0.54,0.55
13,358,80,1107,3,1.45,1110,9.97,0.54,0.55
13,358,80,1107,3,1.45,1110,9.97,0.54,0.55
1,424,54,1110,14,7.09,1124,28.82,0.49,0.53
1,424,54,1110,14,7.09,1124,28.82,0.49,0.53
1,424,54,1110,14,7.09,1124,28.82,0.49,0.53
1,424,54,1110,14,7.09,1124,28.82,0.49,0.53
1,424,54,1110,14,7.09,1124,28.82,0.49,0.53
1,424,54,1110,14,7.09,1124,28.82,0.49,0.53
13,383,80,1112,7,3.59,1119,16.99,0.52,0.54
13,383,80,1112,7,3.59,1119,16.99,0.52,0.54
13,383,80,1112,7,3.59,1119,16.99,0.52,0.54
13,383,80,1112,7,3.59,1119,16.99,0.52,0.54
13,383,80,1112,7,3.59,1119,16.99,0.52,0.54
13,383,80,1112,7,3.59,1119,16.99,0.52,0.54
1,442,54,1160,11,5.55,1171,23.68,0.5,0.53
1,442,54,1160,11,5.55,1171,23.68,0.5,0.53
1,442,54,1160,11,5.55,1171,23.68,0.5,0.53
1,442,54,1160,11,5.55,1171,23.68,0.5,0.53
1,442,54,1160,11,5.55,1171,23.68,0.5,0.53
1,442,54,1160,11,5.55,1171,23.68,0.5,0.53
2,458,43,1154,18,8.91,1172,35.26,0.47000000000000003,0.52
2,458,43,1154,18,8.91,1172,35.26,0.47000000000000003,0.52
2,458,43,1154,18,8.91,1172,35.26,0.47000000000000003,0.52
2,458,43,1154,18,8.91,1172,35.26,0.47000000000000003,0.52
2,458,43,1154,18,8.91,1172,35.26,0.47000000000000003,0.52
2,458,43,1154,18,8.91,1172,35.26,0.47000000000000003,0.52
11,940,32,1156,9,4.58,1165,20.36,0.51,0.54
11,940,32,1156,9,4.58,1165,20.36,0.51,0.54
11,940,32,1156,9,4.58,1165,20.36,0.51,0.54
11,940,32,1156,9,4.58,1165,20.36,0.51,0.54
11,940,32,1156,9,4.58,1165,20.36,0.51,0.54
11,940,32,1156,9,4.58,1165,20.36,0.51,0.54
13,260,80,1166,4,2.13,1170,11.99,0.53,0.55
13,260,80,1166,4,2.13,1170,11.99,0.53,0.55
13,260,80,1166,4,2.13,1170,11.99,0.53,0.55
13,260,80,1166,4,2.13,1170,11.99,0.53,0.55
13,260,80,1166,4,2.13,1170,11.99,0.53,0.55
13,260,80,1166,4,2.13,1170,11.99,0.53,0.55
1,727,54,1226,10,5.13,1236,22.13,0.51,0.53
1,727,54,1226,10,5.13,1236,22.13,0.51,0.53
1,727,54,1226,10,5.13,1236,22.13,0.51,0.53
1,727,54,1226,10,5.13,1236,22.13,0.51,0.53
1,727,54,1226,10,5.13,1236,22.13,0.51,0.53
1,727,54,1226,10,5.13,1236,22.13,0.51,0.53
2,779,43,1228,4,2.22,1232,12.17,0.53,0.55
2,779,43,1228,4,2.22,1232,12.17,0.53,0.55
2,779,43,1228,4,2.22,1232,12.17,0.53,0.55
2,779,43,1228,4,2.22,1232,12.17,0.53,0.55
2,779,43,1228,4,2.22,1232,12.17,0.53,0.55
2,779,43,1228,4,2.22,1232,12.17,0.53,0.55
1,559,54,1257,7,3.34,1264,16.53,0.52,0.54
1,559,54,1257,7,3.34,1264,16.53,0.52,0.54
1,559,54,1257,7,3.34,1264,16.53,0.52,0.54
1,559,54,1257,7,3.34,1264,16.53,0.52,0.54
1,559,54,1257,7,3.34,1264,16.53,0.52,0.54
1,559,54,1257,7,3.34,1264,16.53,0.52,0.54
2,804,43,1251,5,2.54,1256,13.52,0.53,0.55
2,804,43,1251,5,2.54,1256,13.52,0.53,0.55
2,804,43,1251,5,2.54,1256,13.52,0.53,0.55
2,804,43,1251,5,2.54,1256,13.52,0.53,0.55
2,804,43,1251,5,2.54,1256,13.52,0.53,0.55
2,804,43,1251,5,2.54,1256,13.52,0.53,0.55
3,295,2,1258,14,6.8,1272,28.3,0.49,0.53
3,295,2,1258,14,6.8,1272,28.3,0.49,0.53
3,295,2,1258,14,6.8,1272,28.3,0.49,0.53
3,295,2,1258,14,6.8,1272,28.3,0.49,0.53
3,295,2,1258,14,6.8,1272,28.3,0.49,0.53
3,295,2,1258,14,6.8,1272,28.3,0.49,0.53
2,606,43,1289,16,8.0,1305,32.05,0.48,0.52
2,606,43,1289,16,8.0,1305,32.05,0.48,0.52
2,606,43,1289,16,8.0,1305,32.05,0.48,0.52
2,606,43,1289,16,8.0,1305,32.05,0.48,0.52
2,606,43,1289,16,8.0,1305,32.05,0.48,0.52
2,606,43,1289,16,8.0,1305,32.05,0.48,0.52
5,635,44,1265,10,4.93,1275,21.77,0.51,0.54
5,635,44,1265,10,4.93,1275,21.77,0.51,0.54
5,635,44,1265,10,4.93,1275,21.77,0.51,0.54
5,635,44,1265,10,4.93,1275,21.77,0.51,0.54
5,635,44,1265,10,4.93,1275,21.77,0.51,0.54
5,635,44,1265,10,4.93,1275,21.77,0.51,0.54
2,568,43,1311,18,8.85,1329,35.15,0.47000000000000003,0.52
2,568,43,1311,18,8.85,1329,35.15,0.47000000000000003,0.52
2,568,43,1311,18,8.85,1329,35.15,0.47000000000000003,0.52
2,568,43,1311,18,8.85,1329,35.15,0.47000000000000003,0.52
2,568,43,1311,18,8.85,1329,35.15,0.47000000000000003,0.52
2,568,43,1311,18,8.85,1329,35.15,0.47000000000000003,0.52
3,524,2,1316,11,5.73,1327,24.01,0.5,0.53
3,524,2,1316,11,5.73,1327,24.01,0.5,0.53
3,524,2,1316,11,5.73,1327,24.01,0.5,0.53
3,524,2,1316,11,5.73,1327,24.01,0.5,0.53
3,524,2,1316,11,5.73,1327,24.01,0.5,0.53
3,524,2,1316,11,5.73,1327,24.01,0.5,0.53
5,565,44,1317,11,5.43,1328,23.46,0.5,0.53
5,565,44,1317,11,5.43,1328,23.46,0.5,0.53
5,565,44,1317,11,5.43,1328,23.46,0.5,0.53
5,565,44,1317,11,5.43,1328,23.46,0.5,0.53
5,565,44,1317,11,5.43,1328,23.46,0.5,0.53
5,565,44,1317,11,5.43,1328,23.46,0.5,0.53
2,618,43,1341,5,2.65,1346,13.72,0.53,0.55
2,618,43,1341,5,2.65,1346,13.72,0.53,0.55
2,618,43,1341,5,2.65,1346,13.72,0.53,0.55
2,618,43,1341,5,2.65,1346,13.72,0.53,0.55
2,618,43,1341,5,2.65,1346,13.72,0.53,0.55
2,618,43,1341,5,2.65,1346,13.72,0.53,0.55
5,517,44,1376,10,4.81,1386,21.56,0.51,0.54
5,517,44,1376,10,4.81,1386,21.56,0.51,0.54
5,517,44,1376,10,4.81,1386,21.56,0.51,0.54
5,517,44,1376,10,4.81,1386,21.56,0.51,0.54
5,517,44,1376,10,4.81,1386,21.56,0.51,0.54
5,517,44,1376,10,4.81,1386,21.56,0.51,0.54
2,713,43,1412,8,4.22,1420,18.92,0.52,0.54
2,713,43,1412,8,4.22,1420,18.92,0.52,0.54
2,713,43,1412,8,4.22,1420,18.92,0.52,0.54
2,713,43,1412,8,4.22,1420,18.92,0.52,0.54
2,713,43,1412,8,4.22,1420,18.92,0.52,0.54
2,713,43,1412,8,4.22,1420,18.92,0.52,0.54
3,865,28,318,9,4.35,327,19.93,0.51,0.54
3,865,28,318,9,4.35,327,19.93,0.51,0.54
3,865,28,318,9,4.35,327,19.93,0.51,0.54
3,865,28,318,9,4.35,327,19.93,0.51,0.54
3,865,28,318,9,4.35,327,19.93,0.51,0.54
3,865,28,318,9,4.35,327,19.93,0.51,0.54
3,865,28,318,9,4.35,327,19.93,0.51,0.54
6,958,3,336,8,3.86,344,18.26,0.52,0.54
6,958,3,336,8,3.86,344,18.26,0.52,0.54
6,958,3,336,8,3.86,344,18.26,0.52,0.54
6,958,3,336,8,3.86,344,18.26,0.52,0.54
6,958,3,336,8,3.86,344,18.26,0.52,0.54
6,958,3,336,8,3.86,344,18.26,0.52,0.54
6,958,3,336,8,3.86,344,18.26,0.52,0.54
3,982,28,364,16,7.94,380,31.94,0.48,0.52
3,982,28,364,16,7.94,380,31.94,0.48,0.52
3,982,28,364,16,7.94,380,31.94,0.48,0.52
3,982,28,364,16,7.94,380,31.94,0.48,0.52
3,982,28,364,16,7.94,380,31.94,0.48,0.52
3,982,28,364,16,7.94,380,31.94,0.48,0.52
3,982,28,364,16,7.94,380,31.94,0.48,0.52
4,202,67,384,15,7.36,399,30.09,0.49,0.52
4,202,67,384,15,7.36,399,30.09,0.49,0.52
4,202,67,384,15,7.36,399,30.09,0.49,0.52
4,202,67,384,15,7.36,399,30.09,0.49,0.52
4,202,67,384,15,7.36,399,30.09,0.49,0.52
4,202,67,384,15,7.36,399,30.09,0.49,0.52
4,202,67,384,15,7.36,399,30.09,0.49,0.52
6,761,3,376,7,3.35,383,16.55,0.52,0.54
6,761,3,376,7,3.35,383,16.55,0.52,0.54
6,761,3,376,7,3.35,383,16.55,0.52,0.54
6,761,3,376,7,3.35,383,16.55,0.52,0.54
6,761,3,376,7,3.35,383,16.55,0.52,0.54
6,761,3,376,7,3.35,383,16.55,0.52,0.54
6,761,3,376,7,3.35,383,16.55,0.52,0.54
4,137,67,392,3,1.74,395,10.51,0.54,0.55
4,137,67,392,3,1.74,395,10.51,0.54,0.55
4,137,67,392,3,1.74,395,10.51,0.54,0.55
4,137,67,392,3,1.74,395,10.51,0.54,0.55
4,137,67,392,3,1.74,395,10.51,0.54,0.55
4,137,67,392,3,1.74,395,10.51,0.54,0.55
4,137,67,392,3,1.74,395,10.51,0.54,0.55
7,141,25,390,17,8.69,407,34.08,0.48,0.52
7,141,25,390,17,8.69,407,34.08,0.48,0.52
7,141,25,390,17,8.69,407,34.08,0.48,0.52
7,141,25,390,17,8.69,407,34.08,0.48,0.52
7,141,25,390,17,8.69,407,34.08,0.48,0.52
7,141,25,390,17,8.69,407,34.08,0.48,0.52
7,141,25,390,17,8.69,407,34.08,0.48,0.52
6,77,3,433,5,2.49,438,13.43,0.53,0.55
6,77,3,433,5,2.49,438,13.43,0.53,0.55
6,77,3,433,5,2.49,438,13.43,0.53,0.55
6,77,3,433,5,2.49,438,13.43,0.53,0.55
6,77,3,433,5,2.49,438,13.43,0.53,0.55
6,77,3,433,5,2.49,438,13.43,0.53,0.55
6,77,3,433,5,2.49,438,13.43,0.53,0.55
7,112,25,444,12,5.87,456,25.04,0.5,0.53
7,112,25,444,12,5.87,456,25.04,0.5,0.53
7,112,25,444,12,5.87,456,25.04,0.5,0.53
7,112,25,444,12,5.87,456,25.04,0.5,0.53
7,112,25,444,12,5.87,456,25.04,0.5,0.53
7,112,25,444,12,5.87,456,25.04,0.5,0.53
7,112,25,444,12,5.87,456,25.04,0.5,0.53
11,187,85,444,15,7.6,459,30.53,0.49,0.52
11,187,85,444,15,7.6,459,30.53,0.49,0.52
11,187,85,444,15,7.6,459,30.53,0.49,0.52
11,187,85,444,15,7.6,459,30.53,0.49,0.52
11,187,85,444,15,7.6,459,30.53,0.49,0.52
11,187,85,444,15,7.6,459,30.53,0.49,0.52
11,187,85,444,15,7.6,459,30.53,0.49,0.52
1,121,63,466,14,7.17,480,28.98,0.49,0.53
1,121,63,466,14,7.17,480,28.98,0.49,0.53
1,121,63,466,14,7.17,480,28.98,0.49,0.53
1,121,63,466,14,7.17,480,28.98,0.49,0.53
1,121,63,466,14,7.17,480,28.98,0.49,0.53
1,121,63,466,14,7.17,480,28.98,0.49,0.53
1,121,63,466,14,7.17,480,28.98,0.49,0.53
6,29,3,478,9,4.55,487,20.3,0.51,0.54
6,29,3,478,9,4.55,487,20.3,0.51,0.54
6,29,3,478,9,4.55,487,20.3,0.51,0.54
6,29,3,478,9,4.55,487,20.3,0.51,0.54
6,29,3,478,9,4.55,487,20.3,0.51,0.54
6,29,3,478,9,4.55,487,20.3,0.51,0.54
6,29,3,478,9,4.55,487,20.3,0.51,0.54
1,63,63,501,8,3.99,509,18.5,0.52,0.54
1,63,63,501,8,3.99,509,18.5,0.52,0.54
1,63,63,501,8,3.99,509,18.5,0.52,0.54
1,63,63,501,8,3.99,509,18.5,0.52,0.54
1,63,63,501,8,3.99,509,18.5,0.52,0.54
1,63,63,501,8,3.99,509,18.5,0.52,0.54
1,63,63,501,8,3.99,509,18.5,0.52,0.54
7,786,25,496,4,2.21,500,12.15,0.53,0.55
7,786,25,496,4,2.21,500,12.15,0.53,0.55
7,786,25,496,4,2.21,500,12.15,0.53,0.55
7,786,25,496,4,2.21,500,12.15,0.53,0.55
7,786,25,496,4,2.21,500,12.15,0.53,0.55
7,786,25,496,4,2.21,500,12.15,0.53,0.55
7,786,25,496,4,2.21,500,12.15,0.53,0.55
11,133,85,481,10,5.0,491,21.9,0.51,0.54
11,133,85,481,10,5.0,491,21.9,0.51,0.54
11,133,85,481,10,5.0,491,21.9,0.51,0.54
11,133,85,481,10,5.0,491,21.9,0.51,0.54
11,133,85,481,10,5.0,491,21.9,0.51,0.54
11,133,85,481,10,5.0,491,21.9,0.51,0.54
11,133,85,481,10,5.0,491,21.9,0.51,0.54
15,144,71,483,18,8.81,501,35.08,0.47000000000000003,0.52
15,144,71,483,18,8.81,501,35.08,0.47000000000000003,0.52
15,144,71,483,18,8.81,501,35.08,0.47000000000000003,0.52
15,144,71,483,18,8.81,501,35.08,0.47000000000000003,0.52
15,144,71,483,18,8.81,501,35.08,0.47000000000000003,0.52
15,144,71,483,18,8.81,501,35.08,0.47000000000000003,0.52
15,144,71,483,18,8.81,501,35.08,0.47000000000000003,0.52
6,98,3,529,4,2.15,533,12.03,0.53,0.55
6,98,3,529,4,2.15,533,12.03,0.53,0.55
6,98,3,529,4,2.15,533,12.03,0.53,0.55
6,98,3,529,4,2.15,533,12.03,0.53,0.55
6,98,3,529,4,2.15,533,12.03,0.53,0.55
6,98,3,529,4,2.15,533,12.03,0.53,0.55
6,98,3,529,4,2.15,533,12.03,0.53,0.55
11,929,85,539,3,1.7,542,10.43,0.54,0.55
11,929,85,539,3,1.7,542,10.43,0.54,0.55
11,929,85,539,3,1.7,542,10.43,0.54,0.55
11,929,85,539,3,1.7,542,10.43,0.54,0.55
11,929,85,539,3,1.7,542,10.43,0.54,0.55
11,929,85,539,3,1.7,542,10.43,0.54,0.55
11,929,85,539,3,1.7,542,10.43,0.54,0.55
15,62,71,519,9,4.34,528,19.92,0.51,0.54
15,62,71,519,9,4.34,528,19.92,0.51,0.54
15,62,71,519,9,4.34,528,19.92,0.51,0.54
15,62,71,519,9,4.34,528,19.92,0.51,0.54
15,62,71,519,9,4.34,528,19.92,0.51,0.54
15,62,71,519,9,4.34,528,19.92,0.51,0.54
15,62,71,519,9,4.34,528,19.92,0.51,0.54
1,4,63,555,4,2.04,559,11.83,0.53,0.55
1,4,63,555,4,2.04,559,11.83,0.53,0.55
1,4,63,555,4,2.04,559,11.83,0.53,0.55
1,4,63,555,4,2.04,559,11.83,0.53,0.55
1,4,63,555,4,2.04,559,11.83,0.53,0.55
1,4,63,555,4,2.04,559,11.83,0.53,0.55
1,4,63,555,4,2.04,559,11.83,0.53,0.55
11,183,85,559,13,6.46,572,26.89,0.5,0.53
11,183,85,559,13,6.46,572,26.89,0.5,0.53
11,183,85,559,13,6.46,572,26.89,0.5,0.53
11,183,85,559,13,6.46,572,26.89,0.5,0.53
11,183,85,559,13,6.46,572,26.89,0.5,0.53
11,183,85,559,13,6.46,572,26.89,0.5,0.53
11,183,85,559,13,6.46,572,26.89,0.5,0.53
5,126,91,572,6,3.22,578,15.55,0.52,0.54
5,126,91,572,6,3.22,578,15.55,0.52,0.54
5,126,91,572,6,3.22,578,15.55,0.52,0.54
5,126,91,572,6,3.22,578,15.55,0.52,0.54
5,126,91,572,6,3.22,578,15.55,0.52,0.54
5,126,91,572,6,3.22,578,15.55,0.52,0.54
5,126,91,572,6,3.22,578,15.55,0.52,0.54
11,937,85,669,4,2.22,673,12.17,0.53,0.55
11,937,85,669,4,2.22,673,12.17,0.53,0.55
11,937,85,669,4,2.22,673,12.17,0.53,0.55
11,937,85,669,4,2.22,673,12.17,0.53,0.55
11,937,85,669,4,2.22,673,12.17,0.53,0.55
11,937,85,669,4,2.22,673,12.17,0.53,0.55
11,937,85,669,4,2.22,673,12.17,0.53,0.55
13,913,27,666,11,5.69,677,23.93,0.5,0.53
13,913,27,666,11,5.69,677,23.93,0.5,0.53
13,913,27,666,11,5.69,677,23.93,0.5,0.53
13,913,27,666,11,5.69,677,23.93,0.5,0.53
13,913,27,666,11,5.69,677,23.93,0.5,0.53
13,913,27,666,11,5.69,677,23.93,0.5,0.53
13,913,27,666,11,5.69,677,23.93,0.5,0.53
11,919,85,743,20,9.89,763,38.61,0.47000000000000003,0.51
11,919,85,743,20,9.89,763,38.61,0.47000000000000003,0.51
11,919,85,743,20,9.89,763,38.61,0.47000000000000003,0.51
11,919,85,743,20,9.89,763,38.61,0.47000000000000003,0.51
11,919,85,743,20,9.89,763,38.61,0.47000000000000003,0.51
11,919,85,743,20,9.89,763,38.61,0.47000000000000003,0.51
11,919,85,743,20,9.89,763,38.61,0.47000000000000003,0.51
6,848,3,855,0,0.24,855,5.43,0.55,0.56
6,848,3,855,0,0.24,855,5.43,0.55,0.56
6,848,3,855,0,0.24,855,5.43,0.55,0.56
6,848,3,855,0,0.24,855,5.43,0.55,0.56
6,848,3,855,0,0.24,855,5.43,0.55,0.56
6,848,3,855,0,0.24,855,5.43,0.55,0.56
6,848,3,855,0,0.24,855,5.43,0.55,0.56
10,443,40,1042,11,5.53,1053,23.64,0.5,0.53
10,443,40,1042,11,5.53,1053,23.64,0.5,0.53
10,443,40,1042,11,5.53,1053,23.64,0.5,0.53
10,443,40,1042,11,5.53,1053,23.64,0.5,0.53
10,443,40,1042,11,5.53,1053,23.64,0.5,0.53
10,443,40,1042,11,5.53,1053,23.64,0.5,0.53
10,443,40,1042,11,5.53,1053,23.64,0.5,0.53
10,334,40,1060,10,4.92,1070,21.76,0.51,0.54
10,334,40,1060,10,4.92,1070,21.76,0.51,0.54
10,334,40,1060,10,4.92,1070,21.76,0.51,0.54
10,334,40,1060,10,4.92,1070,21.76,0.51,0.54
10,334,40,1060,10,4.92,1070,21.76,0.51,0.54
10,334,40,1060,10,4.92,1070,21.76,0.51,0.54
10,334,40,1060,10,4.92,1070,21.76,0.51,0.54
12,393,77,1126,15,7.65,1141,30.61,0.49,0.52
12,393,77,1126,15,7.65,1141,30.61,0.49,0.52
12,393,77,1126,15,7.65,1141,30.61,0.49,0.52
12,393,77,1126,15,7.65,1141,30.61,0.49,0.52
12,393,77,1126,15,7.65,1141,30.61,0.49,0.52
12,393,77,1126,15,7.65,1141,30.61,0.49,0.52
12,393,77,1126,15,7.65,1141,30.61,0.49,0.52
10,998,40,1167,14,6.75,1181,28.21,0.49,0.53
10,998,40,1167,14,6.75,1181,28.21,0.49,0.53
10,998,40,1167,14,6.75,1181,28.21,0.49,0.53
10,998,40,1167,14,6.75,1181,28.21,0.49,0.53
10,998,40,1167,14,6.75,1181,28.21,0.49,0.53
10,998,40,1167,14,6.75,1181,28.21,0.49,0.53
10,998,40,1167,14,6.75,1181,28.21,0.49,0.53
12,359,77,1143,6,3.19,1149,15.48,0.52,0.54
12,359,77,1143,6,3.19,1149,15.48,0.52,0.54
12,359,77,1143,6,3.19,1149,15.48,0.52,0.54
12,359,77,1143,6,3.19,1149,15.48,0.52,0.54
12,359,77,1143,6,3.19,1149,15.48,0.52,0.54
12,359,77,1143,6,3.19,1149,15.48,0.52,0.54
12,359,77,1143,6,3.19,1149,15.48,0.52,0.54
13,382,27,1146,11,5.71,1157,23.97,0.5,0.53
13,382,27,1146,11,5.71,1157,23.97,0.5,0.53
13,382,27,1146,11,5.71,1157,23.97,0.5,0.53
13,382,27,1146,11,5.71,1157,23.97,0.5,0.53
13,382,27,1146,11,5.71,1157,23.97,0.5,0.53
13,382,27,1146,11,5.71,1157,23.97,0.5,0.53
13,382,27,1146,11,5.71,1157,23.97,0.5,0.53
12,632,77,1214,8,4.25,1222,18.97,0.52,0.54
12,632,77,1214,8,4.25,1222,18.97,0.52,0.54
12,632,77,1214,8,4.25,1222,18.97,0.52,0.54
12,632,77,1214,8,4.25,1222,18.97,0.52,0.54
12,632,77,1214,8,4.25,1222,18.97,0.52,0.54
12,632,77,1214,8,4.25,1222,18.97,0.52,0.54
12,632,77,1214,8,4.25,1222,18.97,0.52,0.54
13,813,27,1206,18,9.16,1224,35.71,0.47000000000000003,0.52
13,813,27,1206,18,9.16,1224,35.71,0.47000000000000003,0.52
13,813,27,1206,18,9.16,1224,35.71,0.47000000000000003,0.52
13,813,27,1206,18,9.16,1224,35.71,0.47000000000000003,0.52
13,813,27,1206,18,9.16,1224,35.71,0.47000000000000003,0.52
13,813,27,1206,18,9.16,1224,35.71,0.47000000000000003,0.52
13,813,27,1206,18,9.16,1224,35.71,0.47000000000000003,0.52
0,505,12,1241,4,2.24,1245,12.21,0.53,0.55
0,505,12,1241,4,2.24,1245,12.21,0.53,0.55
0,505,12,1241,4,2.24,1245,12.21,0.53,0.55
0,505,12,1241,4,2.24,1245,12.21,0.53,0.55
0,505,12,1241,4,2.24,1245,12.21,0.53,0.55
0,505,12,1241,4,2.24,1245,12.21,0.53,0.55
0,505,12,1241,4,2.24,1245,12.21,0.53,0.55
10,640,40,1230,6,3.04,1236,15.21,0.52,0.54
10,640,40,1230,6,3.04,1236,15.21,0.52,0.54
10,640,40,1230,6,3.04,1236,15.21,0.52,0.54
10,640,40,1230,6,3.04,1236,15.21,0.52,0.54
10,640,40,1230,6,3.04,1236,15.21,0.52,0.54
10,640,40,1230,6,3.04,1236,15.21,0.52,0.54
10,640,40,1230,6,3.04,1236,15.21,0.52,0.54
12,565,77,1252,13,6.42,1265,26.83,0.5,0.53
12,565,77,1252,13,6.42,1265,26.83,0.5,0.53
12,565,77,1252,13,6.42,1265,26.83,0.5,0.53
12,565,77,1252,13,6.42,1265,26.83,0.5,0.53
12,565,77,1252,13,6.42,1265,26.83,0.5,0.53
12,565,77,1252,13,6.42,1265,26.83,0.5,0.53
12,565,77,1252,13,6.42,1265,26.83,0.5,0.53
2,622,81,1362,6,2.93,1368,15.01,0.52,0.54
2,622,81,1362,6,2.93,1368,15.01,0.52,0.54
2,622,81,1362,6,2.93,1368,15.01,0.52,0.54
2,622,81,1362,6,2.93,1368,15.01,0.52,0.54
2,622,81,1362,6,2.93,1368,15.01,0.52,0.54
2,622,81,1362,6,2.93,1368,15.01,0.52,0.54
2,622,81,1362,6,2.93,1368,15.01,0.52,0.54
2,569,81,1389,13,6.49,1402,26.96,0.5,0.53
2,569,81,1389,13,6.49,1402,26.96,0.5,0.53
2,569,81,1389,13,6.49,1402,26.96,0.5,0.53
2,569,81,1389,13,6.49,1402,26.96,0.5,0.53
2,569,81,1389,13,6.49,1402,26.96,0.5,0.53
2,569,81,1389,13,6.49,1402,26.96,0.5,0.53
2,569,81,1389,13,6.49,1402,26.96,0.5,0.53
4,989,24,1399,1,0.6000000000000001,1400,6.87,0.55,0.55
4,989,24,1399,1,0.6000000000000001,1400,6.87,0.55,0.55
4,989,24,1399,1,0.6000000000000001,1400,6.87,0.55,0.55
4,989,24,1399,1,0.6000000000000001,1400,6.87,0.55,0.55
4,989,24,1399,1,0.6000000000000001,1400,6.87,0.55,0.55
4,989,24,1399,1,0.6000000000000001,1400,6.87,0.55,0.55
4,989,24,1399,1,0.6000000000000001,1400,6.87,0.55,0.55
