square_index,rider_id,driver_idx,trip_start_timestamp,trip_duration,ride_miles,trip_end_timestamp,price_of_ride,rider_acceptance_prob,driver_acceptance_prob
6,801,51,213,5,2.64,218,13.7,0.53,0.55
1,131,47,311,16,8.19,327,32.39,0.48,0.52
15,877,58,325,22,10.88,347,41.96,0.46,0.51
15,52,58,356,16,8.19,372,32.38,0.48,0.52
15,839,58,388,12,5.83,400,24.96,0.5,0.53
6,242,51,416,12,5.94,428,25.17,0.5,0.53
8,99,90,444,11,5.57,455,23.71,0.5,0.53
11,111,67,448,20,9.91,468,38.64,0.47000000000000003,0.51
1,192,47,450,16,7.86,466,31.79,0.48,0.52
6,92,51,478,8,3.82,486,18.19,0.52,0.54
8,36,90,460,10,5.14,470,22.16,0.51,0.53
1,177,47,497,1,0.41000000000000003,498,6.53,0.55,0.55
5,138,45,485,11,5.31,496,23.25,0.5,0.53
8,10,90,502,4,1.94,506,11.65,0.53,0.55
9,211,30,495,10,4.88,505,21.68,0.51,0.54
5,181,45,530,8,3.88,538,18.31,0.52,0.54
6,163,51,517,11,5.54,528,23.66,0.5,0.53
8,234,90,519,6,3.11,525,15.34,0.52,0.54
9,170,30,523,8,4.15,531,18.8,0.52,0.54
11,41,67,537,11,5.32,548,23.26,0.5,0.53
1,818,47,555,14,7.24,569,29.09,0.49,0.53
6,249,51,545,10,5.21,555,22.28,0.51,0.53
12,855,76,557,14,6.8,571,28.29,0.49,0.53
2,972,18,574,12,5.85,586,25.01,0.5,0.53
5,189,45,620,2,0.78,622,7.98,0.54,0.55
11,3,67,613,18,9.03,631,35.47,0.47000000000000003,0.52
8,862,90,647,7,3.56,654,16.94,0.52,0.54
8,760,90,665,15,7.37,680,30.12,0.49,0.52
12,762,76,676,20,9.91,696,38.63,0.47000000000000003,0.51
2,821,18,739,12,6.16,751,25.57,0.5,0.53
10,957,73,727,4,1.92,731,11.61,0.53,0.55
15,964,35,889,9,4.65,898,20.48,0.51,0.54
11,394,67,1013,19,9.49,1032,37.1,0.47000000000000003,0.52
11,369,67,1038,8,3.81,1046,18.17,0.52,0.54
7,327,88,1144,3,1.25,1147,9.62,0.54,0.55
10,687,48,1326,8,3.78,1334,18.12,0.52,0.54
10,708,48,1357,4,1.79,1361,11.38,0.53,0.55
0,812,98,84,18,8.87,102,35.18,0.47000000000000003,0.52
0,812,98,84,18,8.87,102,35.18,0.47000000000000003,0.52
6,974,6,282,3,1.42,285,9.92,0.54,0.55
6,974,6,282,3,1.42,285,9.92,0.54,0.55
4,65,57,378,18,8.8,396,35.06,0.47000000000000003,0.52
4,65,57,378,18,8.8,396,35.06,0.47000000000000003,0.52
5,87,42,384,3,1.46,387,10.0,0.54,0.55
5,87,42,384,3,1.46,387,10.0,0.54,0.55
13,67,95,371,14,7.19,385,29.0,0.49,0.53
13,67,95,371,14,7.19,385,29.0,0.49,0.53
5,155,42,412,5,2.33,417,13.14,0.53,0.55
5,155,42,412,5,2.33,417,13.14,0.53,0.55
5,85,42,420,9,4.35,429,19.94,0.51,0.54
5,85,42,420,9,4.35,429,19.94,0.51,0.54
6,73,6,436,12,5.84,448,24.99,0.5,0.53
6,73,6,436,12,5.84,448,24.99,0.5,0.53
10,164,15,445,10,4.83,455,21.59,0.51,0.54
10,164,15,445,10,4.83,455,21.59,0.51,0.54
11,192,41,428,7,3.67,435,17.15,0.52,0.54
11,192,41,428,7,3.67,435,17.15,0.52,0.54
13,136,95,441,14,7.09,455,28.82,0.49,0.53
13,136,95,441,14,7.09,455,28.82,0.49,0.53
4,211,57,478,10,5.09,488,22.06,0.51,0.53
4,211,57,478,10,5.09,488,22.06,0.51,0.53
6,211,6,461,5,2.26,466,13.0,0.53,0.55
6,211,6,461,5,2.26,466,13.0,0.53,0.55
10,49,15,476,7,3.64,483,17.08,0.52,0.54
10,49,15,476,7,3.64,483,17.08,0.52,0.54
11,155,41,459,17,8.54,476,33.81,0.48,0.52
11,155,41,459,17,8.54,476,33.81,0.48,0.52
12,192,1,459,19,9.43,478,36.99,0.47000000000000003,0.52
12,192,1,459,19,9.43,478,36.99,0.47000000000000003,0.52
6,13,6,483,6,3.2,489,15.5,0.52,0.54
6,13,6,483,6,3.2,489,15.5,0.52,0.54
15,188,51,483,16,8.13,499,32.27,0.48,0.52
15,188,51,483,16,8.13,499,32.27,0.48,0.52
1,90,36,539,6,3.13,545,15.37,0.52,0.54
1,90,36,539,6,3.13,545,15.37,0.52,0.54
6,140,6,536,5,2.35,541,13.17,0.53,0.55
6,140,6,536,5,2.35,541,13.17,0.53,0.55
1,100,36,545,15,7.65,560,30.62,0.49,0.52
1,100,36,545,15,7.65,560,30.62,0.49,0.52
6,73,6,545,7,3.75,552,17.28,0.52,0.54
6,73,6,545,7,3.75,552,17.28,0.52,0.54
7,51,8,566,9,4.39,575,20.01,0.51,0.54
7,51,8,566,9,4.39,575,20.01,0.51,0.54
12,65,1,550,13,6.28,563,26.57,0.5,0.53
12,65,1,550,13,6.28,563,26.57,0.5,0.53
12,984,1,599,5,2.69,604,13.8,0.53,0.55
12,984,1,599,5,2.69,604,13.8,0.53,0.55
15,10,51,590,3,1.57,593,10.19,0.54,0.55
15,10,51,590,3,1.57,593,10.19,0.54,0.55
13,974,2,765,1,0.30000000000000004,766,6.33,0.55,0.55
13,974,2,765,1,0.30000000000000004,766,6.33,0.55,0.55
9,955,60,896,4,1.84,900,11.46,0.53,0.55
9,955,60,896,4,1.84,900,11.46,0.53,0.55
9,976,60,959,9,4.27,968,19.78,0.51,0.54
9,976,60,959,9,4.27,968,19.78,0.51,0.54
9,339,60,1013,14,6.8,1027,28.3,0.49,0.53
9,339,60,1013,14,6.8,1027,28.3,0.49,0.53
9,380,60,1048,15,7.36,1063,30.09,0.49,0.52
9,380,60,1048,15,7.36,1063,30.09,0.49,0.52
8,370,94,1106,9,4.48,1115,20.17,0.51,0.54
8,370,94,1106,9,4.48,1115,20.17,0.51,0.54
9,417,60,1096,10,5.06,1106,22.0,0.51,0.53
9,417,60,1096,10,5.06,1106,22.0,0.51,0.53
8,997,94,1111,6,2.82,1117,14.82,0.53,0.54
8,997,94,1111,6,2.82,1117,14.82,0.53,0.54
9,338,60,1166,6,3.04,1172,15.21,0.52,0.54
9,338,60,1166,6,3.04,1172,15.21,0.52,0.54
11,369,81,1154,6,2.81,1160,14.79,0.53,0.54
11,369,81,1154,6,2.81,1160,14.79,0.53,0.54
7,491,8,1196,18,9.23,1214,35.84,0.47000000000000003,0.52
7,491,8,1196,18,9.23,1214,35.84,0.47000000000000003,0.52
9,258,60,1192,10,4.93,1202,21.77,0.51,0.54
9,258,60,1192,10,4.93,1202,21.77,0.51,0.54
11,906,81,1200,15,7.56,1215,30.46,0.49,0.52
11,906,81,1200,15,7.56,1215,30.46,0.49,0.52
1,656,5,1259,18,8.99,1277,35.4,0.47000000000000003,0.52
1,656,5,1259,18,8.99,1277,35.4,0.47000000000000003,0.52
1,595,5,1283,18,9.11,1301,35.62,0.47000000000000003,0.52
1,595,5,1283,18,9.11,1301,35.62,0.47000000000000003,0.52
11,543,81,1274,15,7.3,1289,29.99,0.49,0.52
11,543,81,1274,15,7.3,1289,29.99,0.49,0.52
1,525,5,1291,8,3.85,1299,18.25,0.52,0.54
1,525,5,1291,8,3.85,1299,18.25,0.52,0.54
5,927,42,1299,4,2.01,1303,11.78,0.53,0.55
5,927,42,1299,4,2.01,1303,11.78,0.53,0.55
9,594,60,1303,1,0.58,1304,6.84,0.55,0.55
9,594,60,1303,1,0.58,1304,6.84,0.55,0.55
11,726,81,1313,2,0.8,1315,8.01,0.54,0.55
11,726,81,1313,2,0.8,1315,8.01,0.54,0.55
5,536,42,1321,9,4.62,1330,20.44,0.51,0.54
5,536,42,1321,9,4.62,1330,20.44,0.51,0.54
5,989,73,154,9,4.41,163,20.05,0.51,0.54
5,989,73,154,9,4.41,163,20.05,0.51,0.54
5,989,73,154,9,4.41,163,20.05,0.51,0.54
5,790,73,202,7,3.32,209,16.5,0.52,0.54
5,790,73,202,7,3.32,209,16.5,0.52,0.54
5,790,73,202,7,3.32,209,16.5,0.52,0.54
13,990,3,269,12,6.16,281,25.58,0.5,0.53
13,990,3,269,12,6.16,281,25.58,0.5,0.53
13,990,3,269,12,6.16,281,25.58,0.5,0.53
5,813,73,328,4,2.21,332,12.14,0.53,0.55
5,813,73,328,4,2.21,332,12.14,0.53,0.55
5,813,73,328,4,2.21,332,12.14,0.53,0.55
3,91,55,382,13,6.46,395,26.9,0.5,0.53
3,91,55,382,13,6.46,395,26.9,0.5,0.53
3,91,55,382,13,6.46,395,26.9,0.5,0.53
8,156,69,361,8,4.24,369,18.95,0.52,0.54
8,156,69,361,8,4.24,369,18.95,0.52,0.54
8,156,69,361,8,4.24,369,18.95,0.52,0.54
12,140,16,376,7,3.52,383,16.87,0.52,0.54
12,140,16,376,7,3.52,383,16.87,0.52,0.54
12,140,16,376,7,3.52,383,16.87,0.52,0.54
0,17,72,393,12,6.06,405,25.4,0.5,0.53
0,17,72,393,12,6.06,405,25.4,0.5,0.53
0,17,72,393,12,6.06,405,25.4,0.5,0.53
2,806,0,409,15,7.39,424,30.15,0.49,0.52
2,806,0,409,15,7.39,424,30.15,0.49,0.52
2,806,0,409,15,7.39,424,30.15,0.49,0.52
5,78,73,419,11,5.56,430,23.7,0.5,0.53
5,78,73,419,11,5.56,430,23.7,0.5,0.53
5,78,73,419,11,5.56,430,23.7,0.5,0.53
14,815,6,393,8,3.86,401,18.26,0.52,0.54
14,815,6,393,8,3.86,401,18.26,0.52,0.54
14,815,6,393,8,3.86,401,18.26,0.52,0.54
4,51,68,441,9,4.32,450,19.89,0.51,0.54
4,51,68,441,9,4.32,450,19.89,0.51,0.54
4,51,68,441,9,4.32,450,19.89,0.51,0.54
8,35,69,431,8,4.19,439,18.86,0.52,0.54
8,35,69,431,8,4.19,439,18.86,0.52,0.54
8,35,69,431,8,4.19,439,18.86,0.52,0.54
11,91,42,432,14,7.18,446,29.0,0.49,0.53
11,91,42,432,14,7.18,446,29.0,0.49,0.53
11,91,42,432,14,7.18,446,29.0,0.49,0.53
12,67,16,444,12,6.19,456,25.63,0.5,0.53
12,67,16,444,12,6.19,456,25.63,0.5,0.53
12,67,16,444,12,6.19,456,25.63,0.5,0.53
0,242,72,466,15,7.63,481,30.6,0.49,0.52
0,242,72,466,15,7.63,481,30.6,0.49,0.52
0,242,72,466,15,7.63,481,30.6,0.49,0.52
3,185,55,453,14,6.88,467,28.44,0.49,0.53
3,185,55,453,14,6.88,467,28.44,0.49,0.53
3,185,55,453,14,6.88,467,28.44,0.49,0.53
4,68,68,453,14,6.82,467,28.34,0.49,0.53
4,68,68,453,14,6.82,467,28.34,0.49,0.53
4,68,68,453,14,6.82,467,28.34,0.49,0.53
5,890,73,454,5,2.55,459,13.54,0.53,0.55
5,890,73,454,5,2.55,459,13.54,0.53,0.55
5,890,73,454,5,2.55,459,13.54,0.53,0.55
11,236,42,476,14,7.03,490,28.72,0.49,0.53
11,236,42,476,14,7.03,490,28.72,0.49,0.53
11,236,42,476,14,7.03,490,28.72,0.49,0.53
12,20,16,467,3,1.31,470,9.72,0.54,0.55
12,20,16,467,3,1.31,470,9.72,0.54,0.55
12,20,16,467,3,1.31,470,9.72,0.54,0.55
14,47,6,469,11,5.49,480,23.57,0.5,0.53
14,47,6,469,11,5.49,480,23.57,0.5,0.53
14,47,6,469,11,5.49,480,23.57,0.5,0.53
3,91,55,505,9,4.7,514,20.58,0.51,0.54
3,91,55,505,9,4.7,514,20.58,0.51,0.54
3,91,55,505,9,4.7,514,20.58,0.51,0.54
5,248,73,501,12,5.82,513,24.94,0.5,0.53
5,248,73,501,12,5.82,513,24.94,0.5,0.53
5,248,73,501,12,5.82,513,24.94,0.5,0.53
11,28,42,498,8,4.18,506,18.85,0.52,0.54
11,28,42,498,8,4.18,506,18.85,0.52,0.54
11,28,42,498,8,4.18,506,18.85,0.52,0.54
3,139,55,527,18,8.96,545,35.35,0.47000000000000003,0.52
3,139,55,527,18,8.96,545,35.35,0.47000000000000003,0.52
3,139,55,527,18,8.96,545,35.35,0.47000000000000003,0.52
5,84,73,528,7,3.65,535,17.09,0.52,0.54
5,84,73,528,7,3.65,535,17.09,0.52,0.54
5,84,73,528,7,3.65,535,17.09,0.52,0.54
11,44,42,518,11,5.42,529,23.44,0.5,0.53
11,44,42,518,11,5.42,529,23.44,0.5,0.53
11,44,42,518,11,5.42,529,23.44,0.5,0.53
3,163,55,551,16,7.75,567,31.59,0.48,0.52
3,163,55,551,16,7.75,567,31.59,0.48,0.52
3,163,55,551,16,7.75,567,31.59,0.48,0.52
5,593,73,599,6,2.92,605,14.99,0.52,0.54
5,593,73,599,6,2.92,605,14.99,0.52,0.54
5,593,73,599,6,2.92,605,14.99,0.52,0.54
11,110,42,571,13,6.37,584,26.73,0.5,0.53
11,110,42,571,13,6.37,584,26.73,0.5,0.53
11,110,42,571,13,6.37,584,26.73,0.5,0.53
15,2,1,588,14,7.1,602,28.84,0.49,0.53
15,2,1,588,14,7.1,602,28.84,0.49,0.53
15,2,1,588,14,7.1,602,28.84,0.49,0.53
5,92,73,608,8,3.98,616,18.48,0.52,0.54
5,92,73,608,8,3.98,616,18.48,0.52,0.54
5,92,73,608,8,3.98,616,18.48,0.52,0.54
5,974,73,687,6,2.92,693,14.99,0.52,0.54
5,974,73,687,6,2.92,693,14.99,0.52,0.54
5,974,73,687,6,2.92,693,14.99,0.52,0.54
1,926,82,945,9,4.37,954,19.97,0.51,0.54
1,926,82,945,9,4.37,954,19.97,0.51,0.54
1,926,82,945,9,4.37,954,19.97,0.51,0.54
11,266,43,964,15,7.39,979,30.16,0.49,0.52
11,266,43,964,15,7.39,979,30.16,0.49,0.52
11,266,43,964,15,7.39,979,30.16,0.49,0.52
7,403,58,1017,6,2.81,1023,14.79,0.53,0.54
7,403,58,1017,6,2.81,1023,14.79,0.53,0.54
7,403,58,1017,6,2.81,1023,14.79,0.53,0.54
11,344,43,1015,9,4.63,1024,20.45,0.51,0.54
11,344,43,1015,9,4.63,1024,20.45,0.51,0.54
11,344,43,1015,9,4.63,1024,20.45,0.51,0.54
7,258,58,1040,9,4.54,1049,20.29,0.51,0.54
7,258,58,1040,9,4.54,1049,20.29,0.51,0.54
7,258,58,1040,9,4.54,1049,20.29,0.51,0.54
11,258,43,1039,12,5.79,1051,24.9,0.5,0.53
11,258,43,1039,12,5.79,1051,24.9,0.5,0.53
11,258,43,1039,12,5.79,1051,24.9,0.5,0.53
12,281,16,1028,10,5.1,1038,22.07,0.51,0.53
12,281,16,1028,10,5.1,1038,22.07,0.51,0.53
12,281,16,1028,10,5.1,1038,22.07,0.51,0.53
7,258,58,1053,5,2.45,1058,13.36,0.53,0.55
7,258,58,1053,5,2.45,1058,13.36,0.53,0.55
7,258,58,1053,5,2.45,1058,13.36,0.53,0.55
11,299,43,1062,21,10.69,1083,40.84,0.46,0.51
11,299,43,1062,21,10.69,1083,40.84,0.46,0.51
11,299,43,1062,21,10.69,1083,40.84,0.46,0.51
12,265,16,1070,18,8.98,1088,35.38,0.47000000000000003,0.52
12,265,16,1070,18,8.98,1088,35.38,0.47000000000000003,0.52
12,265,16,1070,18,8.98,1088,35.38,0.47000000000000003,0.52
14,416,6,1059,11,5.28,1070,23.19,0.5,0.53
14,416,6,1059,11,5.28,1070,23.19,0.5,0.53
14,416,6,1059,11,5.28,1070,23.19,0.5,0.53
6,440,35,1096,11,5.36,1107,23.33,0.5,0.53
6,440,35,1096,11,5.36,1107,23.33,0.5,0.53
6,440,35,1096,11,5.36,1107,23.33,0.5,0.53
7,385,58,1080,18,8.8,1098,35.05,0.47000000000000003,0.52
7,385,58,1080,18,8.8,1098,35.05,0.47000000000000003,0.52
7,385,58,1080,18,8.8,1098,35.05,0.47000000000000003,0.52
11,440,43,1103,12,6.16,1115,25.57,0.5,0.53
11,440,43,1103,12,6.16,1115,25.57,0.5,0.53
11,440,43,1103,12,6.16,1115,25.57,0.5,0.53
0,398,24,1132,4,2.21,1136,12.14,0.53,0.55
0,398,24,1132,4,2.21,1136,12.14,0.53,0.55
0,398,24,1132,4,2.21,1136,12.14,0.53,0.55
7,460,58,1122,7,3.74,1129,17.27,0.52,0.54
7,460,58,1122,7,3.74,1129,17.27,0.52,0.54
7,460,58,1122,7,3.74,1129,17.27,0.52,0.54
12,327,16,1112,14,6.92,1126,28.52,0.49,0.53
12,327,16,1112,14,6.92,1126,28.52,0.49,0.53
12,327,16,1112,14,6.92,1126,28.52,0.49,0.53
6,974,35,1160,13,6.44,1173,26.86,0.5,0.53
6,974,35,1160,13,6.44,1173,26.86,0.5,0.53
6,974,35,1160,13,6.44,1173,26.86,0.5,0.53
7,279,58,1152,12,5.97,1164,25.23,0.5,0.53
7,279,58,1152,12,5.97,1164,25.23,0.5,0.53
7,279,58,1152,12,5.97,1164,25.23,0.5,0.53
12,381,16,1159,7,3.71,1166,17.2,0.52,0.54
12,381,16,1159,7,3.71,1166,17.2,0.52,0.54
12,381,16,1159,7,3.71,1166,17.2,0.52,0.54
7,258,58,1195,11,5.54,1206,23.66,0.5,0.53
7,258,58,1195,11,5.54,1206,23.66,0.5,0.53
7,258,58,1195,11,5.54,1206,23.66,0.5,0.53
6,884,35,1226,5,2.57,1231,13.58,0.53,0.55
6,884,35,1226,5,2.57,1231,13.58,0.53,0.55
6,884,35,1226,5,2.57,1231,13.58,0.53,0.55
7,570,58,1248,9,4.3,1257,19.84,0.51,0.54
7,570,58,1248,9,4.3,1257,19.84,0.51,0.54
7,570,58,1248,9,4.3,1257,19.84,0.51,0.54
7,719,58,1283,15,7.27,1298,29.93,0.49,0.53
7,719,58,1283,15,7.27,1298,29.93,0.49,0.53
7,719,58,1283,15,7.27,1298,29.93,0.49,0.53
6,504,35,1311,12,6.14,1323,25.53,0.5,0.53
6,504,35,1311,12,6.14,1323,25.53,0.5,0.53
6,504,35,1311,12,6.14,1323,25.53,0.5,0.53
7,718,58,1301,13,6.54,1314,27.05,0.49,0.53
7,718,58,1301,13,6.54,1314,27.05,0.49,0.53
7,718,58,1301,13,6.54,1314,27.05,0.49,0.53
6,536,35,1347,8,3.81,1355,18.18,0.52,0.54
6,536,35,1347,8,3.81,1355,18.18,0.52,0.54
6,536,35,1347,8,3.81,1355,18.18,0.52,0.54
6,543,35,1353,13,6.71,1366,27.36,0.49,0.53
6,543,35,1353,13,6.71,1366,27.36,0.49,0.53
6,543,35,1353,13,6.71,1366,27.36,0.49,0.53
13,974,90,23,5,2.45,28,13.36,0.53,0.55
13,974,90,23,5,2.45,28,13.36,0.53,0.55
13,974,90,23,5,2.45,28,13.36,0.53,0.55
13,974,90,23,5,2.45,28,13.36,0.53,0.55
7,974,70,126,8,3.82,134,18.2,0.52,0.54
7,974,70,126,8,3.82,134,18.2,0.52,0.54
7,974,70,126,8,3.82,134,18.2,0.52,0.54
7,974,70,126,8,3.82,134,18.2,0.52,0.54
2,775,59,172,7,3.58,179,16.97,0.52,0.54
2,775,59,172,7,3.58,179,16.97,0.52,0.54
2,775,59,172,7,3.58,179,16.97,0.52,0.54
2,775,59,172,7,3.58,179,16.97,0.52,0.54
7,791,70,205,9,4.71,214,20.58,0.51,0.54
7,791,70,205,9,4.71,214,20.58,0.51,0.54
7,791,70,205,9,4.71,214,20.58,0.51,0.54
7,791,70,205,9,4.71,214,20.58,0.51,0.54
14,926,30,197,2,1.24,199,8.81,0.54,0.55
14,926,30,197,2,1.24,199,8.81,0.54,0.55
14,926,30,197,2,1.24,199,8.81,0.54,0.55
14,926,30,197,2,1.24,199,8.81,0.54,0.55
7,901,70,225,6,3.23,231,15.55,0.52,0.54
7,901,70,225,6,3.23,231,15.55,0.52,0.54
7,901,70,225,6,3.23,231,15.55,0.52,0.54
7,901,70,225,6,3.23,231,15.55,0.52,0.54
13,831,88,305,16,7.78,321,31.64,0.48,0.52
13,831,88,305,16,7.78,321,31.64,0.48,0.52
13,831,88,305,16,7.78,321,31.64,0.48,0.52
13,831,88,305,16,7.78,321,31.64,0.48,0.52
14,971,30,310,9,4.48,319,20.17,0.51,0.54
14,971,30,310,9,4.48,319,20.17,0.51,0.54
14,971,30,310,9,4.48,319,20.17,0.51,0.54
14,971,30,310,9,4.48,319,20.17,0.51,0.54
7,247,70,361,16,7.88,377,31.82,0.48,0.52
7,247,70,361,16,7.88,377,31.82,0.48,0.52
7,247,70,361,16,7.88,377,31.82,0.48,0.52
7,247,70,361,16,7.88,377,31.82,0.48,0.52
2,120,59,397,6,3.15,403,15.41,0.52,0.54
2,120,59,397,6,3.15,403,15.41,0.52,0.54
2,120,59,397,6,3.15,403,15.41,0.52,0.54
2,120,59,397,6,3.15,403,15.41,0.52,0.54
11,167,31,393,12,6.21,405,25.66,0.5,0.53
11,167,31,393,12,6.21,405,25.66,0.5,0.53
11,167,31,393,12,6.21,405,25.66,0.5,0.53
11,167,31,393,12,6.21,405,25.66,0.5,0.53
13,155,88,399,4,1.8,403,11.39,0.53,0.55
13,155,88,399,4,1.8,403,11.39,0.53,0.55
13,155,88,399,4,1.8,403,11.39,0.53,0.55
13,155,88,399,4,1.8,403,11.39,0.53,0.55
11,211,31,439,14,7.03,453,28.71,0.49,0.53
11,211,31,439,14,7.03,453,28.71,0.49,0.53
11,211,31,439,14,7.03,453,28.71,0.49,0.53
11,211,31,439,14,7.03,453,28.71,0.49,0.53
14,163,30,443,10,5.1,453,22.09,0.51,0.53
14,163,30,443,10,5.1,453,22.09,0.51,0.53
14,163,30,443,10,5.1,453,22.09,0.51,0.53
14,163,30,443,10,5.1,453,22.09,0.51,0.53
0,65,72,470,8,3.82,478,18.19,0.52,0.54
0,65,72,470,8,3.82,478,18.19,0.52,0.54
0,65,72,470,8,3.82,478,18.19,0.52,0.54
0,65,72,470,8,3.82,478,18.19,0.52,0.54
9,157,55,466,8,4.02,474,18.56,0.52,0.54
9,157,55,466,8,4.02,474,18.56,0.52,0.54
9,157,55,466,8,4.02,474,18.56,0.52,0.54
9,157,55,466,8,4.02,474,18.56,0.52,0.54
14,222,30,475,12,6.03,487,25.34,0.5,0.53
14,222,30,475,12,6.03,487,25.34,0.5,0.53
14,222,30,475,12,6.03,487,25.34,0.5,0.53
14,222,30,475,12,6.03,487,25.34,0.5,0.53
0,55,72,502,18,8.75,520,34.97,0.48,0.52
0,55,72,502,18,8.75,520,34.97,0.48,0.52
0,55,72,502,18,8.75,520,34.97,0.48,0.52
0,55,72,502,18,8.75,520,34.97,0.48,0.52
5,20,73,492,6,2.7600000000000002,498,14.71,0.53,0.54
5,20,73,492,6,2.7600000000000002,498,14.71,0.53,0.54
5,20,73,492,6,2.7600000000000002,498,14.71,0.53,0.54
5,20,73,492,6,2.7600000000000002,498,14.71,0.53,0.54
8,109,4,506,5,2.6,511,13.62,0.53,0.55
8,109,4,506,5,2.6,511,13.62,0.53,0.55
8,109,4,506,5,2.6,511,13.62,0.53,0.55
8,109,4,506,5,2.6,511,13.62,0.53,0.55
9,97,55,498,9,4.55,507,20.29,0.51,0.54
9,97,55,498,9,4.55,507,20.29,0.51,0.54
9,97,55,498,9,4.55,507,20.29,0.51,0.54
9,97,55,498,9,4.55,507,20.29,0.51,0.54
11,120,31,492,17,8.49,509,33.7,0.48,0.52
11,120,31,492,17,8.49,509,33.7,0.48,0.52
11,120,31,492,17,8.49,509,33.7,0.48,0.52
11,120,31,492,17,8.49,509,33.7,0.48,0.52
12,598,83,503,13,6.75,516,27.42,0.49,0.53
12,598,83,503,13,6.75,516,27.42,0.49,0.53
12,598,83,503,13,6.75,516,27.42,0.49,0.53
12,598,83,503,13,6.75,516,27.42,0.49,0.53
14,3,30,485,16,7.82,501,31.71,0.48,0.52
14,3,30,485,16,7.82,501,31.71,0.48,0.52
14,3,30,485,16,7.82,501,31.71,0.48,0.52
14,3,30,485,16,7.82,501,31.71,0.48,0.52
5,149,73,518,9,4.52,527,20.25,0.51,0.54
5,149,73,518,9,4.52,527,20.25,0.51,0.54
5,149,73,518,9,4.52,527,20.25,0.51,0.54
5,149,73,518,9,4.52,527,20.25,0.51,0.54
8,85,4,530,12,5.79,542,24.89,0.5,0.53
8,85,4,530,12,5.79,542,24.89,0.5,0.53
8,85,4,530,12,5.79,542,24.89,0.5,0.53
8,85,4,530,12,5.79,542,24.89,0.5,0.53
11,163,31,524,8,4.16,532,18.81,0.52,0.54
11,163,31,524,8,4.16,532,18.81,0.52,0.54
11,163,31,524,8,4.16,532,18.81,0.52,0.54
11,163,31,524,8,4.16,532,18.81,0.52,0.54
14,763,30,523,8,3.81,531,18.18,0.52,0.54
14,763,30,523,8,3.81,531,18.18,0.52,0.54
14,763,30,523,8,3.81,531,18.18,0.52,0.54
14,763,30,523,8,3.81,531,18.18,0.52,0.54
8,114,4,543,15,7.37,558,30.12,0.49,0.52
8,114,4,543,15,7.37,558,30.12,0.49,0.52
8,114,4,543,15,7.37,558,30.12,0.49,0.52
8,114,4,543,15,7.37,558,30.12,0.49,0.52
12,67,83,564,14,7.15,578,28.93,0.49,0.53
12,67,83,564,14,7.15,578,28.93,0.49,0.53
12,67,83,564,14,7.15,578,28.93,0.49,0.53
12,67,83,564,14,7.15,578,28.93,0.49,0.53
5,26,73,584,7,3.27,591,16.41,0.52,0.54
5,26,73,584,7,3.27,591,16.41,0.52,0.54
5,26,73,584,7,3.27,591,16.41,0.52,0.54
5,26,73,584,7,3.27,591,16.41,0.52,0.54
11,51,31,587,2,1.23,589,8.79,0.54,0.55
11,51,31,587,2,1.23,589,8.79,0.54,0.55
11,51,31,587,2,1.23,589,8.79,0.54,0.55
11,51,31,587,2,1.23,589,8.79,0.54,0.55
0,938,72,641,15,7.47,656,30.3,0.49,0.52
0,938,72,641,15,7.47,656,30.3,0.49,0.52
0,938,72,641,15,7.47,656,30.3,0.49,0.52
0,938,72,641,15,7.47,656,30.3,0.49,0.52
10,952,37,848,13,6.33,861,26.66,0.5,0.53
10,952,37,848,13,6.33,861,26.66,0.5,0.53
10,952,37,848,13,6.33,861,26.66,0.5,0.53
10,952,37,848,13,6.33,861,26.66,0.5,0.53
0,959,72,885,22,11.11,907,42.38,0.46,0.51
0,959,72,885,22,11.11,907,42.38,0.46,0.51
0,959,72,885,22,11.11,907,42.38,0.46,0.51
0,959,72,885,22,11.11,907,42.38,0.46,0.51
1,804,58,871,9,4.4,880,20.02,0.51,0.54
1,804,58,871,9,4.4,880,20.02,0.51,0.54
1,804,58,871,9,4.4,880,20.02,0.51,0.54
1,804,58,871,9,4.4,880,20.02,0.51,0.54
2,830,59,920,8,4.19,928,18.86,0.52,0.54
2,830,59,920,8,4.19,928,18.86,0.52,0.54
2,830,59,920,8,4.19,928,18.86,0.52,0.54
2,830,59,920,8,4.19,928,18.86,0.52,0.54
2,403,59,981,11,5.27,992,23.18,0.5,0.53
2,403,59,981,11,5.27,992,23.18,0.5,0.53
2,403,59,981,11,5.27,992,23.18,0.5,0.53
2,403,59,981,11,5.27,992,23.18,0.5,0.53
0,445,72,1036,7,3.72,1043,17.23,0.52,0.54
0,445,72,1036,7,3.72,1043,17.23,0.52,0.54
0,445,72,1036,7,3.72,1043,17.23,0.52,0.54
0,445,72,1036,7,3.72,1043,17.23,0.52,0.54
2,365,59,1046,8,4.05,1054,18.61,0.52,0.54
2,365,59,1046,8,4.05,1054,18.61,0.52,0.54
2,365,59,1046,8,4.05,1054,18.61,0.52,0.54
2,365,59,1046,8,4.05,1054,18.61,0.52,0.54
0,350,72,1059,13,6.47,1072,26.91,0.5,0.53
0,350,72,1059,13,6.47,1072,26.91,0.5,0.53
0,350,72,1059,13,6.47,1072,26.91,0.5,0.53
0,350,72,1059,13,6.47,1072,26.91,0.5,0.53
0,272,72,1125,11,5.31,1136,23.25,0.5,0.53
0,272,72,1125,11,5.31,1136,23.25,0.5,0.53
0,272,72,1125,11,5.31,1136,23.25,0.5,0.53
0,272,72,1125,11,5.31,1136,23.25,0.5,0.53
3,426,19,1112,5,2.46,1117,13.38,0.53,0.55
3,426,19,1112,5,2.46,1117,13.38,0.53,0.55
3,426,19,1112,5,2.46,1117,13.38,0.53,0.55
3,426,19,1112,5,2.46,1117,13.38,0.53,0.55
7,426,70,1133,1,0.6000000000000001,1134,6.88,0.55,0.55
7,426,70,1133,1,0.6000000000000001,1134,6.88,0.55,0.55
7,426,70,1133,1,0.6000000000000001,1134,6.88,0.55,0.55
7,426,70,1133,1,0.6000000000000001,1134,6.88,0.55,0.55
6,405,54,1155,3,1.74,1158,10.51,0.54,0.55
6,405,54,1155,3,1.74,1158,10.51,0.54,0.55
6,405,54,1155,3,1.74,1158,10.51,0.54,0.55
6,405,54,1155,3,1.74,1158,10.51,0.54,0.55
0,957,72,1190,16,8.13,1206,32.27,0.48,0.52
0,957,72,1190,16,8.13,1206,32.27,0.48,0.52
0,957,72,1190,16,8.13,1206,32.27,0.48,0.52
0,957,72,1190,16,8.13,1206,32.27,0.48,0.52
3,380,19,1173,10,5.23,1183,22.32,0.51,0.53
3,380,19,1173,10,5.23,1183,22.32,0.51,0.53
3,380,19,1173,10,5.23,1183,22.32,0.51,0.53
3,380,19,1173,10,5.23,1183,22.32,0.51,0.53
3,566,19,1237,8,3.96,1245,18.45,0.52,0.54
3,566,19,1237,8,3.96,1245,18.45,0.52,0.54
3,566,19,1237,8,3.96,1245,18.45,0.52,0.54
3,566,19,1237,8,3.96,1245,18.45,0.52,0.54
7,674,70,1235,11,5.41,1246,23.42,0.5,0.53
7,674,70,1235,11,5.41,1246,23.42,0.5,0.53
7,674,70,1235,11,5.41,1246,23.42,0.5,0.53
7,674,70,1235,11,5.41,1246,23.42,0.5,0.53
9,514,65,1248,13,6.43,1261,26.85,0.5,0.53
9,514,65,1248,13,6.43,1261,26.85,0.5,0.53
9,514,65,1248,13,6.43,1261,26.85,0.5,0.53
9,514,65,1248,13,6.43,1261,26.85,0.5,0.53
6,535,54,1274,4,2.09,1278,11.93,0.53,0.55
6,535,54,1274,4,2.09,1278,11.93,0.53,0.55
6,535,54,1274,4,2.09,1278,11.93,0.53,0.55
6,535,54,1274,4,2.09,1278,11.93,0.53,0.55
7,703,70,1260,8,4.14,1268,18.77,0.52,0.54
7,703,70,1260,8,4.14,1268,18.77,0.52,0.54
7,703,70,1260,8,4.14,1268,18.77,0.52,0.54
7,703,70,1260,8,4.14,1268,18.77,0.52,0.54
6,749,54,1309,5,2.49,1314,13.44,0.53,0.55
6,749,54,1309,5,2.49,1314,13.44,0.53,0.55
6,749,54,1309,5,2.49,1314,13.44,0.53,0.55
6,749,54,1309,5,2.49,1314,13.44,0.53,0.55
7,633,70,1293,15,7.5,1308,30.35,0.49,0.52
7,633,70,1293,15,7.5,1308,30.35,0.49,0.52
7,633,70,1293,15,7.5,1308,30.35,0.49,0.52
7,633,70,1293,15,7.5,1308,30.35,0.49,0.52
15,529,64,1297,14,7.22,1311,29.06,0.49,0.53
15,529,64,1297,14,7.22,1311,29.06,0.49,0.53
15,529,64,1297,14,7.22,1311,29.06,0.49,0.53
15,529,64,1297,14,7.22,1311,29.06,0.49,0.53
3,508,19,1338,5,2.35,1343,13.18,0.53,0.55
3,508,19,1338,5,2.35,1343,13.18,0.53,0.55
3,508,19,1338,5,2.35,1343,13.18,0.53,0.55
3,508,19,1338,5,2.35,1343,13.18,0.53,0.55
15,690,64,1373,15,7.75,1388,30.8,0.49,0.52
15,690,64,1373,15,7.75,1388,30.8,0.49,0.52
15,690,64,1373,15,7.75,1388,30.8,0.49,0.52
15,690,64,1373,15,7.75,1388,30.8,0.49,0.52
3,933,19,1385,4,2.14,1389,12.01,0.53,0.55
3,933,19,1385,4,2.14,1389,12.01,0.53,0.55
3,933,19,1385,4,2.14,1389,12.01,0.53,0.55
3,933,19,1385,4,2.14,1389,12.01,0.53,0.55
7,633,70,1422,12,6.1,1434,25.46,0.5,0.53
7,633,70,1422,12,6.1,1434,25.46,0.5,0.53
7,633,70,1422,12,6.1,1434,25.46,0.5,0.53
7,633,70,1422,12,6.1,1434,25.46,0.5,0.53
11,776,77,197,6,3.1,203,15.32,0.52,0.54
11,776,77,197,6,3.1,203,15.32,0.52,0.54
11,776,77,197,6,3.1,203,15.32,0.52,0.54
11,776,77,197,6,3.1,203,15.32,0.52,0.54
11,776,77,197,6,3.1,203,15.32,0.52,0.54
13,971,20,249,13,6.39,262,26.77,0.5,0.53
13,971,20,249,13,6.39,262,26.77,0.5,0.53
13,971,20,249,13,6.39,262,26.77,0.5,0.53
13,971,20,249,13,6.39,262,26.77,0.5,0.53
13,971,20,249,13,6.39,262,26.77,0.5,0.53
8,175,47,388,7,3.39,395,16.64,0.52,0.54
8,175,47,388,7,3.39,395,16.64,0.52,0.54
8,175,47,388,7,3.39,395,16.64,0.52,0.54
8,175,47,388,7,3.39,395,16.64,0.52,0.54
8,175,47,388,7,3.39,395,16.64,0.52,0.54
11,58,77,374,8,4.15,382,18.79,0.52,0.54
11,58,77,374,8,4.15,382,18.79,0.52,0.54
11,58,77,374,8,4.15,382,18.79,0.52,0.54
11,58,77,374,8,4.15,382,18.79,0.52,0.54
11,58,77,374,8,4.15,382,18.79,0.52,0.54
8,51,47,409,8,4.0,417,18.51,0.52,0.54
8,51,47,409,8,4.0,417,18.51,0.52,0.54
8,51,47,409,8,4.0,417,18.51,0.52,0.54
8,51,47,409,8,4.0,417,18.51,0.52,0.54
8,51,47,409,8,4.0,417,18.51,0.52,0.54
3,119,32,434,17,8.65,451,34.0,0.48,0.52
3,119,32,434,17,8.65,451,34.0,0.48,0.52
3,119,32,434,17,8.65,451,34.0,0.48,0.52
3,119,32,434,17,8.65,451,34.0,0.48,0.52
3,119,32,434,17,8.65,451,34.0,0.48,0.52
6,87,88,449,12,6.16,461,25.57,0.5,0.53
6,87,88,449,12,6.16,461,25.57,0.5,0.53
6,87,88,449,12,6.16,461,25.57,0.5,0.53
6,87,88,449,12,6.16,461,25.57,0.5,0.53
6,87,88,449,12,6.16,461,25.57,0.5,0.53
11,175,77,445,10,5.18,455,22.23,0.51,0.53
11,175,77,445,10,5.18,455,22.23,0.51,0.53
11,175,77,445,10,5.18,455,22.23,0.51,0.53
11,175,77,445,10,5.18,455,22.23,0.51,0.53
11,175,77,445,10,5.18,455,22.23,0.51,0.53
0,125,13,486,14,6.96,500,28.58,0.49,0.53
0,125,13,486,14,6.96,500,28.58,0.49,0.53
0,125,13,486,14,6.96,500,28.58,0.49,0.53
0,125,13,486,14,6.96,500,28.58,0.49,0.53
0,125,13,486,14,6.96,500,28.58,0.49,0.53
6,90,88,503,2,0.91,505,8.21,0.54,0.55
6,90,88,503,2,0.91,505,8.21,0.54,0.55
6,90,88,503,2,0.91,505,8.21,0.54,0.55
6,90,88,503,2,0.91,505,8.21,0.54,0.55
6,90,88,503,2,0.91,505,8.21,0.54,0.55
11,247,77,495,14,6.8,509,28.3,0.49,0.53
11,247,77,495,14,6.8,509,28.3,0.49,0.53
11,247,77,495,14,6.8,509,28.3,0.49,0.53
11,247,77,495,14,6.8,509,28.3,0.49,0.53
11,247,77,495,14,6.8,509,28.3,0.49,0.53
0,9,13,534,15,7.65,549,30.62,0.49,0.52
0,9,13,534,15,7.65,549,30.62,0.49,0.52
0,9,13,534,15,7.65,549,30.62,0.49,0.52
0,9,13,534,15,7.65,549,30.62,0.49,0.52
0,9,13,534,15,7.65,549,30.62,0.49,0.52
6,64,88,513,14,6.83,527,28.35,0.49,0.53
6,64,88,513,14,6.83,527,28.35,0.49,0.53
6,64,88,513,14,6.83,527,28.35,0.49,0.53
6,64,88,513,14,6.83,527,28.35,0.49,0.53
6,64,88,513,14,6.83,527,28.35,0.49,0.53
11,56,77,533,13,6.33,546,26.65,0.5,0.53
11,56,77,533,13,6.33,546,26.65,0.5,0.53
11,56,77,533,13,6.33,546,26.65,0.5,0.53
11,56,77,533,13,6.33,546,26.65,0.5,0.53
11,56,77,533,13,6.33,546,26.65,0.5,0.53
4,926,70,549,10,5.18,559,22.22,0.51,0.53
4,926,70,549,10,5.18,559,22.22,0.51,0.53
4,926,70,549,10,5.18,559,22.22,0.51,0.53
4,926,70,549,10,5.18,559,22.22,0.51,0.53
4,926,70,549,10,5.18,559,22.22,0.51,0.53
11,83,77,540,19,9.52,559,37.15,0.47000000000000003,0.52
11,83,77,540,19,9.52,559,37.15,0.47000000000000003,0.52
11,83,77,540,19,9.52,559,37.15,0.47000000000000003,0.52
11,83,77,540,19,9.52,559,37.15,0.47000000000000003,0.52
11,83,77,540,19,9.52,559,37.15,0.47000000000000003,0.52
0,76,13,570,7,3.54,577,16.91,0.52,0.54
0,76,13,570,7,3.54,577,16.91,0.52,0.54
0,76,13,570,7,3.54,577,16.91,0.52,0.54
0,76,13,570,7,3.54,577,16.91,0.52,0.54
0,76,13,570,7,3.54,577,16.91,0.52,0.54
4,45,70,574,8,3.86,582,18.26,0.52,0.54
4,45,70,574,8,3.86,582,18.26,0.52,0.54
4,45,70,574,8,3.86,582,18.26,0.52,0.54
4,45,70,574,8,3.86,582,18.26,0.52,0.54
4,45,70,574,8,3.86,582,18.26,0.52,0.54
13,17,20,634,15,7.68,649,30.68,0.49,0.52
13,17,20,634,15,7.68,649,30.68,0.49,0.52
13,17,20,634,15,7.68,649,30.68,0.49,0.52
13,17,20,634,15,7.68,649,30.68,0.49,0.52
13,17,20,634,15,7.68,649,30.68,0.49,0.52
13,806,20,705,5,2.73,710,13.87,0.53,0.55
13,806,20,705,5,2.73,710,13.87,0.53,0.55
13,806,20,705,5,2.73,710,13.87,0.53,0.55
13,806,20,705,5,2.73,710,13.87,0.53,0.55
13,806,20,705,5,2.73,710,13.87,0.53,0.55
4,812,70,729,2,0.9400000000000001,731,8.27,0.54,0.55
4,812,70,729,2,0.9400000000000001,731,8.27,0.54,0.55
4,812,70,729,2,0.9400000000000001,731,8.27,0.54,0.55
4,812,70,729,2,0.9400000000000001,731,8.27,0.54,0.55
4,812,70,729,2,0.9400000000000001,731,8.27,0.54,0.55
4,753,70,758,18,9.24,776,35.86,0.47000000000000003,0.52
4,753,70,758,18,9.24,776,35.86,0.47000000000000003,0.52
4,753,70,758,18,9.24,776,35.86,0.47000000000000003,0.52
4,753,70,758,18,9.24,776,35.86,0.47000000000000003,0.52
4,753,70,758,18,9.24,776,35.86,0.47000000000000003,0.52
7,877,65,781,11,5.55,792,23.68,0.5,0.53
7,877,65,781,11,5.55,792,23.68,0.5,0.53
7,877,65,781,11,5.55,792,23.68,0.5,0.53
7,877,65,781,11,5.55,792,23.68,0.5,0.53
7,877,65,781,11,5.55,792,23.68,0.5,0.53
10,464,9,918,16,7.8,934,31.67,0.48,0.52
10,464,9,918,16,7.8,934,31.67,0.48,0.52
10,464,9,918,16,7.8,934,31.67,0.48,0.52
10,464,9,918,16,7.8,934,31.67,0.48,0.52
10,464,9,918,16,7.8,934,31.67,0.48,0.52
8,257,85,1015,18,8.79,1033,35.04,0.47000000000000003,0.52
8,257,85,1015,18,8.79,1033,35.04,0.47000000000000003,0.52
8,257,85,1015,18,8.79,1033,35.04,0.47000000000000003,0.52
8,257,85,1015,18,8.79,1033,35.04,0.47000000000000003,0.52
8,257,85,1015,18,8.79,1033,35.04,0.47000000000000003,0.52
15,261,7,1013,17,8.31,1030,33.39,0.48,0.52
15,261,7,1013,17,8.31,1030,33.39,0.48,0.52
15,261,7,1013,17,8.31,1030,33.39,0.48,0.52
15,261,7,1013,17,8.31,1030,33.39,0.48,0.52
15,261,7,1013,17,8.31,1030,33.39,0.48,0.52
2,934,55,1049,18,8.89,1067,35.22,0.47000000000000003,0.52
2,934,55,1049,18,8.89,1067,35.22,0.47000000000000003,0.52
2,934,55,1049,18,8.89,1067,35.22,0.47000000000000003,0.52
2,934,55,1049,18,8.89,1067,35.22,0.47000000000000003,0.52
2,934,55,1049,18,8.89,1067,35.22,0.47000000000000003,0.52
3,258,63,1054,10,4.83,1064,21.58,0.51,0.54
3,258,63,1054,10,4.83,1064,21.58,0.51,0.54
3,258,63,1054,10,4.83,1064,21.58,0.51,0.54
3,258,63,1054,10,4.83,1064,21.58,0.51,0.54
3,258,63,1054,10,4.83,1064,21.58,0.51,0.54
0,343,25,1099,20,9.99,1119,38.78,0.47000000000000003,0.51
0,343,25,1099,20,9.99,1119,38.78,0.47000000000000003,0.51
0,343,25,1099,20,9.99,1119,38.78,0.47000000000000003,0.51
0,343,25,1099,20,9.99,1119,38.78,0.47000000000000003,0.51
0,343,25,1099,20,9.99,1119,38.78,0.47000000000000003,0.51
10,403,9,1086,8,4.25,1094,18.97,0.52,0.54
10,403,9,1086,8,4.25,1094,18.97,0.52,0.54
10,403,9,1086,8,4.25,1094,18.97,0.52,0.54
10,403,9,1086,8,4.25,1094,18.97,0.52,0.54
10,403,9,1086,8,4.25,1094,18.97,0.52,0.54
2,326,55,1127,8,4.19,1135,18.86,0.52,0.54
2,326,55,1127,8,4.19,1135,18.86,0.52,0.54
2,326,55,1127,8,4.19,1135,18.86,0.52,0.54
2,326,55,1127,8,4.19,1135,18.86,0.52,0.54
2,326,55,1127,8,4.19,1135,18.86,0.52,0.54
3,813,63,1118,16,8.13,1134,32.27,0.48,0.52
3,813,63,1118,16,8.13,1134,32.27,0.48,0.52
3,813,63,1118,16,8.13,1134,32.27,0.48,0.52
3,813,63,1118,16,8.13,1134,32.27,0.48,0.52
3,813,63,1118,16,8.13,1134,32.27,0.48,0.52
10,388,9,1186,6,3.24,1192,15.58,0.52,0.54
10,388,9,1186,6,3.24,1192,15.58,0.52,0.54
10,388,9,1186,6,3.24,1192,15.58,0.52,0.54
10,388,9,1186,6,3.24,1192,15.58,0.52,0.54
10,388,9,1186,6,3.24,1192,15.58,0.52,0.54
13,623,20,1175,3,1.44,1178,9.96,0.54,0.55
13,623,20,1175,3,1.44,1178,9.96,0.54,0.55
13,623,20,1175,3,1.44,1178,9.96,0.54,0.55
13,623,20,1175,3,1.44,1178,9.96,0.54,0.55
13,623,20,1175,3,1.44,1178,9.96,0.54,0.55
10,513,9,1278,7,3.75,1285,17.28,0.52,0.54
10,513,9,1278,7,3.75,1285,17.28,0.52,0.54
10,513,9,1278,7,3.75,1285,17.28,0.52,0.54
10,513,9,1278,7,3.75,1285,17.28,0.52,0.54
10,513,9,1278,7,3.75,1285,17.28,0.52,0.54
14,679,71,1288,10,5.14,1298,22.16,0.51,0.53
14,679,71,1288,10,5.14,1298,22.16,0.51,0.53
14,679,71,1288,10,5.14,1298,22.16,0.51,0.53
14,679,71,1288,10,5.14,1298,22.16,0.51,0.53
14,679,71,1288,10,5.14,1298,22.16,0.51,0.53
2,564,55,1300,5,2.67,1305,13.75,0.53,0.55
2,564,55,1300,5,2.67,1305,13.75,0.53,0.55
2,564,55,1300,5,2.67,1305,13.75,0.53,0.55
2,564,55,1300,5,2.67,1305,13.75,0.53,0.55
2,564,55,1300,5,2.67,1305,13.75,0.53,0.55
2,685,55,1347,12,5.98,1359,25.25,0.5,0.53
2,685,55,1347,12,5.98,1359,25.25,0.5,0.53
2,685,55,1347,12,5.98,1359,25.25,0.5,0.53
2,685,55,1347,12,5.98,1359,25.25,0.5,0.53
2,685,55,1347,12,5.98,1359,25.25,0.5,0.53
14,660,71,1336,5,2.4,1341,13.27,0.53,0.55
14,660,71,1336,5,2.4,1341,13.27,0.53,0.55
14,660,71,1336,5,2.4,1341,13.27,0.53,0.55
14,660,71,1336,5,2.4,1341,13.27,0.53,0.55
14,660,71,1336,5,2.4,1341,13.27,0.53,0.55
2,606,55,1352,9,4.26,1361,19.78,0.51,0.54
2,606,55,1352,9,4.26,1361,19.78,0.51,0.54
2,606,55,1352,9,4.26,1361,19.78,0.51,0.54
2,606,55,1352,9,4.26,1361,19.78,0.51,0.54
2,606,55,1352,9,4.26,1361,19.78,0.51,0.54
14,779,71,1374,2,1.06,1376,8.49,0.54,0.55
14,779,71,1374,2,1.06,1376,8.49,0.54,0.55
14,779,71,1374,2,1.06,1376,8.49,0.54,0.55
14,779,71,1374,2,1.06,1376,8.49,0.54,0.55
14,779,71,1374,2,1.06,1376,8.49,0.54,0.55
0,536,25,1382,3,1.52,1385,10.1,0.54,0.55
0,536,25,1382,3,1.52,1385,10.1,0.54,0.55
0,536,25,1382,3,1.52,1385,10.1,0.54,0.55
0,536,25,1382,3,1.52,1385,10.1,0.54,0.55
0,536,25,1382,3,1.52,1385,10.1,0.54,0.55
2,543,55,1388,15,7.46,1403,30.28,0.49,0.52
2,543,55,1388,15,7.46,1403,30.28,0.49,0.52
2,543,55,1388,15,7.46,1403,30.28,0.49,0.52
2,543,55,1388,15,7.46,1403,30.28,0.49,0.52
2,543,55,1388,15,7.46,1403,30.28,0.49,0.52
14,846,71,1382,18,9.2,1400,35.78,0.47000000000000003,0.52
14,846,71,1382,18,9.2,1400,35.78,0.47000000000000003,0.52
14,846,71,1382,18,9.2,1400,35.78,0.47000000000000003,0.52
14,846,71,1382,18,9.2,1400,35.78,0.47000000000000003,0.52
14,846,71,1382,18,9.2,1400,35.78,0.47000000000000003,0.52
9,960,19,145,3,1.55,148,10.16,0.54,0.55
9,960,19,145,3,1.55,148,10.16,0.54,0.55
9,960,19,145,3,1.55,148,10.16,0.54,0.55
9,960,19,145,3,1.55,148,10.16,0.54,0.55
9,960,19,145,3,1.55,148,10.16,0.54,0.55
9,960,19,145,3,1.55,148,10.16,0.54,0.55
9,889,19,365,6,3.2,371,15.51,0.52,0.54
9,889,19,365,6,3.2,371,15.51,0.52,0.54
9,889,19,365,6,3.2,371,15.51,0.52,0.54
9,889,19,365,6,3.2,371,15.51,0.52,0.54
9,889,19,365,6,3.2,371,15.51,0.52,0.54
9,889,19,365,6,3.2,371,15.51,0.52,0.54
2,885,11,395,5,2.74,400,13.88,0.53,0.55
2,885,11,395,5,2.74,400,13.88,0.53,0.55
2,885,11,395,5,2.74,400,13.88,0.53,0.55
2,885,11,395,5,2.74,400,13.88,0.53,0.55
2,885,11,395,5,2.74,400,13.88,0.53,0.55
2,885,11,395,5,2.74,400,13.88,0.53,0.55
13,204,28,391,2,0.76,393,7.94,0.54,0.55
13,204,28,391,2,0.76,393,7.94,0.54,0.55
13,204,28,391,2,0.76,393,7.94,0.54,0.55
13,204,28,391,2,0.76,393,7.94,0.54,0.55
13,204,28,391,2,0.76,393,7.94,0.54,0.55
13,204,28,391,2,0.76,393,7.94,0.54,0.55
3,19,13,426,7,3.49,433,16.82,0.52,0.54
3,19,13,426,7,3.49,433,16.82,0.52,0.54
3,19,13,426,7,3.49,433,16.82,0.52,0.54
3,19,13,426,7,3.49,433,16.82,0.52,0.54
3,19,13,426,7,3.49,433,16.82,0.52,0.54
3,19,13,426,7,3.49,433,16.82,0.52,0.54
7,31,48,423,6,3.1,429,15.31,0.52,0.54
7,31,48,423,6,3.1,429,15.31,0.52,0.54
7,31,48,423,6,3.1,429,15.31,0.52,0.54
7,31,48,423,6,3.1,429,15.31,0.52,0.54
7,31,48,423,6,3.1,429,15.31,0.52,0.54
7,31,48,423,6,3.1,429,15.31,0.52,0.54
9,25,19,448,11,5.71,459,23.98,0.5,0.53
9,25,19,448,11,5.71,459,23.98,0.5,0.53
9,25,19,448,11,5.71,459,23.98,0.5,0.53
9,25,19,448,11,5.71,459,23.98,0.5,0.53
9,25,19,448,11,5.71,459,23.98,0.5,0.53
9,25,19,448,11,5.71,459,23.98,0.5,0.53
11,248,74,439,7,3.6,446,17.02,0.52,0.54
11,248,74,439,7,3.6,446,17.02,0.52,0.54
11,248,74,439,7,3.6,446,17.02,0.52,0.54
11,248,74,439,7,3.6,446,17.02,0.52,0.54
11,248,74,439,7,3.6,446,17.02,0.52,0.54
11,248,74,439,7,3.6,446,17.02,0.52,0.54
1,763,81,468,14,7.08,482,28.8,0.49,0.53
1,763,81,468,14,7.08,482,28.8,0.49,0.53
1,763,81,468,14,7.08,482,28.8,0.49,0.53
1,763,81,468,14,7.08,482,28.8,0.49,0.53
1,763,81,468,14,7.08,482,28.8,0.49,0.53
1,763,81,468,14,7.08,482,28.8,0.49,0.53
7,237,48,478,11,5.64,489,23.84,0.5,0.53
7,237,48,478,11,5.64,489,23.84,0.5,0.53
7,237,48,478,11,5.64,489,23.84,0.5,0.53
7,237,48,478,11,5.64,489,23.84,0.5,0.53
7,237,48,478,11,5.64,489,23.84,0.5,0.53
7,237,48,478,11,5.64,489,23.84,0.5,0.53
9,129,19,457,11,5.46,468,23.52,0.5,0.53
9,129,19,457,11,5.46,468,23.52,0.5,0.53
9,129,19,457,11,5.46,468,23.52,0.5,0.53
9,129,19,457,11,5.46,468,23.52,0.5,0.53
9,129,19,457,11,5.46,468,23.52,0.5,0.53
9,129,19,457,11,5.46,468,23.52,0.5,0.53
11,242,74,453,15,7.31,468,30.01,0.49,0.52
11,242,74,453,15,7.31,468,30.01,0.49,0.52
11,242,74,453,15,7.31,468,30.01,0.49,0.52
11,242,74,453,15,7.31,468,30.01,0.49,0.52
11,242,74,453,15,7.31,468,30.01,0.49,0.52
11,242,74,453,15,7.31,468,30.01,0.49,0.52
3,244,13,500,11,5.58,511,23.74,0.5,0.53
3,244,13,500,11,5.58,511,23.74,0.5,0.53
3,244,13,500,11,5.58,511,23.74,0.5,0.53
3,244,13,500,11,5.58,511,23.74,0.5,0.53
3,244,13,500,11,5.58,511,23.74,0.5,0.53
3,244,13,500,11,5.58,511,23.74,0.5,0.53
7,247,48,491,18,8.85,509,35.14,0.47000000000000003,0.52
7,247,48,491,18,8.85,509,35.14,0.47000000000000003,0.52
7,247,48,491,18,8.85,509,35.14,0.47000000000000003,0.52
7,247,48,491,18,8.85,509,35.14,0.47000000000000003,0.52
7,247,48,491,18,8.85,509,35.14,0.47000000000000003,0.52
7,247,48,491,18,8.85,509,35.14,0.47000000000000003,0.52
11,49,74,509,17,8.52,526,33.76,0.48,0.52
11,49,74,509,17,8.52,526,33.76,0.48,0.52
11,49,74,509,17,8.52,526,33.76,0.48,0.52
11,49,74,509,17,8.52,526,33.76,0.48,0.52
11,49,74,509,17,8.52,526,33.76,0.48,0.52
11,49,74,509,17,8.52,526,33.76,0.48,0.52
1,141,81,513,11,5.61,524,23.78,0.5,0.53
1,141,81,513,11,5.61,524,23.78,0.5,0.53
1,141,81,513,11,5.61,524,23.78,0.5,0.53
1,141,81,513,11,5.61,524,23.78,0.5,0.53
1,141,81,513,11,5.61,524,23.78,0.5,0.53
1,141,81,513,11,5.61,524,23.78,0.5,0.53
7,73,48,520,4,1.94,524,11.65,0.53,0.55
7,73,48,520,4,1.94,524,11.65,0.53,0.55
7,73,48,520,4,1.94,524,11.65,0.53,0.55
7,73,48,520,4,1.94,524,11.65,0.53,0.55
7,73,48,520,4,1.94,524,11.65,0.53,0.55
7,73,48,520,4,1.94,524,11.65,0.53,0.55
11,21,74,536,10,4.8,546,21.54,0.51,0.54
11,21,74,536,10,4.8,546,21.54,0.51,0.54
11,21,74,536,10,4.8,546,21.54,0.51,0.54
11,21,74,536,10,4.8,546,21.54,0.51,0.54
11,21,74,536,10,4.8,546,21.54,0.51,0.54
11,21,74,536,10,4.8,546,21.54,0.51,0.54
0,159,32,573,1,0.59,574,6.85,0.55,0.55
0,159,32,573,1,0.59,574,6.85,0.55,0.55
0,159,32,573,1,0.59,574,6.85,0.55,0.55
0,159,32,573,1,0.59,574,6.85,0.55,0.55
0,159,32,573,1,0.59,574,6.85,0.55,0.55
0,159,32,573,1,0.59,574,6.85,0.55,0.55
3,10,13,591,14,6.86,605,28.4,0.49,0.53
3,10,13,591,14,6.86,605,28.4,0.49,0.53
3,10,13,591,14,6.86,605,28.4,0.49,0.53
3,10,13,591,14,6.86,605,28.4,0.49,0.53
3,10,13,591,14,6.86,605,28.4,0.49,0.53
3,10,13,591,14,6.86,605,28.4,0.49,0.53
11,76,74,585,4,2.08,589,11.9,0.53,0.55
11,76,74,585,4,2.08,589,11.9,0.53,0.55
11,76,74,585,4,2.08,589,11.9,0.53,0.55
11,76,74,585,4,2.08,589,11.9,0.53,0.55
11,76,74,585,4,2.08,589,11.9,0.53,0.55
11,76,74,585,4,2.08,589,11.9,0.53,0.55
15,240,33,600,17,8.35,617,33.45,0.48,0.52
15,240,33,600,17,8.35,617,33.45,0.48,0.52
15,240,33,600,17,8.35,617,33.45,0.48,0.52
15,240,33,600,17,8.35,617,33.45,0.48,0.52
15,240,33,600,17,8.35,617,33.45,0.48,0.52
15,240,33,600,17,8.35,617,33.45,0.48,0.52
4,815,57,664,12,5.98,676,25.24,0.5,0.53
4,815,57,664,12,5.98,676,25.24,0.5,0.53
4,815,57,664,12,5.98,676,25.24,0.5,0.53
4,815,57,664,12,5.98,676,25.24,0.5,0.53
4,815,57,664,12,5.98,676,25.24,0.5,0.53
4,815,57,664,12,5.98,676,25.24,0.5,0.53
8,695,38,663,10,4.96,673,21.83,0.51,0.54
8,695,38,663,10,4.96,673,21.83,0.51,0.54
8,695,38,663,10,4.96,673,21.83,0.51,0.54
8,695,38,663,10,4.96,673,21.83,0.51,0.54
8,695,38,663,10,4.96,673,21.83,0.51,0.54
8,695,38,663,10,4.96,673,21.83,0.51,0.54
10,897,30,695,4,2.16,699,12.05,0.53,0.55
10,897,30,695,4,2.16,699,12.05,0.53,0.55
10,897,30,695,4,2.16,699,12.05,0.53,0.55
10,897,30,695,4,2.16,699,12.05,0.53,0.55
10,897,30,695,4,2.16,699,12.05,0.53,0.55
10,897,30,695,4,2.16,699,12.05,0.53,0.55
8,849,38,873,13,6.63,886,27.21,0.49,0.53
8,849,38,873,13,6.63,886,27.21,0.49,0.53
8,849,38,873,13,6.63,886,27.21,0.49,0.53
8,849,38,873,13,6.63,886,27.21,0.49,0.53
8,849,38,873,13,6.63,886,27.21,0.49,0.53
8,849,38,873,13,6.63,886,27.21,0.49,0.53
0,472,6,1078,15,7.59,1093,30.52,0.49,0.52
0,472,6,1078,15,7.59,1093,30.52,0.49,0.52
0,472,6,1078,15,7.59,1093,30.52,0.49,0.52
0,472,6,1078,15,7.59,1093,30.52,0.49,0.52
0,472,6,1078,15,7.59,1093,30.52,0.49,0.52
0,472,6,1078,15,7.59,1093,30.52,0.49,0.52
4,483,95,1054,19,9.29,1073,36.72,0.47000000000000003,0.52
4,483,95,1054,19,9.29,1073,36.72,0.47000000000000003,0.52
4,483,95,1054,19,9.29,1073,36.72,0.47000000000000003,0.52
4,483,95,1054,19,9.29,1073,36.72,0.47000000000000003,0.52
4,483,95,1054,19,9.29,1073,36.72,0.47000000000000003,0.52
4,483,95,1054,19,9.29,1073,36.72,0.47000000000000003,0.52
0,916,6,1123,11,5.64,1134,23.85,0.5,0.53
0,916,6,1123,11,5.64,1134,23.85,0.5,0.53
0,916,6,1123,11,5.64,1134,23.85,0.5,0.53
0,916,6,1123,11,5.64,1134,23.85,0.5,0.53
0,916,6,1123,11,5.64,1134,23.85,0.5,0.53
0,916,6,1123,11,5.64,1134,23.85,0.5,0.53
0,972,6,1162,10,5.22,1172,22.3,0.51,0.53
0,972,6,1162,10,5.22,1172,22.3,0.51,0.53
0,972,6,1162,10,5.22,1172,22.3,0.51,0.53
0,972,6,1162,10,5.22,1172,22.3,0.51,0.53
0,972,6,1162,10,5.22,1172,22.3,0.51,0.53
0,972,6,1162,10,5.22,1172,22.3,0.51,0.53
0,599,6,1179,2,1.06,1181,8.48,0.54,0.55
0,599,6,1179,2,1.06,1181,8.48,0.54,0.55
0,599,6,1179,2,1.06,1181,8.48,0.54,0.55
0,599,6,1179,2,1.06,1181,8.48,0.54,0.55
0,599,6,1179,2,1.06,1181,8.48,0.54,0.55
0,599,6,1179,2,1.06,1181,8.48,0.54,0.55
0,704,58,1364,16,7.76,1380,31.6,0.48,0.52
0,704,58,1364,16,7.76,1380,31.6,0.48,0.52
0,704,58,1364,16,7.76,1380,31.6,0.48,0.52
0,704,58,1364,16,7.76,1380,31.6,0.48,0.52
0,704,58,1364,16,7.76,1380,31.6,0.48,0.52
0,704,58,1364,16,7.76,1380,31.6,0.48,0.52
0,819,20,147,13,6.35,160,26.7,0.5,0.53
0,819,20,147,13,6.35,160,26.7,0.5,0.53
0,819,20,147,13,6.35,160,26.7,0.5,0.53
0,819,20,147,13,6.35,160,26.7,0.5,0.53
0,819,20,147,13,6.35,160,26.7,0.5,0.53
0,819,20,147,13,6.35,160,26.7,0.5,0.53
0,819,20,147,13,6.35,160,26.7,0.5,0.53
13,889,45,167,10,4.87,177,21.66,0.51,0.54
13,889,45,167,10,4.87,177,21.66,0.51,0.54
13,889,45,167,10,4.87,177,21.66,0.51,0.54
13,889,45,167,10,4.87,177,21.66,0.51,0.54
13,889,45,167,10,4.87,177,21.66,0.51,0.54
13,889,45,167,10,4.87,177,21.66,0.51,0.54
13,889,45,167,10,4.87,177,21.66,0.51,0.54
13,960,45,189,19,9.5,208,37.11,0.47000000000000003,0.52
13,960,45,189,19,9.5,208,37.11,0.47000000000000003,0.52
13,960,45,189,19,9.5,208,37.11,0.47000000000000003,0.52
13,960,45,189,19,9.5,208,37.11,0.47000000000000003,0.52
13,960,45,189,19,9.5,208,37.11,0.47000000000000003,0.52
13,960,45,189,19,9.5,208,37.11,0.47000000000000003,0.52
13,960,45,189,19,9.5,208,37.11,0.47000000000000003,0.52
0,984,20,249,18,8.91,267,35.25,0.47000000000000003,0.52
0,984,20,249,18,8.91,267,35.25,0.47000000000000003,0.52
0,984,20,249,18,8.91,267,35.25,0.47000000000000003,0.52
0,984,20,249,18,8.91,267,35.25,0.47000000000000003,0.52
0,984,20,249,18,8.91,267,35.25,0.47000000000000003,0.52
0,984,20,249,18,8.91,267,35.25,0.47000000000000003,0.52
0,984,20,249,18,8.91,267,35.25,0.47000000000000003,0.52
9,806,79,258,5,2.31,263,13.1,0.53,0.55
9,806,79,258,5,2.31,263,13.1,0.53,0.55
9,806,79,258,5,2.31,263,13.1,0.53,0.55
9,806,79,258,5,2.31,263,13.1,0.53,0.55
9,806,79,258,5,2.31,263,13.1,0.53,0.55
9,806,79,258,5,2.31,263,13.1,0.53,0.55
9,806,79,258,5,2.31,263,13.1,0.53,0.55
1,760,93,317,15,7.7,332,30.72,0.49,0.52
1,760,93,317,15,7.7,332,30.72,0.49,0.52
1,760,93,317,15,7.7,332,30.72,0.49,0.52
1,760,93,317,15,7.7,332,30.72,0.49,0.52
1,760,93,317,15,7.7,332,30.72,0.49,0.52
1,760,93,317,15,7.7,332,30.72,0.49,0.52
1,760,93,317,15,7.7,332,30.72,0.49,0.52
6,98,88,366,3,1.46,369,10.0,0.54,0.55
6,98,88,366,3,1.46,369,10.0,0.54,0.55
6,98,88,366,3,1.46,369,10.0,0.54,0.55
6,98,88,366,3,1.46,369,10.0,0.54,0.55
6,98,88,366,3,1.46,369,10.0,0.54,0.55
6,98,88,366,3,1.46,369,10.0,0.54,0.55
6,98,88,366,3,1.46,369,10.0,0.54,0.55
10,35,86,371,9,4.47,380,20.16,0.51,0.54
10,35,86,371,9,4.47,380,20.16,0.51,0.54
10,35,86,371,9,4.47,380,20.16,0.51,0.54
10,35,86,371,9,4.47,380,20.16,0.51,0.54
10,35,86,371,9,4.47,380,20.16,0.51,0.54
10,35,86,371,9,4.47,380,20.16,0.51,0.54
10,35,86,371,9,4.47,380,20.16,0.51,0.54
0,167,20,407,6,2.84,413,14.85,0.53,0.54
0,167,20,407,6,2.84,413,14.85,0.53,0.54
0,167,20,407,6,2.84,413,14.85,0.53,0.54
0,167,20,407,6,2.84,413,14.85,0.53,0.54
0,167,20,407,6,2.84,413,14.85,0.53,0.54
0,167,20,407,6,2.84,413,14.85,0.53,0.54
0,167,20,407,6,2.84,413,14.85,0.53,0.54
10,114,86,405,5,2.52,410,13.49,0.53,0.55
10,114,86,405,5,2.52,410,13.49,0.53,0.55
10,114,86,405,5,2.52,410,13.49,0.53,0.55
10,114,86,405,5,2.52,410,13.49,0.53,0.55
10,114,86,405,5,2.52,410,13.49,0.53,0.55
10,114,86,405,5,2.52,410,13.49,0.53,0.55
10,114,86,405,5,2.52,410,13.49,0.53,0.55
13,839,45,396,17,8.45,413,33.64,0.48,0.52
13,839,45,396,17,8.45,413,33.64,0.48,0.52
13,839,45,396,17,8.45,413,33.64,0.48,0.52
13,839,45,396,17,8.45,413,33.64,0.48,0.52
13,839,45,396,17,8.45,413,33.64,0.48,0.52
13,839,45,396,17,8.45,413,33.64,0.48,0.52
13,839,45,396,17,8.45,413,33.64,0.48,0.52
0,959,20,433,14,7.01,447,28.68,0.49,0.53
0,959,20,433,14,7.01,447,28.68,0.49,0.53
0,959,20,433,14,7.01,447,28.68,0.49,0.53
0,959,20,433,14,7.01,447,28.68,0.49,0.53
0,959,20,433,14,7.01,447,28.68,0.49,0.53
0,959,20,433,14,7.01,447,28.68,0.49,0.53
0,959,20,433,14,7.01,447,28.68,0.49,0.53
11,98,96,475,9,4.32,484,19.89,0.51,0.54
11,98,96,475,9,4.32,484,19.89,0.51,0.54
11,98,96,475,9,4.32,484,19.89,0.51,0.54
11,98,96,475,9,4.32,484,19.89,0.51,0.54
11,98,96,475,9,4.32,484,19.89,0.51,0.54
11,98,96,475,9,4.32,484,19.89,0.51,0.54
11,98,96,475,9,4.32,484,19.89,0.51,0.54
0,77,20,483,14,7.15,497,28.93,0.49,0.53
0,77,20,483,14,7.15,497,28.93,0.49,0.53
0,77,20,483,14,7.15,497,28.93,0.49,0.53
0,77,20,483,14,7.15,497,28.93,0.49,0.53
0,77,20,483,14,7.15,497,28.93,0.49,0.53
0,77,20,483,14,7.15,497,28.93,0.49,0.53
0,77,20,483,14,7.15,497,28.93,0.49,0.53
7,21,36,494,11,5.45,505,23.5,0.5,0.53
7,21,36,494,11,5.45,505,23.5,0.5,0.53
7,21,36,494,11,5.45,505,23.5,0.5,0.53
7,21,36,494,11,5.45,505,23.5,0.5,0.53
7,21,36,494,11,5.45,505,23.5,0.5,0.53
7,21,36,494,11,5.45,505,23.5,0.5,0.53
7,21,36,494,11,5.45,505,23.5,0.5,0.53
11,106,96,498,21,10.29,519,40.11,0.46,0.51
11,106,96,498,21,10.29,519,40.11,0.46,0.51
11,106,96,498,21,10.29,519,40.11,0.46,0.51
11,106,96,498,21,10.29,519,40.11,0.46,0.51
11,106,96,498,21,10.29,519,40.11,0.46,0.51
11,106,96,498,21,10.29,519,40.11,0.46,0.51
11,106,96,498,21,10.29,519,40.11,0.46,0.51
15,126,33,501,4,2.01,505,11.78,0.53,0.55
15,126,33,501,4,2.01,505,11.78,0.53,0.55
15,126,33,501,4,2.01,505,11.78,0.53,0.55
15,126,33,501,4,2.01,505,11.78,0.53,0.55
15,126,33,501,4,2.01,505,11.78,0.53,0.55
15,126,33,501,4,2.01,505,11.78,0.53,0.55
15,126,33,501,4,2.01,505,11.78,0.53,0.55
15,211,33,539,3,1.32,542,9.73,0.54,0.55
15,211,33,539,3,1.32,542,9.73,0.54,0.55
15,211,33,539,3,1.32,542,9.73,0.54,0.55
15,211,33,539,3,1.32,542,9.73,0.54,0.55
15,211,33,539,3,1.32,542,9.73,0.54,0.55
15,211,33,539,3,1.32,542,9.73,0.54,0.55
15,211,33,539,3,1.32,542,9.73,0.54,0.55
2,67,13,557,16,7.94,573,31.92,0.48,0.52
2,67,13,557,16,7.94,573,31.92,0.48,0.52
2,67,13,557,16,7.94,573,31.92,0.48,0.52
2,67,13,557,16,7.94,573,31.92,0.48,0.52
2,67,13,557,16,7.94,573,31.92,0.48,0.52
2,67,13,557,16,7.94,573,31.92,0.48,0.52
2,67,13,557,16,7.94,573,31.92,0.48,0.52
9,206,29,543,4,2.09,547,11.93,0.53,0.55
9,206,29,543,4,2.09,547,11.93,0.53,0.55
9,206,29,543,4,2.09,547,11.93,0.53,0.55
9,206,29,543,4,2.09,547,11.93,0.53,0.55
9,206,29,543,4,2.09,547,11.93,0.53,0.55
9,206,29,543,4,2.09,547,11.93,0.53,0.55
9,206,29,543,4,2.09,547,11.93,0.53,0.55
11,33,96,550,3,1.47,553,10.01,0.54,0.55
11,33,96,550,3,1.47,553,10.01,0.54,0.55
11,33,96,550,3,1.47,553,10.01,0.54,0.55
11,33,96,550,3,1.47,553,10.01,0.54,0.55
11,33,96,550,3,1.47,553,10.01,0.54,0.55
11,33,96,550,3,1.47,553,10.01,0.54,0.55
11,33,96,550,3,1.47,553,10.01,0.54,0.55
15,209,33,552,14,7.14,566,28.91,0.49,0.53
15,209,33,552,14,7.14,566,28.91,0.49,0.53
15,209,33,552,14,7.14,566,28.91,0.49,0.53
15,209,33,552,14,7.14,566,28.91,0.49,0.53
15,209,33,552,14,7.14,566,28.91,0.49,0.53
15,209,33,552,14,7.14,566,28.91,0.49,0.53
15,209,33,552,14,7.14,566,28.91,0.49,0.53
11,6,96,571,6,3.17,577,15.45,0.52,0.54
11,6,96,571,6,3.17,577,15.45,0.52,0.54
11,6,96,571,6,3.17,577,15.45,0.52,0.54
11,6,96,571,6,3.17,577,15.45,0.52,0.54
11,6,96,571,6,3.17,577,15.45,0.52,0.54
11,6,96,571,6,3.17,577,15.45,0.52,0.54
11,6,96,571,6,3.17,577,15.45,0.52,0.54
15,99,33,581,3,1.42,584,9.92,0.54,0.55
15,99,33,581,3,1.42,584,9.92,0.54,0.55
15,99,33,581,3,1.42,584,9.92,0.54,0.55
15,99,33,581,3,1.42,584,9.92,0.54,0.55
15,99,33,581,3,1.42,584,9.92,0.54,0.55
15,99,33,581,3,1.42,584,9.92,0.54,0.55
15,99,33,581,3,1.42,584,9.92,0.54,0.55
13,977,45,726,9,4.58,735,20.35,0.51,0.54
13,977,45,726,9,4.58,735,20.35,0.51,0.54
13,977,45,726,9,4.58,735,20.35,0.51,0.54
13,977,45,726,9,4.58,735,20.35,0.51,0.54
13,977,45,726,9,4.58,735,20.35,0.51,0.54
13,977,45,726,9,4.58,735,20.35,0.51,0.54
13,977,45,726,9,4.58,735,20.35,0.51,0.54
12,889,42,831,3,1.66,834,10.36,0.54,0.55
12,889,42,831,3,1.66,834,10.36,0.54,0.55
12,889,42,831,3,1.66,834,10.36,0.54,0.55
12,889,42,831,3,1.66,834,10.36,0.54,0.55
12,889,42,831,3,1.66,834,10.36,0.54,0.55
12,889,42,831,3,1.66,834,10.36,0.54,0.55
12,889,42,831,3,1.66,834,10.36,0.54,0.55
15,254,33,1042,9,4.64,1051,20.46,0.51,0.54
15,254,33,1042,9,4.64,1051,20.46,0.51,0.54
15,254,33,1042,9,4.64,1051,20.46,0.51,0.54
15,254,33,1042,9,4.64,1051,20.46,0.51,0.54
15,254,33,1042,9,4.64,1051,20.46,0.51,0.54
15,254,33,1042,9,4.64,1051,20.46,0.51,0.54
15,254,33,1042,9,4.64,1051,20.46,0.51,0.54
13,266,45,1069,7,3.68,1076,17.16,0.52,0.54
13,266,45,1069,7,3.68,1076,17.16,0.52,0.54
13,266,45,1069,7,3.68,1076,17.16,0.52,0.54
13,266,45,1069,7,3.68,1076,17.16,0.52,0.54
13,266,45,1069,7,3.68,1076,17.16,0.52,0.54
13,266,45,1069,7,3.68,1076,17.16,0.52,0.54
13,266,45,1069,7,3.68,1076,17.16,0.52,0.54
2,276,89,1105,14,7.04,1119,28.72,0.49,0.53
2,276,89,1105,14,7.04,1119,28.72,0.49,0.53
2,276,89,1105,14,7.04,1119,28.72,0.49,0.53
2,276,89,1105,14,7.04,1119,28.72,0.49,0.53
2,276,89,1105,14,7.04,1119,28.72,0.49,0.53
2,276,89,1105,14,7.04,1119,28.72,0.49,0.53
2,276,89,1105,14,7.04,1119,28.72,0.49,0.53
15,401,33,1134,18,8.82,1152,35.09,0.47000000000000003,0.52
15,401,33,1134,18,8.82,1152,35.09,0.47000000000000003,0.52
15,401,33,1134,18,8.82,1152,35.09,0.47000000000000003,0.52
15,401,33,1134,18,8.82,1152,35.09,0.47000000000000003,0.52
15,401,33,1134,18,8.82,1152,35.09,0.47000000000000003,0.52
15,401,33,1134,18,8.82,1152,35.09,0.47000000000000003,0.52
15,401,33,1134,18,8.82,1152,35.09,0.47000000000000003,0.52
2,426,89,1148,3,1.61,1151,10.27,0.54,0.55
2,426,89,1148,3,1.61,1151,10.27,0.54,0.55
2,426,89,1148,3,1.61,1151,10.27,0.54,0.55
2,426,89,1148,3,1.61,1151,10.27,0.54,0.55
2,426,89,1148,3,1.61,1151,10.27,0.54,0.55
2,426,89,1148,3,1.61,1151,10.27,0.54,0.55
2,426,89,1148,3,1.61,1151,10.27,0.54,0.55
2,749,89,1273,14,6.77,1287,28.25,0.49,0.53
2,749,89,1273,14,6.77,1287,28.25,0.49,0.53
2,749,89,1273,14,6.77,1287,28.25,0.49,0.53
2,749,89,1273,14,6.77,1287,28.25,0.49,0.53
2,749,89,1273,14,6.77,1287,28.25,0.49,0.53
2,749,89,1273,14,6.77,1287,28.25,0.49,0.53
2,749,89,1273,14,6.77,1287,28.25,0.49,0.53
2,566,89,1295,4,1.8900000000000001,1299,11.56,0.53,0.55
2,566,89,1295,4,1.8900000000000001,1299,11.56,0.53,0.55
2,566,89,1295,4,1.8900000000000001,1299,11.56,0.53,0.55
2,566,89,1295,4,1.8900000000000001,1299,11.56,0.53,0.55
2,566,89,1295,4,1.8900000000000001,1299,11.56,0.53,0.55
2,566,89,1295,4,1.8900000000000001,1299,11.56,0.53,0.55
2,566,89,1295,4,1.8900000000000001,1299,11.56,0.53,0.55
14,618,51,1317,17,8.51,1334,33.74,0.48,0.52
14,618,51,1317,17,8.51,1334,33.74,0.48,0.52
14,618,51,1317,17,8.51,1334,33.74,0.48,0.52
14,618,51,1317,17,8.51,1334,33.74,0.48,0.52
14,618,51,1317,17,8.51,1334,33.74,0.48,0.52
14,618,51,1317,17,8.51,1334,33.74,0.48,0.52
14,618,51,1317,17,8.51,1334,33.74,0.48,0.52
2,536,89,1327,12,5.79,1339,24.9,0.5,0.53
2,536,89,1327,12,5.79,1339,24.9,0.5,0.53
2,536,89,1327,12,5.79,1339,24.9,0.5,0.53
2,536,89,1327,12,5.79,1339,24.9,0.5,0.53
2,536,89,1327,12,5.79,1339,24.9,0.5,0.53
2,536,89,1327,12,5.79,1339,24.9,0.5,0.53
2,536,89,1327,12,5.79,1339,24.9,0.5,0.53
2,513,89,1357,14,7.22,1371,29.06,0.49,0.53
2,513,89,1357,14,7.22,1371,29.06,0.49,0.53
2,513,89,1357,14,7.22,1371,29.06,0.49,0.53
2,513,89,1357,14,7.22,1371,29.06,0.49,0.53
2,513,89,1357,14,7.22,1371,29.06,0.49,0.53
2,513,89,1357,14,7.22,1371,29.06,0.49,0.53
2,513,89,1357,14,7.22,1371,29.06,0.49,0.53
14,536,51,1351,18,8.8,1369,35.06,0.47000000000000003,0.52
14,536,51,1351,18,8.8,1369,35.06,0.47000000000000003,0.52
14,536,51,1351,18,8.8,1369,35.06,0.47000000000000003,0.52
14,536,51,1351,18,8.8,1369,35.06,0.47000000000000003,0.52
14,536,51,1351,18,8.8,1369,35.06,0.47000000000000003,0.52
14,536,51,1351,18,8.8,1369,35.06,0.47000000000000003,0.52
14,536,51,1351,18,8.8,1369,35.06,0.47000000000000003,0.52
14,731,51,1401,3,1.58,1404,10.22,0.54,0.55
14,731,51,1401,3,1.58,1404,10.22,0.54,0.55
14,731,51,1401,3,1.58,1404,10.22,0.54,0.55
14,731,51,1401,3,1.58,1404,10.22,0.54,0.55
14,731,51,1401,3,1.58,1404,10.22,0.54,0.55
14,731,51,1401,3,1.58,1404,10.22,0.54,0.55
14,731,51,1401,3,1.58,1404,10.22,0.54,0.55
