square_index,rider_id,driver_idx,trip_start_timestamp,trip_duration,ride_miles,trip_end_timestamp,price_of_ride,rider_acceptance_prob,driver_acceptance_prob
13,847,28,70,9,4.38,79,19.99,0.51,0.54
3,61,84,362,13,6.45,375,26.88,0.5,0.53
12,222,77,385,13,6.62,398,27.19,0.49,0.53
2,47,59,412,4,1.8800000000000001,416,11.55,0.53,0.55
3,13,84,415,12,6.18,427,25.6,0.5,0.53
11,89,39,416,19,9.26,435,36.67,0.47000000000000003,0.52
12,624,77,403,10,4.89,413,21.7,0.51,0.54
3,238,84,432,12,5.86,444,25.02,0.5,0.53
12,218,77,442,11,5.74,453,24.03,0.5,0.53
14,14,56,421,16,7.95,437,31.95,0.48,0.52
3,232,84,465,8,4.16,473,18.81,0.52,0.54
8,99,26,455,18,8.82,473,35.09,0.47000000000000003,0.52
9,88,78,476,9,4.49,485,20.18,0.51,0.54
12,976,77,465,14,6.83,479,28.35,0.49,0.53
13,150,66,478,11,5.4,489,23.4,0.5,0.53
14,152,56,465,8,3.84,473,18.23,0.52,0.54
15,63,35,475,5,2.38,480,13.23,0.53,0.55
3,206,84,491,9,4.47,500,20.15,0.51,0.54
9,179,78,498,3,1.44,501,9.97,0.54,0.55
10,53,91,494,5,2.62,499,13.67,0.53,0.55
15,24,35,489,2,1.11,491,8.58,0.54,0.55
1,18,46,538,14,6.76,552,28.22,0.49,0.53
3,159,84,521,15,7.47,536,30.3,0.49,0.52
8,159,26,524,7,3.57,531,16.95,0.52,0.54
9,238,78,546,5,2.28,551,13.06,0.53,0.55
10,18,91,558,11,5.33,569,23.28,0.5,0.53
3,812,84,578,9,4.58,587,20.36,0.51,0.54
12,240,77,584,7,3.73,591,17.24,0.52,0.54
9,987,78,623,14,7.16,637,28.95,0.49,0.53
6,831,62,647,4,1.81,651,11.41,0.53,0.55
7,759,76,689,13,6.36,702,26.72,0.5,0.53
7,934,76,727,14,6.97,741,28.6,0.49,0.53
7,753,76,778,8,3.92,786,18.37,0.52,0.54
8,801,50,899,8,3.87,907,18.27,0.52,0.54
1,422,61,937,1,0.53,938,6.75,0.55,0.55
3,422,73,943,4,1.82,947,11.44,0.53,0.55
1,453,61,1019,4,2.18,1023,12.09,0.53,0.55
3,325,73,1018,14,6.95,1032,28.57,0.49,0.53
15,355,8,1097,8,4.16,1105,18.82,0.52,0.54
15,288,8,1117,9,4.55,1126,20.3,0.51,0.54
15,275,8,1169,15,7.53,1184,30.41,0.49,0.52
15,318,8,1236,16,7.83,1252,31.73,0.48,0.52
12,883,91,206,9,4.68,215,20.53,0.51,0.54
12,883,91,206,9,4.68,215,20.53,0.51,0.54
1,759,35,348,15,7.29,363,29.98,0.49,0.53
1,759,35,348,15,7.29,363,29.98,0.49,0.53
4,18,1,381,13,6.28,394,26.58,0.5,0.53
4,18,1,381,13,6.28,394,26.58,0.5,0.53
7,89,18,415,18,9.15,433,35.69,0.47000000000000003,0.52
7,89,18,415,18,9.15,433,35.69,0.47000000000000003,0.52
10,127,47,399,6,2.88,405,14.92,0.53,0.54
10,127,47,399,6,2.88,405,14.92,0.53,0.54
3,63,61,441,23,11.34,464,43.59,0.45,0.51
3,63,61,441,23,11.34,464,43.59,0.45,0.51
6,56,5,432,9,4.25,441,19.76,0.51,0.54
6,56,5,432,9,4.25,441,19.76,0.51,0.54
6,88,5,474,11,5.35,485,23.32,0.5,0.53
6,88,5,474,11,5.35,485,23.32,0.5,0.53
9,129,14,472,12,5.84,484,24.98,0.5,0.53
9,129,14,472,12,5.84,484,24.98,0.5,0.53
7,31,18,496,17,8.48,513,33.69,0.48,0.52
7,31,18,496,17,8.48,513,33.69,0.48,0.52
9,222,14,497,8,3.97,505,18.47,0.52,0.54
9,222,14,497,8,3.97,505,18.47,0.52,0.54
9,513,14,527,11,5.31,538,23.25,0.5,0.53
9,513,14,527,11,5.31,538,23.25,0.5,0.53
12,11,91,563,11,5.44,574,23.48,0.5,0.53
12,11,91,563,11,5.44,574,23.48,0.5,0.53
0,154,20,591,18,9.25,609,35.87,0.47000000000000003,0.52
0,154,20,591,18,9.25,609,35.87,0.47000000000000003,0.52
7,88,18,594,4,2.19,598,12.1,0.53,0.55
7,88,18,594,4,2.19,598,12.1,0.53,0.55
12,702,91,616,6,2.91,622,14.98,0.53,0.54
12,702,91,616,6,2.91,622,14.98,0.53,0.54
2,949,11,735,11,5.28,746,23.19,0.5,0.53
2,949,11,735,11,5.28,746,23.19,0.5,0.53
3,310,4,1005,18,8.95,1023,35.34,0.47000000000000003,0.52
3,310,4,1005,18,8.95,1023,35.34,0.47000000000000003,0.52
4,458,70,1028,10,5.06,1038,22.0,0.51,0.53
4,458,70,1028,10,5.06,1038,22.0,0.51,0.53
8,281,97,1032,17,8.69,1049,34.07,0.48,0.52
8,281,97,1032,17,8.69,1049,34.07,0.48,0.52
3,300,4,1075,17,8.31,1092,33.39,0.48,0.52
3,300,4,1075,17,8.31,1092,33.39,0.48,0.52
4,319,70,1076,7,3.73,1083,17.24,0.52,0.54
4,319,70,1076,7,3.73,1083,17.24,0.52,0.54
8,382,97,1064,10,5.05,1074,22.0,0.51,0.53
8,382,97,1064,10,5.05,1074,22.0,0.51,0.53
4,462,70,1101,17,8.36,1118,33.48,0.48,0.52
4,462,70,1101,17,8.36,1118,33.48,0.48,0.52
4,341,70,1119,4,1.91,1123,11.59,0.53,0.55
4,341,70,1119,4,1.91,1123,11.59,0.53,0.55
8,474,97,1110,8,3.8,1118,18.16,0.52,0.54
8,474,97,1110,8,3.8,1118,18.16,0.52,0.54
2,707,93,1219,11,5.45,1230,23.51,0.5,0.53
2,707,93,1219,11,5.45,1230,23.51,0.5,0.53
8,632,97,1218,6,2.96,1224,15.07,0.52,0.54
8,632,97,1218,6,2.96,1224,15.07,0.52,0.54
2,629,93,1252,7,3.5,1259,16.83,0.52,0.54
2,629,93,1252,7,3.5,1259,16.83,0.52,0.54
9,616,40,1231,8,3.84,1239,18.23,0.52,0.54
9,616,40,1231,8,3.84,1239,18.23,0.52,0.54
12,648,3,1237,3,1.32,1240,9.74,0.54,0.55
12,648,3,1237,3,1.32,1240,9.74,0.54,0.55
2,540,93,1263,7,3.42,1270,16.69,0.52,0.54
2,540,93,1263,7,3.42,1270,16.69,0.52,0.54
8,683,97,1273,6,2.83,1279,14.84,0.53,0.54
8,683,97,1273,6,2.83,1279,14.84,0.53,0.54
9,586,40,1268,5,2.66,1273,13.74,0.53,0.55
9,586,40,1268,5,2.66,1273,13.74,0.53,0.55
12,525,3,1276,12,5.75,1288,24.83,0.5,0.53
12,525,3,1276,12,5.75,1288,24.83,0.5,0.53
7,586,50,1302,9,4.7,1311,20.58,0.51,0.54
7,586,50,1302,9,4.7,1311,20.58,0.51,0.54
8,606,97,1303,6,3.04,1309,15.22,0.52,0.54
8,606,97,1303,6,3.04,1309,15.22,0.52,0.54
12,650,3,1305,19,9.31,1324,36.77,0.47000000000000003,0.52
12,650,3,1305,19,9.31,1324,36.77,0.47000000000000003,0.52
8,528,97,1325,11,5.51,1336,23.61,0.5,0.53
8,528,97,1325,11,5.51,1336,23.61,0.5,0.53
9,823,40,1320,6,3.12,1326,15.35,0.52,0.54
9,823,40,1320,6,3.12,1326,15.35,0.52,0.54
12,743,3,1336,18,9.2,1354,35.79,0.47000000000000003,0.52
12,743,3,1336,18,9.2,1354,35.79,0.47000000000000003,0.52
14,225,12,347,4,2.15,351,12.03,0.53,0.55
14,225,12,347,4,2.15,351,12.03,0.53,0.55
14,225,12,347,4,2.15,351,12.03,0.53,0.55
13,174,87,382,13,6.41,395,26.8,0.5,0.53
13,174,87,382,13,6.41,395,26.8,0.5,0.53
13,174,87,382,13,6.41,395,26.8,0.5,0.53
13,187,87,391,4,2.23,395,12.18,0.53,0.55
13,187,87,391,4,2.23,395,12.18,0.53,0.55
13,187,87,391,4,2.23,395,12.18,0.53,0.55
1,144,83,428,12,5.94,440,25.17,0.5,0.53
1,144,83,428,12,5.94,440,25.17,0.5,0.53
1,144,83,428,12,5.94,440,25.17,0.5,0.53
4,185,75,433,13,6.68,446,27.3,0.49,0.53
4,185,75,433,13,6.68,446,27.3,0.49,0.53
4,185,75,433,13,6.68,446,27.3,0.49,0.53
14,93,12,448,6,2.7600000000000002,454,14.7,0.53,0.54
14,93,12,448,6,2.7600000000000002,454,14.7,0.53,0.54
14,93,12,448,6,2.7600000000000002,454,14.7,0.53,0.54
4,185,75,465,13,6.59,478,27.14,0.49,0.53
4,185,75,465,13,6.59,478,27.14,0.49,0.53
4,185,75,465,13,6.59,478,27.14,0.49,0.53
13,48,87,454,13,6.63,467,27.21,0.49,0.53
13,48,87,454,13,6.63,467,27.21,0.49,0.53
13,48,87,454,13,6.63,467,27.21,0.49,0.53
3,248,78,488,19,9.34,507,36.82,0.47000000000000003,0.52
3,248,78,488,19,9.34,507,36.82,0.47000000000000003,0.52
3,248,78,488,19,9.34,507,36.82,0.47000000000000003,0.52
4,203,75,493,14,6.92,507,28.51,0.49,0.53
4,203,75,493,14,6.92,507,28.51,0.49,0.53
4,203,75,493,14,6.92,507,28.51,0.49,0.53
9,176,85,480,5,2.57,485,13.58,0.53,0.55
9,176,85,480,5,2.57,485,13.58,0.53,0.55
9,176,85,480,5,2.57,485,13.58,0.53,0.55
10,236,74,483,12,6.19,495,25.63,0.5,0.53
10,236,74,483,12,6.19,495,25.63,0.5,0.53
10,236,74,483,12,6.19,495,25.63,0.5,0.53
11,770,38,501,18,8.98,519,35.38,0.47000000000000003,0.52
11,770,38,501,18,8.98,519,35.38,0.47000000000000003,0.52
11,770,38,501,18,8.98,519,35.38,0.47000000000000003,0.52
13,61,87,493,19,9.49,512,37.09,0.47000000000000003,0.52
13,61,87,493,19,9.49,512,37.09,0.47000000000000003,0.52
13,61,87,493,19,9.49,512,37.09,0.47000000000000003,0.52
14,150,12,491,16,7.79,507,31.66,0.48,0.52
14,150,12,491,16,7.79,507,31.66,0.48,0.52
14,150,12,491,16,7.79,507,31.66,0.48,0.52
1,113,83,520,4,2.17,524,12.07,0.53,0.55
1,113,83,520,4,2.17,524,12.07,0.53,0.55
1,113,83,520,4,2.17,524,12.07,0.53,0.55
2,826,84,510,14,7.0,524,28.67,0.49,0.53
2,826,84,510,14,7.0,524,28.67,0.49,0.53
2,826,84,510,14,7.0,524,28.67,0.49,0.53
3,227,78,515,6,3.1,521,15.32,0.52,0.54
3,227,78,515,6,3.1,521,15.32,0.52,0.54
3,227,78,515,6,3.1,521,15.32,0.52,0.54
4,143,75,525,8,4.12,533,18.74,0.52,0.54
4,143,75,525,8,4.12,533,18.74,0.52,0.54
4,143,75,525,8,4.12,533,18.74,0.52,0.54
11,18,38,528,10,5.21,538,22.29,0.51,0.53
11,18,38,528,10,5.21,538,22.29,0.51,0.53
11,18,38,528,10,5.21,538,22.29,0.51,0.53
12,62,39,533,13,6.49,546,26.95,0.5,0.53
12,62,39,533,13,6.49,546,26.95,0.5,0.53
12,62,39,533,13,6.49,546,26.95,0.5,0.53
13,214,87,537,4,1.82,541,11.44,0.53,0.55
13,214,87,537,4,1.82,541,11.44,0.53,0.55
13,214,87,537,4,1.82,541,11.44,0.53,0.55
0,203,69,559,12,6.2,571,25.64,0.5,0.53
0,203,69,559,12,6.2,571,25.64,0.5,0.53
0,203,69,559,12,6.2,571,25.64,0.5,0.53
9,768,85,550,12,5.87,562,25.04,0.5,0.53
9,768,85,550,12,5.87,562,25.04,0.5,0.53
9,768,85,550,12,5.87,562,25.04,0.5,0.53
11,837,38,549,10,5.24,559,22.34,0.51,0.53
11,837,38,549,10,5.24,559,22.34,0.51,0.53
11,837,38,549,10,5.24,559,22.34,0.51,0.53
15,150,64,566,2,1.09,568,8.55,0.54,0.55
15,150,64,566,2,1.09,568,8.55,0.54,0.55
15,150,64,566,2,1.09,568,8.55,0.54,0.55
0,28,69,582,10,4.87,592,21.66,0.51,0.54
0,28,69,582,10,4.87,592,21.66,0.51,0.54
0,28,69,582,10,4.87,592,21.66,0.51,0.54
2,170,84,576,0,0.25,576,5.45,0.55,0.56
2,170,84,576,0,0.25,576,5.45,0.55,0.56
2,170,84,576,0,0.25,576,5.45,0.55,0.56
4,16,75,583,5,2.4,588,13.28,0.53,0.55
4,16,75,583,5,2.4,588,13.28,0.53,0.55
4,16,75,583,5,2.4,588,13.28,0.53,0.55
15,976,64,615,2,1.18,617,8.7,0.54,0.55
15,976,64,615,2,1.18,617,8.7,0.54,0.55
15,976,64,615,2,1.18,617,8.7,0.54,0.55
0,821,69,656,11,5.5,667,23.6,0.5,0.53
0,821,69,656,11,5.5,667,23.6,0.5,0.53
0,821,69,656,11,5.5,667,23.6,0.5,0.53
7,430,22,1049,4,2.15,1053,12.03,0.53,0.55
7,430,22,1049,4,2.15,1053,12.03,0.53,0.55
7,430,22,1049,4,2.15,1053,12.03,0.53,0.55
7,864,22,1078,15,7.37,1093,30.11,0.49,0.52
7,864,22,1078,15,7.37,1093,30.11,0.49,0.52
7,864,22,1078,15,7.37,1093,30.11,0.49,0.52
6,409,37,1128,11,5.64,1139,23.84,0.5,0.53
6,409,37,1128,11,5.64,1139,23.84,0.5,0.53
6,409,37,1128,11,5.64,1139,23.84,0.5,0.53
6,305,37,1203,5,2.5,1208,13.45,0.53,0.55
6,305,37,1203,5,2.5,1208,13.45,0.53,0.55
6,305,37,1203,5,2.5,1208,13.45,0.53,0.55
15,544,35,1200,6,3.02,1206,15.18,0.52,0.54
15,544,35,1200,6,3.02,1206,15.18,0.52,0.54
15,544,35,1200,6,3.02,1206,15.18,0.52,0.54
13,413,42,1236,18,9.13,1254,35.66,0.47000000000000003,0.52
13,413,42,1236,18,9.13,1254,35.66,0.47000000000000003,0.52
13,413,42,1236,18,9.13,1254,35.66,0.47000000000000003,0.52
15,749,35,1235,20,10.12,1255,39.02,0.47000000000000003,0.51
15,749,35,1235,20,10.12,1255,39.02,0.47000000000000003,0.51
15,749,35,1235,20,10.12,1255,39.02,0.47000000000000003,0.51
0,736,89,1272,18,8.98,1290,35.38,0.47000000000000003,0.52
0,736,89,1272,18,8.98,1290,35.38,0.47000000000000003,0.52
0,736,89,1272,18,8.98,1290,35.38,0.47000000000000003,0.52
6,683,37,1281,11,5.26,1292,23.16,0.5,0.53
6,683,37,1281,11,5.26,1292,23.16,0.5,0.53
6,683,37,1281,11,5.26,1292,23.16,0.5,0.53
13,569,42,1279,7,3.42,1286,16.68,0.52,0.54
13,569,42,1279,7,3.42,1286,16.68,0.52,0.54
13,569,42,1279,7,3.42,1286,16.68,0.52,0.54
6,587,37,1315,13,6.73,1328,27.39,0.49,0.53
6,587,37,1315,13,6.73,1328,27.39,0.49,0.53
6,587,37,1315,13,6.73,1328,27.39,0.49,0.53
13,543,42,1306,9,4.26,1315,19.77,0.51,0.54
13,543,42,1306,9,4.26,1315,19.77,0.51,0.54
13,543,42,1306,9,4.26,1315,19.77,0.51,0.54
6,699,37,1348,12,6.02,1360,25.32,0.5,0.53
6,699,37,1348,12,6.02,1360,25.32,0.5,0.53
6,699,37,1348,12,6.02,1360,25.32,0.5,0.53
6,544,37,1354,10,5.11,1364,22.1,0.51,0.53
6,544,37,1354,10,5.11,1364,22.1,0.51,0.53
6,544,37,1354,10,5.11,1364,22.1,0.51,0.53
15,783,35,1361,14,7.08,1375,28.81,0.49,0.53
15,783,35,1361,14,7.08,1375,28.81,0.49,0.53
15,783,35,1361,14,7.08,1375,28.81,0.49,0.53
3,633,23,1390,17,8.39,1407,33.53,0.48,0.52
3,633,23,1390,17,8.39,1407,33.53,0.48,0.52
3,633,23,1390,17,8.39,1407,33.53,0.48,0.52
13,597,42,1419,13,6.3,1432,26.61,0.5,0.53
13,597,42,1419,13,6.3,1432,26.61,0.5,0.53
13,597,42,1419,13,6.3,1432,26.61,0.5,0.53
15,714,35,1422,17,8.72,1439,34.13,0.48,0.52
15,714,35,1422,17,8.72,1439,34.13,0.48,0.52
15,714,35,1422,17,8.72,1439,34.13,0.48,0.52
9,157,95,400,11,5.73,411,24.02,0.5,0.53
9,157,95,400,11,5.73,411,24.02,0.5,0.53
9,157,95,400,11,5.73,411,24.02,0.5,0.53
9,157,95,400,11,5.73,411,24.02,0.5,0.53
14,78,46,434,20,9.79,454,38.41,0.47000000000000003,0.51
14,78,46,434,20,9.79,454,38.41,0.47000000000000003,0.51
14,78,46,434,20,9.79,454,38.41,0.47000000000000003,0.51
14,78,46,434,20,9.79,454,38.41,0.47000000000000003,0.51
3,129,50,451,17,8.62,468,33.94,0.48,0.52
3,129,50,451,17,8.62,468,33.94,0.48,0.52
3,129,50,451,17,8.62,468,33.94,0.48,0.52
3,129,50,451,17,8.62,468,33.94,0.48,0.52
14,80,46,474,1,0.74,475,7.13,0.54,0.55
14,80,46,474,1,0.74,475,7.13,0.54,0.55
14,80,46,474,1,0.74,475,7.13,0.54,0.55
14,80,46,474,1,0.74,475,7.13,0.54,0.55
4,108,52,507,10,4.92,517,21.76,0.51,0.54
4,108,52,507,10,4.92,517,21.76,0.51,0.54
4,108,52,507,10,4.92,517,21.76,0.51,0.54
4,108,52,507,10,4.92,517,21.76,0.51,0.54
7,157,59,490,17,8.65,507,34.0,0.48,0.52
7,157,59,490,17,8.65,507,34.0,0.48,0.52
7,157,59,490,17,8.65,507,34.0,0.48,0.52
7,157,59,490,17,8.65,507,34.0,0.48,0.52
12,13,31,491,1,0.68,492,7.02,0.54,0.55
12,13,31,491,1,0.68,492,7.02,0.54,0.55
12,13,31,491,1,0.68,492,7.02,0.54,0.55
12,13,31,491,1,0.68,492,7.02,0.54,0.55
13,80,85,533,12,5.79,545,24.9,0.5,0.53
13,80,85,533,12,5.79,545,24.9,0.5,0.53
13,80,85,533,12,5.79,545,24.9,0.5,0.53
13,80,85,533,12,5.79,545,24.9,0.5,0.53
13,86,85,591,13,6.27,604,26.54,0.5,0.53
13,86,85,591,13,6.27,604,26.54,0.5,0.53
13,86,85,591,13,6.27,604,26.54,0.5,0.53
13,86,85,591,13,6.27,604,26.54,0.5,0.53
7,115,59,621,13,6.33,634,26.66,0.5,0.53
7,115,59,621,13,6.33,634,26.66,0.5,0.53
7,115,59,621,13,6.33,634,26.66,0.5,0.53
7,115,59,621,13,6.33,634,26.66,0.5,0.53
13,223,85,604,7,3.58,611,16.97,0.52,0.54
13,223,85,604,7,3.58,611,16.97,0.52,0.54
13,223,85,604,7,3.58,611,16.97,0.52,0.54
13,223,85,604,7,3.58,611,16.97,0.52,0.54
10,826,63,716,13,6.7,729,27.33,0.49,0.53
10,826,63,716,13,6.7,729,27.33,0.49,0.53
10,826,63,716,13,6.7,729,27.33,0.49,0.53
10,826,63,716,13,6.7,729,27.33,0.49,0.53
7,860,59,744,9,4.61,753,20.4,0.51,0.54
7,860,59,744,9,4.61,753,20.4,0.51,0.54
7,860,59,744,9,4.61,753,20.4,0.51,0.54
7,860,59,744,9,4.61,753,20.4,0.51,0.54
8,754,7,833,9,4.67,842,20.52,0.51,0.54
8,754,7,833,9,4.67,842,20.52,0.51,0.54
8,754,7,833,9,4.67,842,20.52,0.51,0.54
8,754,7,833,9,4.67,842,20.52,0.51,0.54
11,360,94,946,5,2.5100000000000002,951,13.47,0.53,0.55
11,360,94,946,5,2.5100000000000002,951,13.47,0.53,0.55
11,360,94,946,5,2.5100000000000002,951,13.47,0.53,0.55
11,360,94,946,5,2.5100000000000002,951,13.47,0.53,0.55
8,422,7,1004,6,3.18,1010,15.46,0.52,0.54
8,422,7,1004,6,3.18,1010,15.46,0.52,0.54
8,422,7,1004,6,3.18,1010,15.46,0.52,0.54
8,422,7,1004,6,3.18,1010,15.46,0.52,0.54
11,462,94,1046,8,3.93,1054,18.39,0.52,0.54
11,462,94,1046,8,3.93,1054,18.39,0.52,0.54
11,462,94,1046,8,3.93,1054,18.39,0.52,0.54
11,462,94,1046,8,3.93,1054,18.39,0.52,0.54
0,860,14,1078,15,7.38,1093,30.13,0.49,0.52
0,860,14,1078,15,7.38,1093,30.13,0.49,0.52
0,860,14,1078,15,7.38,1093,30.13,0.49,0.52
0,860,14,1078,15,7.38,1093,30.13,0.49,0.52
15,402,82,1077,4,2.12,1081,11.97,0.53,0.55
15,402,82,1077,4,2.12,1081,11.97,0.53,0.55
15,402,82,1077,4,2.12,1081,11.97,0.53,0.55
15,402,82,1077,4,2.12,1081,11.97,0.53,0.55
0,299,14,1109,15,7.63,1124,30.58,0.49,0.52
0,299,14,1109,15,7.63,1124,30.58,0.49,0.52
0,299,14,1109,15,7.63,1124,30.58,0.49,0.52
0,299,14,1109,15,7.63,1124,30.58,0.49,0.52
0,476,14,1112,11,5.54,1123,23.67,0.5,0.53
0,476,14,1112,11,5.54,1123,23.67,0.5,0.53
0,476,14,1112,11,5.54,1123,23.67,0.5,0.53
0,476,14,1112,11,5.54,1123,23.67,0.5,0.53
7,457,59,1162,0,0.14,1162,5.25,0.55,0.56
7,457,59,1162,0,0.14,1162,5.25,0.55,0.56
7,457,59,1162,0,0.14,1162,5.25,0.55,0.56
7,457,59,1162,0,0.14,1162,5.25,0.55,0.56
7,822,59,1228,12,5.92,1240,25.13,0.5,0.53
7,822,59,1228,12,5.92,1240,25.13,0.5,0.53
7,822,59,1228,12,5.92,1240,25.13,0.5,0.53
7,822,59,1228,12,5.92,1240,25.13,0.5,0.53
7,636,59,1253,7,3.55,1260,16.91,0.52,0.54
7,636,59,1253,7,3.55,1260,16.91,0.52,0.54
7,636,59,1253,7,3.55,1260,16.91,0.52,0.54
7,636,59,1253,7,3.55,1260,16.91,0.52,0.54
9,506,91,1293,5,2.41,1298,13.28,0.53,0.55
9,506,91,1293,5,2.41,1298,13.28,0.53,0.55
9,506,91,1293,5,2.41,1298,13.28,0.53,0.55
9,506,91,1293,5,2.41,1298,13.28,0.53,0.55
9,602,91,1332,10,5.11,1342,22.11,0.51,0.53
9,602,91,1332,10,5.11,1342,22.11,0.51,0.53
9,602,91,1332,10,5.11,1342,22.11,0.51,0.53
9,602,91,1332,10,5.11,1342,22.11,0.51,0.53
9,502,91,1350,14,7.15,1364,28.93,0.49,0.53
9,502,91,1350,14,7.15,1364,28.93,0.49,0.53
9,502,91,1350,14,7.15,1364,28.93,0.49,0.53
9,502,91,1350,14,7.15,1364,28.93,0.49,0.53
14,686,34,1361,17,8.53,1378,33.78,0.48,0.52
14,686,34,1361,17,8.53,1378,33.78,0.48,0.52
14,686,34,1361,17,8.53,1378,33.78,0.48,0.52
14,686,34,1361,17,8.53,1378,33.78,0.48,0.52
9,669,91,1396,2,1.06,1398,8.5,0.54,0.55
9,669,91,1396,2,1.06,1398,8.5,0.54,0.55
9,669,91,1396,2,1.06,1398,8.5,0.54,0.55
9,669,91,1396,2,1.06,1398,8.5,0.54,0.55
15,998,27,1,16,7.99,17,32.02,0.48,0.52
15,998,27,1,16,7.99,17,32.02,0.48,0.52
15,998,27,1,16,7.99,17,32.02,0.48,0.52
15,998,27,1,16,7.99,17,32.02,0.48,0.52
15,998,27,1,16,7.99,17,32.02,0.48,0.52
15,900,27,84,15,7.55,99,30.44,0.49,0.52
15,900,27,84,15,7.55,99,30.44,0.49,0.52
15,900,27,84,15,7.55,99,30.44,0.49,0.52
15,900,27,84,15,7.55,99,30.44,0.49,0.52
15,900,27,84,15,7.55,99,30.44,0.49,0.52
5,962,93,163,14,6.79,177,28.28,0.49,0.53
5,962,93,163,14,6.79,177,28.28,0.49,0.53
5,962,93,163,14,6.79,177,28.28,0.49,0.53
5,962,93,163,14,6.79,177,28.28,0.49,0.53
5,962,93,163,14,6.79,177,28.28,0.49,0.53
15,925,27,267,1,0.6000000000000001,268,6.88,0.55,0.55
15,925,27,267,1,0.6000000000000001,268,6.88,0.55,0.55
15,925,27,267,1,0.6000000000000001,268,6.88,0.55,0.55
15,925,27,267,1,0.6000000000000001,268,6.88,0.55,0.55
15,925,27,267,1,0.6000000000000001,268,6.88,0.55,0.55
13,238,6,412,18,9.17,430,35.73,0.47000000000000003,0.52
13,238,6,412,18,9.17,430,35.73,0.47000000000000003,0.52
13,238,6,412,18,9.17,430,35.73,0.47000000000000003,0.52
13,238,6,412,18,9.17,430,35.73,0.47000000000000003,0.52
13,238,6,412,18,9.17,430,35.73,0.47000000000000003,0.52
1,877,19,435,1,0.71,436,7.08,0.54,0.55
1,877,19,435,1,0.71,436,7.08,0.54,0.55
1,877,19,435,1,0.71,436,7.08,0.54,0.55
1,877,19,435,1,0.71,436,7.08,0.54,0.55
1,877,19,435,1,0.71,436,7.08,0.54,0.55
13,902,6,447,11,5.66,458,23.87,0.5,0.53
13,902,6,447,11,5.66,458,23.87,0.5,0.53
13,902,6,447,11,5.66,458,23.87,0.5,0.53
13,902,6,447,11,5.66,458,23.87,0.5,0.53
13,902,6,447,11,5.66,458,23.87,0.5,0.53
15,84,27,437,7,3.44,444,16.72,0.52,0.54
15,84,27,437,7,3.44,444,16.72,0.52,0.54
15,84,27,437,7,3.44,444,16.72,0.52,0.54
15,84,27,437,7,3.44,444,16.72,0.52,0.54
15,84,27,437,7,3.44,444,16.72,0.52,0.54
1,18,19,452,7,3.67,459,17.13,0.52,0.54
1,18,19,452,7,3.67,459,17.13,0.52,0.54
1,18,19,452,7,3.67,459,17.13,0.52,0.54
1,18,19,452,7,3.67,459,17.13,0.52,0.54
1,18,19,452,7,3.67,459,17.13,0.52,0.54
2,12,75,490,10,5.18,500,22.23,0.51,0.53
2,12,75,490,10,5.18,500,22.23,0.51,0.53
2,12,75,490,10,5.18,500,22.23,0.51,0.53
2,12,75,490,10,5.18,500,22.23,0.51,0.53
2,12,75,490,10,5.18,500,22.23,0.51,0.53
3,185,95,507,9,4.66,516,20.49,0.51,0.54
3,185,95,507,9,4.66,516,20.49,0.51,0.54
3,185,95,507,9,4.66,516,20.49,0.51,0.54
3,185,95,507,9,4.66,516,20.49,0.51,0.54
3,185,95,507,9,4.66,516,20.49,0.51,0.54
4,93,86,495,6,3.12,501,15.35,0.52,0.54
4,93,86,495,6,3.12,501,15.35,0.52,0.54
4,93,86,495,6,3.12,501,15.35,0.52,0.54
4,93,86,495,6,3.12,501,15.35,0.52,0.54
4,93,86,495,6,3.12,501,15.35,0.52,0.54
12,88,34,480,15,7.48,495,30.32,0.49,0.52
12,88,34,480,15,7.48,495,30.32,0.49,0.52
12,88,34,480,15,7.48,495,30.32,0.49,0.52
12,88,34,480,15,7.48,495,30.32,0.49,0.52
12,88,34,480,15,7.48,495,30.32,0.49,0.52
2,53,75,510,13,6.34,523,26.67,0.5,0.53
2,53,75,510,13,6.34,523,26.67,0.5,0.53
2,53,75,510,13,6.34,523,26.67,0.5,0.53
2,53,75,510,13,6.34,523,26.67,0.5,0.53
2,53,75,510,13,6.34,523,26.67,0.5,0.53
3,135,95,524,19,9.36,543,36.85,0.47000000000000003,0.52
3,135,95,524,19,9.36,543,36.85,0.47000000000000003,0.52
3,135,95,524,19,9.36,543,36.85,0.47000000000000003,0.52
3,135,95,524,19,9.36,543,36.85,0.47000000000000003,0.52
3,135,95,524,19,9.36,543,36.85,0.47000000000000003,0.52
12,156,34,528,11,5.6,539,23.77,0.5,0.53
12,156,34,528,11,5.6,539,23.77,0.5,0.53
12,156,34,528,11,5.6,539,23.77,0.5,0.53
12,156,34,528,11,5.6,539,23.77,0.5,0.53
12,156,34,528,11,5.6,539,23.77,0.5,0.53
13,172,6,522,3,1.74,525,10.51,0.54,0.55
13,172,6,522,3,1.74,525,10.51,0.54,0.55
13,172,6,522,3,1.74,525,10.51,0.54,0.55
13,172,6,522,3,1.74,525,10.51,0.54,0.55
13,172,6,522,3,1.74,525,10.51,0.54,0.55
15,5,27,525,22,10.95,547,42.09,0.46,0.51
15,5,27,525,22,10.95,547,42.09,0.46,0.51
15,5,27,525,22,10.95,547,42.09,0.46,0.51
15,5,27,525,22,10.95,547,42.09,0.46,0.51
15,5,27,525,22,10.95,547,42.09,0.46,0.51
3,18,95,555,19,9.48,574,37.08,0.47000000000000003,0.52
3,18,95,555,19,9.48,574,37.08,0.47000000000000003,0.52
3,18,95,555,19,9.48,574,37.08,0.47000000000000003,0.52
3,18,95,555,19,9.48,574,37.08,0.47000000000000003,0.52
3,18,95,555,19,9.48,574,37.08,0.47000000000000003,0.52
2,122,75,579,2,0.92,581,8.23,0.54,0.55
2,122,75,579,2,0.92,581,8.23,0.54,0.55
2,122,75,579,2,0.92,581,8.23,0.54,0.55
2,122,75,579,2,0.92,581,8.23,0.54,0.55
2,122,75,579,2,0.92,581,8.23,0.54,0.55
12,92,34,596,16,8.24,612,32.48,0.48,0.52
12,92,34,596,16,8.24,612,32.48,0.48,0.52
12,92,34,596,16,8.24,612,32.48,0.48,0.52
12,92,34,596,16,8.24,612,32.48,0.48,0.52
12,92,34,596,16,8.24,612,32.48,0.48,0.52
11,218,13,612,16,8.01,628,32.06,0.48,0.52
11,218,13,612,16,8.01,628,32.06,0.48,0.52
11,218,13,612,16,8.01,628,32.06,0.48,0.52
11,218,13,612,16,8.01,628,32.06,0.48,0.52
11,218,13,612,16,8.01,628,32.06,0.48,0.52
3,410,9,1042,18,8.8,1060,35.06,0.47000000000000003,0.52
3,410,9,1042,18,8.8,1060,35.06,0.47000000000000003,0.52
3,410,9,1042,18,8.8,1060,35.06,0.47000000000000003,0.52
3,410,9,1042,18,8.8,1060,35.06,0.47000000000000003,0.52
3,410,9,1042,18,8.8,1060,35.06,0.47000000000000003,0.52
6,424,3,1031,10,4.97,1041,21.84,0.51,0.54
6,424,3,1031,10,4.97,1041,21.84,0.51,0.54
6,424,3,1031,10,4.97,1041,21.84,0.51,0.54
6,424,3,1031,10,4.97,1041,21.84,0.51,0.54
6,424,3,1031,10,4.97,1041,21.84,0.51,0.54
2,341,75,1071,10,4.86,1081,21.64,0.51,0.54
2,341,75,1071,10,4.86,1081,21.64,0.51,0.54
2,341,75,1071,10,4.86,1081,21.64,0.51,0.54
2,341,75,1071,10,4.86,1081,21.64,0.51,0.54
2,341,75,1071,10,4.86,1081,21.64,0.51,0.54
2,409,75,1097,15,7.66,1112,30.64,0.49,0.52
2,409,75,1097,15,7.66,1112,30.64,0.49,0.52
2,409,75,1097,15,7.66,1112,30.64,0.49,0.52
2,409,75,1097,15,7.66,1112,30.64,0.49,0.52
2,409,75,1097,15,7.66,1112,30.64,0.49,0.52
3,911,9,1080,17,8.27,1097,33.31,0.48,0.52
3,911,9,1080,17,8.27,1097,33.31,0.48,0.52
3,911,9,1080,17,8.27,1097,33.31,0.48,0.52
3,911,9,1080,17,8.27,1097,33.31,0.48,0.52
3,911,9,1080,17,8.27,1097,33.31,0.48,0.52
2,499,75,1138,7,3.49,1145,16.81,0.52,0.54
2,499,75,1138,7,3.49,1145,16.81,0.52,0.54
2,499,75,1138,7,3.49,1145,16.81,0.52,0.54
2,499,75,1138,7,3.49,1145,16.81,0.52,0.54
2,499,75,1138,7,3.49,1145,16.81,0.52,0.54
3,286,9,1168,19,9.47,1187,37.06,0.47000000000000003,0.52
3,286,9,1168,19,9.47,1187,37.06,0.47000000000000003,0.52
3,286,9,1168,19,9.47,1187,37.06,0.47000000000000003,0.52
3,286,9,1168,19,9.47,1187,37.06,0.47000000000000003,0.52
3,286,9,1168,19,9.47,1187,37.06,0.47000000000000003,0.52
3,265,9,1191,2,1.22,1193,8.78,0.54,0.55
3,265,9,1191,2,1.22,1193,8.78,0.54,0.55
3,265,9,1191,2,1.22,1193,8.78,0.54,0.55
3,265,9,1191,2,1.22,1193,8.78,0.54,0.55
3,265,9,1191,2,1.22,1193,8.78,0.54,0.55
11,324,25,1184,13,6.73,1197,27.39,0.49,0.53
11,324,25,1184,13,6.73,1197,27.39,0.49,0.53
11,324,25,1184,13,6.73,1197,27.39,0.49,0.53
11,324,25,1184,13,6.73,1197,27.39,0.49,0.53
11,324,25,1184,13,6.73,1197,27.39,0.49,0.53
2,821,75,1202,6,3.2,1208,15.5,0.52,0.54
2,821,75,1202,6,3.2,1208,15.5,0.52,0.54
2,821,75,1202,6,3.2,1208,15.5,0.52,0.54
2,821,75,1202,6,3.2,1208,15.5,0.52,0.54
2,821,75,1202,6,3.2,1208,15.5,0.52,0.54
3,346,9,1212,7,3.56,1219,16.94,0.52,0.54
3,346,9,1212,7,3.56,1219,16.94,0.52,0.54
3,346,9,1212,7,3.56,1219,16.94,0.52,0.54
3,346,9,1212,7,3.56,1219,16.94,0.52,0.54
3,346,9,1212,7,3.56,1219,16.94,0.52,0.54
12,628,32,1356,17,8.59,1373,33.9,0.48,0.52
12,628,32,1356,17,8.59,1373,33.9,0.48,0.52
12,628,32,1356,17,8.59,1373,33.9,0.48,0.52
12,628,32,1356,17,8.59,1373,33.9,0.48,0.52
12,628,32,1356,17,8.59,1373,33.9,0.48,0.52
12,846,23,92,12,5.84,104,24.99,0.5,0.53
12,846,23,92,12,5.84,104,24.99,0.5,0.53
12,846,23,92,12,5.84,104,24.99,0.5,0.53
12,846,23,92,12,5.84,104,24.99,0.5,0.53
12,846,23,92,12,5.84,104,24.99,0.5,0.53
12,846,23,92,12,5.84,104,24.99,0.5,0.53
6,987,33,328,10,5.06,338,22.0,0.51,0.53
6,987,33,328,10,5.06,338,22.0,0.51,0.53
6,987,33,328,10,5.06,338,22.0,0.51,0.53
6,987,33,328,10,5.06,338,22.0,0.51,0.53
6,987,33,328,10,5.06,338,22.0,0.51,0.53
6,987,33,328,10,5.06,338,22.0,0.51,0.53
6,958,33,388,4,1.79,392,11.37,0.53,0.55
6,958,33,388,4,1.79,392,11.37,0.53,0.55
6,958,33,388,4,1.79,392,11.37,0.53,0.55
6,958,33,388,4,1.79,392,11.37,0.53,0.55
6,958,33,388,4,1.79,392,11.37,0.53,0.55
6,958,33,388,4,1.79,392,11.37,0.53,0.55
9,32,68,363,5,2.71,368,13.84,0.53,0.55
9,32,68,363,5,2.71,368,13.84,0.53,0.55
9,32,68,363,5,2.71,368,13.84,0.53,0.55
9,32,68,363,5,2.71,368,13.84,0.53,0.55
9,32,68,363,5,2.71,368,13.84,0.53,0.55
9,32,68,363,5,2.71,368,13.84,0.53,0.55
4,32,25,415,9,4.5,424,20.22,0.51,0.54
4,32,25,415,9,4.5,424,20.22,0.51,0.54
4,32,25,415,9,4.5,424,20.22,0.51,0.54
4,32,25,415,9,4.5,424,20.22,0.51,0.54
4,32,25,415,9,4.5,424,20.22,0.51,0.54
4,32,25,415,9,4.5,424,20.22,0.51,0.54
9,167,68,418,8,3.96,426,18.44,0.52,0.54
9,167,68,418,8,3.96,426,18.44,0.52,0.54
9,167,68,418,8,3.96,426,18.44,0.52,0.54
9,167,68,418,8,3.96,426,18.44,0.52,0.54
9,167,68,418,8,3.96,426,18.44,0.52,0.54
9,167,68,418,8,3.96,426,18.44,0.52,0.54
1,159,47,437,17,8.7,454,34.1,0.48,0.52
1,159,47,437,17,8.7,454,34.1,0.48,0.52
1,159,47,437,17,8.7,454,34.1,0.48,0.52
1,159,47,437,17,8.7,454,34.1,0.48,0.52
1,159,47,437,17,8.7,454,34.1,0.48,0.52
1,159,47,437,17,8.7,454,34.1,0.48,0.52
9,101,68,434,4,2.14,438,12.01,0.53,0.55
9,101,68,434,4,2.14,438,12.01,0.53,0.55
9,101,68,434,4,2.14,438,12.01,0.53,0.55
9,101,68,434,4,2.14,438,12.01,0.53,0.55
9,101,68,434,4,2.14,438,12.01,0.53,0.55
9,101,68,434,4,2.14,438,12.01,0.53,0.55
0,141,36,458,4,2.12,462,11.98,0.53,0.55
0,141,36,458,4,2.12,462,11.98,0.53,0.55
0,141,36,458,4,2.12,462,11.98,0.53,0.55
0,141,36,458,4,2.12,462,11.98,0.53,0.55
0,141,36,458,4,2.12,462,11.98,0.53,0.55
0,141,36,458,4,2.12,462,11.98,0.53,0.55
1,23,47,458,4,2.23,462,12.18,0.53,0.55
1,23,47,458,4,2.23,462,12.18,0.53,0.55
1,23,47,458,4,2.23,462,12.18,0.53,0.55
1,23,47,458,4,2.23,462,12.18,0.53,0.55
1,23,47,458,4,2.23,462,12.18,0.53,0.55
1,23,47,458,4,2.23,462,12.18,0.53,0.55
4,115,25,456,8,3.81,464,18.18,0.52,0.54
4,115,25,456,8,3.81,464,18.18,0.52,0.54
4,115,25,456,8,3.81,464,18.18,0.52,0.54
4,115,25,456,8,3.81,464,18.18,0.52,0.54
4,115,25,456,8,3.81,464,18.18,0.52,0.54
4,115,25,456,8,3.81,464,18.18,0.52,0.54
6,219,33,467,13,6.29,480,26.58,0.5,0.53
6,219,33,467,13,6.29,480,26.58,0.5,0.53
6,219,33,467,13,6.29,480,26.58,0.5,0.53
6,219,33,467,13,6.29,480,26.58,0.5,0.53
6,219,33,467,13,6.29,480,26.58,0.5,0.53
6,219,33,467,13,6.29,480,26.58,0.5,0.53
7,35,86,459,8,3.77,467,18.1,0.52,0.54
7,35,86,459,8,3.77,467,18.1,0.52,0.54
7,35,86,459,8,3.77,467,18.1,0.52,0.54
7,35,86,459,8,3.77,467,18.1,0.52,0.54
7,35,86,459,8,3.77,467,18.1,0.52,0.54
7,35,86,459,8,3.77,467,18.1,0.52,0.54
9,783,68,472,12,6.12,484,25.5,0.5,0.53
9,783,68,472,12,6.12,484,25.5,0.5,0.53
9,783,68,472,12,6.12,484,25.5,0.5,0.53
9,783,68,472,12,6.12,484,25.5,0.5,0.53
9,783,68,472,12,6.12,484,25.5,0.5,0.53
9,783,68,472,12,6.12,484,25.5,0.5,0.53
15,616,57,466,9,4.57,475,20.34,0.51,0.54
15,616,57,466,9,4.57,475,20.34,0.51,0.54
15,616,57,466,9,4.57,475,20.34,0.51,0.54
15,616,57,466,9,4.57,475,20.34,0.51,0.54
15,616,57,466,9,4.57,475,20.34,0.51,0.54
15,616,57,466,9,4.57,475,20.34,0.51,0.54
0,872,36,491,11,5.38,502,23.38,0.5,0.53
0,872,36,491,11,5.38,502,23.38,0.5,0.53
0,872,36,491,11,5.38,502,23.38,0.5,0.53
0,872,36,491,11,5.38,502,23.38,0.5,0.53
0,872,36,491,11,5.38,502,23.38,0.5,0.53
0,872,36,491,11,5.38,502,23.38,0.5,0.53
1,113,47,493,9,4.65,502,20.48,0.51,0.54
1,113,47,493,9,4.65,502,20.48,0.51,0.54
1,113,47,493,9,4.65,502,20.48,0.51,0.54
1,113,47,493,9,4.65,502,20.48,0.51,0.54
1,113,47,493,9,4.65,502,20.48,0.51,0.54
1,113,47,493,9,4.65,502,20.48,0.51,0.54
4,145,25,508,12,5.85,520,25.0,0.5,0.53
4,145,25,508,12,5.85,520,25.0,0.5,0.53
4,145,25,508,12,5.85,520,25.0,0.5,0.53
4,145,25,508,12,5.85,520,25.0,0.5,0.53
4,145,25,508,12,5.85,520,25.0,0.5,0.53
4,145,25,508,12,5.85,520,25.0,0.5,0.53
6,232,33,483,7,3.64,490,17.08,0.52,0.54
6,232,33,483,7,3.64,490,17.08,0.52,0.54
6,232,33,483,7,3.64,490,17.08,0.52,0.54
6,232,33,483,7,3.64,490,17.08,0.52,0.54
6,232,33,483,7,3.64,490,17.08,0.52,0.54
6,232,33,483,7,3.64,490,17.08,0.52,0.54
10,115,54,489,10,5.24,499,22.35,0.51,0.53
10,115,54,489,10,5.24,499,22.35,0.51,0.53
10,115,54,489,10,5.24,499,22.35,0.51,0.53
10,115,54,489,10,5.24,499,22.35,0.51,0.53
10,115,54,489,10,5.24,499,22.35,0.51,0.53
10,115,54,489,10,5.24,499,22.35,0.51,0.53
11,22,73,485,10,5.2,495,22.27,0.51,0.53
11,22,73,485,10,5.2,495,22.27,0.51,0.53
11,22,73,485,10,5.2,495,22.27,0.51,0.53
11,22,73,485,10,5.2,495,22.27,0.51,0.53
11,22,73,485,10,5.2,495,22.27,0.51,0.53
11,22,73,485,10,5.2,495,22.27,0.51,0.53
15,113,57,485,14,7.19,499,29.01,0.49,0.53
15,113,57,485,14,7.19,499,29.01,0.49,0.53
15,113,57,485,14,7.19,499,29.01,0.49,0.53
15,113,57,485,14,7.19,499,29.01,0.49,0.53
15,113,57,485,14,7.19,499,29.01,0.49,0.53
15,113,57,485,14,7.19,499,29.01,0.49,0.53
0,787,36,518,8,4.01,526,18.53,0.52,0.54
0,787,36,518,8,4.01,526,18.53,0.52,0.54
0,787,36,518,8,4.01,526,18.53,0.52,0.54
0,787,36,518,8,4.01,526,18.53,0.52,0.54
0,787,36,518,8,4.01,526,18.53,0.52,0.54
0,787,36,518,8,4.01,526,18.53,0.52,0.54
1,878,47,523,19,9.32,542,36.78,0.47000000000000003,0.52
1,878,47,523,19,9.32,542,36.78,0.47000000000000003,0.52
1,878,47,523,19,9.32,542,36.78,0.47000000000000003,0.52
1,878,47,523,19,9.32,542,36.78,0.47000000000000003,0.52
1,878,47,523,19,9.32,542,36.78,0.47000000000000003,0.52
1,878,47,523,19,9.32,542,36.78,0.47000000000000003,0.52
2,172,20,532,5,2.38,537,13.24,0.53,0.55
2,172,20,532,5,2.38,537,13.24,0.53,0.55
2,172,20,532,5,2.38,537,13.24,0.53,0.55
2,172,20,532,5,2.38,537,13.24,0.53,0.55
2,172,20,532,5,2.38,537,13.24,0.53,0.55
2,172,20,532,5,2.38,537,13.24,0.53,0.55
6,145,33,523,5,2.41,528,13.29,0.53,0.55
6,145,33,523,5,2.41,528,13.29,0.53,0.55
6,145,33,523,5,2.41,528,13.29,0.53,0.55
6,145,33,523,5,2.41,528,13.29,0.53,0.55
6,145,33,523,5,2.41,528,13.29,0.53,0.55
6,145,33,523,5,2.41,528,13.29,0.53,0.55
9,4,68,520,7,3.72,527,17.23,0.52,0.54
9,4,68,520,7,3.72,527,17.23,0.52,0.54
9,4,68,520,7,3.72,527,17.23,0.52,0.54
9,4,68,520,7,3.72,527,17.23,0.52,0.54
9,4,68,520,7,3.72,527,17.23,0.52,0.54
9,4,68,520,7,3.72,527,17.23,0.52,0.54
15,5,57,533,3,1.6,536,10.25,0.54,0.55
15,5,57,533,3,1.6,536,10.25,0.54,0.55
15,5,57,533,3,1.6,536,10.25,0.54,0.55
15,5,57,533,3,1.6,536,10.25,0.54,0.55
15,5,57,533,3,1.6,536,10.25,0.54,0.55
15,5,57,533,3,1.6,536,10.25,0.54,0.55
0,142,36,551,15,7.57,566,30.47,0.49,0.52
0,142,36,551,15,7.57,566,30.47,0.49,0.52
0,142,36,551,15,7.57,566,30.47,0.49,0.52
0,142,36,551,15,7.57,566,30.47,0.49,0.52
0,142,36,551,15,7.57,566,30.47,0.49,0.52
0,142,36,551,15,7.57,566,30.47,0.49,0.52
2,152,20,552,15,7.27,567,29.94,0.49,0.53
2,152,20,552,15,7.27,567,29.94,0.49,0.53
2,152,20,552,15,7.27,567,29.94,0.49,0.53
2,152,20,552,15,7.27,567,29.94,0.49,0.53
2,152,20,552,15,7.27,567,29.94,0.49,0.53
2,152,20,552,15,7.27,567,29.94,0.49,0.53
15,4,57,564,12,6.0,576,25.28,0.5,0.53
15,4,57,564,12,6.0,576,25.28,0.5,0.53
15,4,57,564,12,6.0,576,25.28,0.5,0.53
15,4,57,564,12,6.0,576,25.28,0.5,0.53
15,4,57,564,12,6.0,576,25.28,0.5,0.53
15,4,57,564,12,6.0,576,25.28,0.5,0.53
15,230,57,624,15,7.72,639,30.75,0.49,0.52
15,230,57,624,15,7.72,639,30.75,0.49,0.52
15,230,57,624,15,7.72,639,30.75,0.49,0.52
15,230,57,624,15,7.72,639,30.75,0.49,0.52
15,230,57,624,15,7.72,639,30.75,0.49,0.52
15,230,57,624,15,7.72,639,30.75,0.49,0.52
7,895,15,865,2,0.97,867,8.33,0.54,0.55
7,895,15,865,2,0.97,867,8.33,0.54,0.55
7,895,15,865,2,0.97,867,8.33,0.54,0.55
7,895,15,865,2,0.97,867,8.33,0.54,0.55
7,895,15,865,2,0.97,867,8.33,0.54,0.55
7,895,15,865,2,0.97,867,8.33,0.54,0.55
5,808,90,910,2,0.98,912,8.34,0.54,0.55
5,808,90,910,2,0.98,912,8.34,0.54,0.55
5,808,90,910,2,0.98,912,8.34,0.54,0.55
5,808,90,910,2,0.98,912,8.34,0.54,0.55
5,808,90,910,2,0.98,912,8.34,0.54,0.55
5,808,90,910,2,0.98,912,8.34,0.54,0.55
5,789,90,960,10,5.03,970,21.95,0.51,0.54
5,789,90,960,10,5.03,970,21.95,0.51,0.54
5,789,90,960,10,5.03,970,21.95,0.51,0.54
5,789,90,960,10,5.03,970,21.95,0.51,0.54
5,789,90,960,10,5.03,970,21.95,0.51,0.54
5,789,90,960,10,5.03,970,21.95,0.51,0.54
0,497,34,1008,15,7.7,1023,30.72,0.49,0.52
0,497,34,1008,15,7.7,1023,30.72,0.49,0.52
0,497,34,1008,15,7.7,1023,30.72,0.49,0.52
0,497,34,1008,15,7.7,1023,30.72,0.49,0.52
0,497,34,1008,15,7.7,1023,30.72,0.49,0.52
0,497,34,1008,15,7.7,1023,30.72,0.49,0.52
5,411,90,1014,8,3.82,1022,18.19,0.52,0.54
5,411,90,1014,8,3.82,1022,18.19,0.52,0.54
5,411,90,1014,8,3.82,1022,18.19,0.52,0.54
5,411,90,1014,8,3.82,1022,18.19,0.52,0.54
5,411,90,1014,8,3.82,1022,18.19,0.52,0.54
5,411,90,1014,8,3.82,1022,18.19,0.52,0.54
0,451,34,1031,18,8.99,1049,35.4,0.47000000000000003,0.52
0,451,34,1031,18,8.99,1049,35.4,0.47000000000000003,0.52
0,451,34,1031,18,8.99,1049,35.4,0.47000000000000003,0.52
0,451,34,1031,18,8.99,1049,35.4,0.47000000000000003,0.52
0,451,34,1031,18,8.99,1049,35.4,0.47000000000000003,0.52
0,451,34,1031,18,8.99,1049,35.4,0.47000000000000003,0.52
14,261,55,1030,17,8.7,1047,34.09,0.48,0.52
14,261,55,1030,17,8.7,1047,34.09,0.48,0.52
14,261,55,1030,17,8.7,1047,34.09,0.48,0.52
14,261,55,1030,17,8.7,1047,34.09,0.48,0.52
14,261,55,1030,17,8.7,1047,34.09,0.48,0.52
14,261,55,1030,17,8.7,1047,34.09,0.48,0.52
1,288,8,1073,3,1.27,1076,9.64,0.54,0.55
1,288,8,1073,3,1.27,1076,9.64,0.54,0.55
1,288,8,1073,3,1.27,1076,9.64,0.54,0.55
1,288,8,1073,3,1.27,1076,9.64,0.54,0.55
1,288,8,1073,3,1.27,1076,9.64,0.54,0.55
1,288,8,1073,3,1.27,1076,9.64,0.54,0.55
0,380,34,1083,12,6.14,1095,25.53,0.5,0.53
0,380,34,1083,12,6.14,1095,25.53,0.5,0.53
0,380,34,1083,12,6.14,1095,25.53,0.5,0.53
0,380,34,1083,12,6.14,1095,25.53,0.5,0.53
0,380,34,1083,12,6.14,1095,25.53,0.5,0.53
0,380,34,1083,12,6.14,1095,25.53,0.5,0.53
14,465,55,1090,17,8.31,1107,33.38,0.48,0.52
14,465,55,1090,17,8.31,1107,33.38,0.48,0.52
14,465,55,1090,17,8.31,1107,33.38,0.48,0.52
14,465,55,1090,17,8.31,1107,33.38,0.48,0.52
14,465,55,1090,17,8.31,1107,33.38,0.48,0.52
14,465,55,1090,17,8.31,1107,33.38,0.48,0.52
0,360,34,1131,18,8.77,1149,35.0,0.48,0.52
0,360,34,1131,18,8.77,1149,35.0,0.48,0.52
0,360,34,1131,18,8.77,1149,35.0,0.48,0.52
0,360,34,1131,18,8.77,1149,35.0,0.48,0.52
0,360,34,1131,18,8.77,1149,35.0,0.48,0.52
0,360,34,1131,18,8.77,1149,35.0,0.48,0.52
9,574,88,1212,13,6.39,1225,26.76,0.5,0.53
9,574,88,1212,13,6.39,1225,26.76,0.5,0.53
9,574,88,1212,13,6.39,1225,26.76,0.5,0.53
9,574,88,1212,13,6.39,1225,26.76,0.5,0.53
9,574,88,1212,13,6.39,1225,26.76,0.5,0.53
9,574,88,1212,13,6.39,1225,26.76,0.5,0.53
9,552,88,1238,13,6.7,1251,27.34,0.49,0.53
9,552,88,1238,13,6.7,1251,27.34,0.49,0.53
9,552,88,1238,13,6.7,1251,27.34,0.49,0.53
9,552,88,1238,13,6.7,1251,27.34,0.49,0.53
9,552,88,1238,13,6.7,1251,27.34,0.49,0.53
9,552,88,1238,13,6.7,1251,27.34,0.49,0.53
14,630,55,1252,3,1.67,1255,10.38,0.54,0.55
14,630,55,1252,3,1.67,1255,10.38,0.54,0.55
14,630,55,1252,3,1.67,1255,10.38,0.54,0.55
14,630,55,1252,3,1.67,1255,10.38,0.54,0.55
14,630,55,1252,3,1.67,1255,10.38,0.54,0.55
14,630,55,1252,3,1.67,1255,10.38,0.54,0.55
9,642,88,1262,6,3.16,1268,15.42,0.52,0.54
9,642,88,1262,6,3.16,1268,15.42,0.52,0.54
9,642,88,1262,6,3.16,1268,15.42,0.52,0.54
9,642,88,1262,6,3.16,1268,15.42,0.52,0.54
9,642,88,1262,6,3.16,1268,15.42,0.52,0.54
9,642,88,1262,6,3.16,1268,15.42,0.52,0.54
9,869,88,1310,6,3.19,1316,15.49,0.52,0.54
9,869,88,1310,6,3.19,1316,15.49,0.52,0.54
9,869,88,1310,6,3.19,1316,15.49,0.52,0.54
9,869,88,1310,6,3.19,1316,15.49,0.52,0.54
9,869,88,1310,6,3.19,1316,15.49,0.52,0.54
9,869,88,1310,6,3.19,1316,15.49,0.52,0.54
14,689,55,1290,1,0.62,1291,6.91,0.55,0.55
14,689,55,1290,1,0.62,1291,6.91,0.55,0.55
14,689,55,1290,1,0.62,1291,6.91,0.55,0.55
14,689,55,1290,1,0.62,1291,6.91,0.55,0.55
14,689,55,1290,1,0.62,1291,6.91,0.55,0.55
14,689,55,1290,1,0.62,1291,6.91,0.55,0.55
7,841,15,1329,5,2.71,1334,13.83,0.53,0.55
7,841,15,1329,5,2.71,1334,13.83,0.53,0.55
7,841,15,1329,5,2.71,1334,13.83,0.53,0.55
7,841,15,1329,5,2.71,1334,13.83,0.53,0.55
7,841,15,1329,5,2.71,1334,13.83,0.53,0.55
7,841,15,1329,5,2.71,1334,13.83,0.53,0.55
7,809,15,1369,4,1.93,1373,11.63,0.53,0.55
7,809,15,1369,4,1.93,1373,11.63,0.53,0.55
7,809,15,1369,4,1.93,1373,11.63,0.53,0.55
7,809,15,1369,4,1.93,1373,11.63,0.53,0.55
7,809,15,1369,4,1.93,1373,11.63,0.53,0.55
7,809,15,1369,4,1.93,1373,11.63,0.53,0.55
7,531,15,1412,3,1.62,1415,10.29,0.54,0.55
7,531,15,1412,3,1.62,1415,10.29,0.54,0.55
7,531,15,1412,3,1.62,1415,10.29,0.54,0.55
7,531,15,1412,3,1.62,1415,10.29,0.54,0.55
7,531,15,1412,3,1.62,1415,10.29,0.54,0.55
7,531,15,1412,3,1.62,1415,10.29,0.54,0.55
12,818,45,1411,6,3.17,1417,15.44,0.52,0.54
12,818,45,1411,6,3.17,1417,15.44,0.52,0.54
12,818,45,1411,6,3.17,1417,15.44,0.52,0.54
12,818,45,1411,6,3.17,1417,15.44,0.52,0.54
12,818,45,1411,6,3.17,1417,15.44,0.52,0.54
12,818,45,1411,6,3.17,1417,15.44,0.52,0.54
3,997,68,208,13,6.59,221,27.13,0.49,0.53
3,997,68,208,13,6.59,221,27.13,0.49,0.53
3,997,68,208,13,6.59,221,27.13,0.49,0.53
3,997,68,208,13,6.59,221,27.13,0.49,0.53
3,997,68,208,13,6.59,221,27.13,0.49,0.53
3,997,68,208,13,6.59,221,27.13,0.49,0.53
3,997,68,208,13,6.59,221,27.13,0.49,0.53
3,771,68,237,12,6.09,249,25.44,0.5,0.53
3,771,68,237,12,6.09,249,25.44,0.5,0.53
3,771,68,237,12,6.09,249,25.44,0.5,0.53
3,771,68,237,12,6.09,249,25.44,0.5,0.53
3,771,68,237,12,6.09,249,25.44,0.5,0.53
3,771,68,237,12,6.09,249,25.44,0.5,0.53
3,771,68,237,12,6.09,249,25.44,0.5,0.53
13,822,71,258,8,4.01,266,18.54,0.52,0.54
13,822,71,258,8,4.01,266,18.54,0.52,0.54
13,822,71,258,8,4.01,266,18.54,0.52,0.54
13,822,71,258,8,4.01,266,18.54,0.52,0.54
13,822,71,258,8,4.01,266,18.54,0.52,0.54
13,822,71,258,8,4.01,266,18.54,0.52,0.54
13,822,71,258,8,4.01,266,18.54,0.52,0.54
2,872,61,274,14,7.02,288,28.7,0.49,0.53
2,872,61,274,14,7.02,288,28.7,0.49,0.53
2,872,61,274,14,7.02,288,28.7,0.49,0.53
2,872,61,274,14,7.02,288,28.7,0.49,0.53
2,872,61,274,14,7.02,288,28.7,0.49,0.53
2,872,61,274,14,7.02,288,28.7,0.49,0.53
2,872,61,274,14,7.02,288,28.7,0.49,0.53
14,965,40,293,3,1.48,296,10.03,0.54,0.55
14,965,40,293,3,1.48,296,10.03,0.54,0.55
14,965,40,293,3,1.48,296,10.03,0.54,0.55
14,965,40,293,3,1.48,296,10.03,0.54,0.55
14,965,40,293,3,1.48,296,10.03,0.54,0.55
14,965,40,293,3,1.48,296,10.03,0.54,0.55
14,965,40,293,3,1.48,296,10.03,0.54,0.55
4,47,97,338,3,1.73,341,10.5,0.54,0.55
4,47,97,338,3,1.73,341,10.5,0.54,0.55
4,47,97,338,3,1.73,341,10.5,0.54,0.55
4,47,97,338,3,1.73,341,10.5,0.54,0.55
4,47,97,338,3,1.73,341,10.5,0.54,0.55
4,47,97,338,3,1.73,341,10.5,0.54,0.55
4,47,97,338,3,1.73,341,10.5,0.54,0.55
2,145,61,385,13,6.72,398,27.37,0.49,0.53
2,145,61,385,13,6.72,398,27.37,0.49,0.53
2,145,61,385,13,6.72,398,27.37,0.49,0.53
2,145,61,385,13,6.72,398,27.37,0.49,0.53
2,145,61,385,13,6.72,398,27.37,0.49,0.53
2,145,61,385,13,6.72,398,27.37,0.49,0.53
2,145,61,385,13,6.72,398,27.37,0.49,0.53
4,24,97,389,4,2.08,393,11.91,0.53,0.55
4,24,97,389,4,2.08,393,11.91,0.53,0.55
4,24,97,389,4,2.08,393,11.91,0.53,0.55
4,24,97,389,4,2.08,393,11.91,0.53,0.55
4,24,97,389,4,2.08,393,11.91,0.53,0.55
4,24,97,389,4,2.08,393,11.91,0.53,0.55
4,24,97,389,4,2.08,393,11.91,0.53,0.55
2,2,61,413,10,4.98,423,21.86,0.51,0.54
2,2,61,413,10,4.98,423,21.86,0.51,0.54
2,2,61,413,10,4.98,423,21.86,0.51,0.54
2,2,61,413,10,4.98,423,21.86,0.51,0.54
2,2,61,413,10,4.98,423,21.86,0.51,0.54
2,2,61,413,10,4.98,423,21.86,0.51,0.54
2,2,61,413,10,4.98,423,21.86,0.51,0.54
14,139,40,411,7,3.55,418,16.92,0.52,0.54
14,139,40,411,7,3.55,418,16.92,0.52,0.54
14,139,40,411,7,3.55,418,16.92,0.52,0.54
14,139,40,411,7,3.55,418,16.92,0.52,0.54
14,139,40,411,7,3.55,418,16.92,0.52,0.54
14,139,40,411,7,3.55,418,16.92,0.52,0.54
14,139,40,411,7,3.55,418,16.92,0.52,0.54
11,169,91,431,11,5.62,442,23.8,0.5,0.53
11,169,91,431,11,5.62,442,23.8,0.5,0.53
11,169,91,431,11,5.62,442,23.8,0.5,0.53
11,169,91,431,11,5.62,442,23.8,0.5,0.53
11,169,91,431,11,5.62,442,23.8,0.5,0.53
11,169,91,431,11,5.62,442,23.8,0.5,0.53
11,169,91,431,11,5.62,442,23.8,0.5,0.53
13,129,71,429,14,7.09,443,28.82,0.49,0.53
13,129,71,429,14,7.09,443,28.82,0.49,0.53
13,129,71,429,14,7.09,443,28.82,0.49,0.53
13,129,71,429,14,7.09,443,28.82,0.49,0.53
13,129,71,429,14,7.09,443,28.82,0.49,0.53
13,129,71,429,14,7.09,443,28.82,0.49,0.53
13,129,71,429,14,7.09,443,28.82,0.49,0.53
1,82,27,477,9,4.42,486,20.07,0.51,0.54
1,82,27,477,9,4.42,486,20.07,0.51,0.54
1,82,27,477,9,4.42,486,20.07,0.51,0.54
1,82,27,477,9,4.42,486,20.07,0.51,0.54
1,82,27,477,9,4.42,486,20.07,0.51,0.54
1,82,27,477,9,4.42,486,20.07,0.51,0.54
1,82,27,477,9,4.42,486,20.07,0.51,0.54
3,47,43,473,13,6.48,486,26.93,0.5,0.53
3,47,43,473,13,6.48,486,26.93,0.5,0.53
3,47,43,473,13,6.48,486,26.93,0.5,0.53
3,47,43,473,13,6.48,486,26.93,0.5,0.53
3,47,43,473,13,6.48,486,26.93,0.5,0.53
3,47,43,473,13,6.48,486,26.93,0.5,0.53
3,47,43,473,13,6.48,486,26.93,0.5,0.53
7,701,13,470,12,5.96,482,25.2,0.5,0.53
7,701,13,470,12,5.96,482,25.2,0.5,0.53
7,701,13,470,12,5.96,482,25.2,0.5,0.53
7,701,13,470,12,5.96,482,25.2,0.5,0.53
7,701,13,470,12,5.96,482,25.2,0.5,0.53
7,701,13,470,12,5.96,482,25.2,0.5,0.53
7,701,13,470,12,5.96,482,25.2,0.5,0.53
11,115,91,451,9,4.38,460,19.99,0.51,0.54
11,115,91,451,9,4.38,460,19.99,0.51,0.54
11,115,91,451,9,4.38,460,19.99,0.51,0.54
11,115,91,451,9,4.38,460,19.99,0.51,0.54
11,115,91,451,9,4.38,460,19.99,0.51,0.54
11,115,91,451,9,4.38,460,19.99,0.51,0.54
11,115,91,451,9,4.38,460,19.99,0.51,0.54
12,183,31,457,11,5.27,468,23.17,0.5,0.53
12,183,31,457,11,5.27,468,23.17,0.5,0.53
12,183,31,457,11,5.27,468,23.17,0.5,0.53
12,183,31,457,11,5.27,468,23.17,0.5,0.53
12,183,31,457,11,5.27,468,23.17,0.5,0.53
12,183,31,457,11,5.27,468,23.17,0.5,0.53
12,183,31,457,11,5.27,468,23.17,0.5,0.53
13,157,71,452,9,4.41,461,20.04,0.51,0.54
13,157,71,452,9,4.41,461,20.04,0.51,0.54
13,157,71,452,9,4.41,461,20.04,0.51,0.54
13,157,71,452,9,4.41,461,20.04,0.51,0.54
13,157,71,452,9,4.41,461,20.04,0.51,0.54
13,157,71,452,9,4.41,461,20.04,0.51,0.54
13,157,71,452,9,4.41,461,20.04,0.51,0.54
1,32,27,501,1,0.54,502,6.76,0.55,0.55
1,32,27,501,1,0.54,502,6.76,0.55,0.55
1,32,27,501,1,0.54,502,6.76,0.55,0.55
1,32,27,501,1,0.54,502,6.76,0.55,0.55
1,32,27,501,1,0.54,502,6.76,0.55,0.55
1,32,27,501,1,0.54,502,6.76,0.55,0.55
1,32,27,501,1,0.54,502,6.76,0.55,0.55
7,92,13,488,9,4.39,497,20.01,0.51,0.54
7,92,13,488,9,4.39,497,20.01,0.51,0.54
7,92,13,488,9,4.39,497,20.01,0.51,0.54
7,92,13,488,9,4.39,497,20.01,0.51,0.54
7,92,13,488,9,4.39,497,20.01,0.51,0.54
7,92,13,488,9,4.39,497,20.01,0.51,0.54
7,92,13,488,9,4.39,497,20.01,0.51,0.54
11,0,91,483,2,1.19,485,8.72,0.54,0.55
11,0,91,483,2,1.19,485,8.72,0.54,0.55
11,0,91,483,2,1.19,485,8.72,0.54,0.55
11,0,91,483,2,1.19,485,8.72,0.54,0.55
11,0,91,483,2,1.19,485,8.72,0.54,0.55
11,0,91,483,2,1.19,485,8.72,0.54,0.55
11,0,91,483,2,1.19,485,8.72,0.54,0.55
12,22,31,502,20,9.81,522,38.46,0.47000000000000003,0.51
12,22,31,502,20,9.81,522,38.46,0.47000000000000003,0.51
12,22,31,502,20,9.81,522,38.46,0.47000000000000003,0.51
12,22,31,502,20,9.81,522,38.46,0.47000000000000003,0.51
12,22,31,502,20,9.81,522,38.46,0.47000000000000003,0.51
12,22,31,502,20,9.81,522,38.46,0.47000000000000003,0.51
12,22,31,502,20,9.81,522,38.46,0.47000000000000003,0.51
1,21,27,537,5,2.43,542,13.33,0.53,0.55
1,21,27,537,5,2.43,542,13.33,0.53,0.55
1,21,27,537,5,2.43,542,13.33,0.53,0.55
1,21,27,537,5,2.43,542,13.33,0.53,0.55
1,21,27,537,5,2.43,542,13.33,0.53,0.55
1,21,27,537,5,2.43,542,13.33,0.53,0.55
1,21,27,537,5,2.43,542,13.33,0.53,0.55
12,23,31,514,16,7.79,530,31.66,0.48,0.52
12,23,31,514,16,7.79,530,31.66,0.48,0.52
12,23,31,514,16,7.79,530,31.66,0.48,0.52
12,23,31,514,16,7.79,530,31.66,0.48,0.52
12,23,31,514,16,7.79,530,31.66,0.48,0.52
12,23,31,514,16,7.79,530,31.66,0.48,0.52
12,23,31,514,16,7.79,530,31.66,0.48,0.52
13,655,71,519,11,5.7,530,23.96,0.5,0.53
13,655,71,519,11,5.7,530,23.96,0.5,0.53
13,655,71,519,11,5.7,530,23.96,0.5,0.53
13,655,71,519,11,5.7,530,23.96,0.5,0.53
13,655,71,519,11,5.7,530,23.96,0.5,0.53
13,655,71,519,11,5.7,530,23.96,0.5,0.53
13,655,71,519,11,5.7,530,23.96,0.5,0.53
4,233,34,540,13,6.33,553,26.65,0.5,0.53
4,233,34,540,13,6.33,553,26.65,0.5,0.53
4,233,34,540,13,6.33,553,26.65,0.5,0.53
4,233,34,540,13,6.33,553,26.65,0.5,0.53
4,233,34,540,13,6.33,553,26.65,0.5,0.53
4,233,34,540,13,6.33,553,26.65,0.5,0.53
4,233,34,540,13,6.33,553,26.65,0.5,0.53
7,96,13,554,9,4.53,563,20.26,0.51,0.54
7,96,13,554,9,4.53,563,20.26,0.51,0.54
7,96,13,554,9,4.53,563,20.26,0.51,0.54
7,96,13,554,9,4.53,563,20.26,0.51,0.54
7,96,13,554,9,4.53,563,20.26,0.51,0.54
7,96,13,554,9,4.53,563,20.26,0.51,0.54
7,96,13,554,9,4.53,563,20.26,0.51,0.54
4,894,34,582,5,2.36,587,13.2,0.53,0.55
4,894,34,582,5,2.36,587,13.2,0.53,0.55
4,894,34,582,5,2.36,587,13.2,0.53,0.55
4,894,34,582,5,2.36,587,13.2,0.53,0.55
4,894,34,582,5,2.36,587,13.2,0.53,0.55
4,894,34,582,5,2.36,587,13.2,0.53,0.55
4,894,34,582,5,2.36,587,13.2,0.53,0.55
13,93,71,583,8,3.85,591,18.24,0.52,0.54
13,93,71,583,8,3.85,591,18.24,0.52,0.54
13,93,71,583,8,3.85,591,18.24,0.52,0.54
13,93,71,583,8,3.85,591,18.24,0.52,0.54
13,93,71,583,8,3.85,591,18.24,0.52,0.54
13,93,71,583,8,3.85,591,18.24,0.52,0.54
13,93,71,583,8,3.85,591,18.24,0.52,0.54
11,881,91,627,16,7.76,643,31.61,0.48,0.52
11,881,91,627,16,7.76,643,31.61,0.48,0.52
11,881,91,627,16,7.76,643,31.61,0.48,0.52
11,881,91,627,16,7.76,643,31.61,0.48,0.52
11,881,91,627,16,7.76,643,31.61,0.48,0.52
11,881,91,627,16,7.76,643,31.61,0.48,0.52
11,881,91,627,16,7.76,643,31.61,0.48,0.52
9,998,35,776,9,4.51,785,20.23,0.51,0.54
9,998,35,776,9,4.51,785,20.23,0.51,0.54
9,998,35,776,9,4.51,785,20.23,0.51,0.54
9,998,35,776,9,4.51,785,20.23,0.51,0.54
9,998,35,776,9,4.51,785,20.23,0.51,0.54
9,998,35,776,9,4.51,785,20.23,0.51,0.54
9,998,35,776,9,4.51,785,20.23,0.51,0.54
9,821,35,894,7,3.31,901,16.48,0.52,0.54
9,821,35,894,7,3.31,901,16.48,0.52,0.54
9,821,35,894,7,3.31,901,16.48,0.52,0.54
9,821,35,894,7,3.31,901,16.48,0.52,0.54
9,821,35,894,7,3.31,901,16.48,0.52,0.54
9,821,35,894,7,3.31,901,16.48,0.52,0.54
9,821,35,894,7,3.31,901,16.48,0.52,0.54
10,493,89,1004,8,3.88,1012,18.3,0.52,0.54
10,493,89,1004,8,3.88,1012,18.3,0.52,0.54
10,493,89,1004,8,3.88,1012,18.3,0.52,0.54
10,493,89,1004,8,3.88,1012,18.3,0.52,0.54
10,493,89,1004,8,3.88,1012,18.3,0.52,0.54
10,493,89,1004,8,3.88,1012,18.3,0.52,0.54
10,493,89,1004,8,3.88,1012,18.3,0.52,0.54
1,296,27,1035,3,1.45,1038,9.98,0.54,0.55
1,296,27,1035,3,1.45,1038,9.98,0.54,0.55
1,296,27,1035,3,1.45,1038,9.98,0.54,0.55
1,296,27,1035,3,1.45,1038,9.98,0.54,0.55
1,296,27,1035,3,1.45,1038,9.98,0.54,0.55
1,296,27,1035,3,1.45,1038,9.98,0.54,0.55
1,296,27,1035,3,1.45,1038,9.98,0.54,0.55
8,261,10,1034,18,9.2,1052,35.79,0.47000000000000003,0.52
8,261,10,1034,18,9.2,1052,35.79,0.47000000000000003,0.52
8,261,10,1034,18,9.2,1052,35.79,0.47000000000000003,0.52
8,261,10,1034,18,9.2,1052,35.79,0.47000000000000003,0.52
8,261,10,1034,18,9.2,1052,35.79,0.47000000000000003,0.52
8,261,10,1034,18,9.2,1052,35.79,0.47000000000000003,0.52
8,261,10,1034,18,9.2,1052,35.79,0.47000000000000003,0.52
9,496,35,1023,12,6.04,1035,25.35,0.5,0.53
9,496,35,1023,12,6.04,1035,25.35,0.5,0.53
9,496,35,1023,12,6.04,1035,25.35,0.5,0.53
9,496,35,1023,12,6.04,1035,25.35,0.5,0.53
9,496,35,1023,12,6.04,1035,25.35,0.5,0.53
9,496,35,1023,12,6.04,1035,25.35,0.5,0.53
9,496,35,1023,12,6.04,1035,25.35,0.5,0.53
10,443,89,1032,8,3.83,1040,18.22,0.52,0.54
10,443,89,1032,8,3.83,1040,18.22,0.52,0.54
10,443,89,1032,8,3.83,1040,18.22,0.52,0.54
10,443,89,1032,8,3.83,1040,18.22,0.52,0.54
10,443,89,1032,8,3.83,1040,18.22,0.52,0.54
10,443,89,1032,8,3.83,1040,18.22,0.52,0.54
10,443,89,1032,8,3.83,1040,18.22,0.52,0.54
1,473,27,1076,14,7.04,1090,28.74,0.49,0.53
1,473,27,1076,14,7.04,1090,28.74,0.49,0.53
1,473,27,1076,14,7.04,1090,28.74,0.49,0.53
1,473,27,1076,14,7.04,1090,28.74,0.49,0.53
1,473,27,1076,14,7.04,1090,28.74,0.49,0.53
1,473,27,1076,14,7.04,1090,28.74,0.49,0.53
1,473,27,1076,14,7.04,1090,28.74,0.49,0.53
8,498,10,1069,6,3.21,1075,15.53,0.52,0.54
8,498,10,1069,6,3.21,1075,15.53,0.52,0.54
8,498,10,1069,6,3.21,1075,15.53,0.52,0.54
8,498,10,1069,6,3.21,1075,15.53,0.52,0.54
8,498,10,1069,6,3.21,1075,15.53,0.52,0.54
8,498,10,1069,6,3.21,1075,15.53,0.52,0.54
8,498,10,1069,6,3.21,1075,15.53,0.52,0.54
9,435,35,1065,4,1.8800000000000001,1069,11.54,0.53,0.55
9,435,35,1065,4,1.8800000000000001,1069,11.54,0.53,0.55
9,435,35,1065,4,1.8800000000000001,1069,11.54,0.53,0.55
9,435,35,1065,4,1.8800000000000001,1069,11.54,0.53,0.55
9,435,35,1065,4,1.8800000000000001,1069,11.54,0.53,0.55
9,435,35,1065,4,1.8800000000000001,1069,11.54,0.53,0.55
9,435,35,1065,4,1.8800000000000001,1069,11.54,0.53,0.55
12,261,31,1060,18,9.13,1078,35.66,0.47000000000000003,0.52
12,261,31,1060,18,9.13,1078,35.66,0.47000000000000003,0.52
12,261,31,1060,18,9.13,1078,35.66,0.47000000000000003,0.52
12,261,31,1060,18,9.13,1078,35.66,0.47000000000000003,0.52
12,261,31,1060,18,9.13,1078,35.66,0.47000000000000003,0.52
12,261,31,1060,18,9.13,1078,35.66,0.47000000000000003,0.52
12,261,31,1060,18,9.13,1078,35.66,0.47000000000000003,0.52
1,403,27,1097,11,5.36,1108,23.33,0.5,0.53
1,403,27,1097,11,5.36,1108,23.33,0.5,0.53
1,403,27,1097,11,5.36,1108,23.33,0.5,0.53
1,403,27,1097,11,5.36,1108,23.33,0.5,0.53
1,403,27,1097,11,5.36,1108,23.33,0.5,0.53
1,403,27,1097,11,5.36,1108,23.33,0.5,0.53
1,403,27,1097,11,5.36,1108,23.33,0.5,0.53
8,255,10,1101,5,2.59,1106,13.61,0.53,0.55
8,255,10,1101,5,2.59,1106,13.61,0.53,0.55
8,255,10,1101,5,2.59,1106,13.61,0.53,0.55
8,255,10,1101,5,2.59,1106,13.61,0.53,0.55
8,255,10,1101,5,2.59,1106,13.61,0.53,0.55
8,255,10,1101,5,2.59,1106,13.61,0.53,0.55
8,255,10,1101,5,2.59,1106,13.61,0.53,0.55
12,794,31,1098,11,5.29,1109,23.22,0.5,0.53
12,794,31,1098,11,5.29,1109,23.22,0.5,0.53
12,794,31,1098,11,5.29,1109,23.22,0.5,0.53
12,794,31,1098,11,5.29,1109,23.22,0.5,0.53
12,794,31,1098,11,5.29,1109,23.22,0.5,0.53
12,794,31,1098,11,5.29,1109,23.22,0.5,0.53
12,794,31,1098,11,5.29,1109,23.22,0.5,0.53
1,310,27,1110,18,8.77,1128,35.0,0.48,0.52
1,310,27,1110,18,8.77,1128,35.0,0.48,0.52
1,310,27,1110,18,8.77,1128,35.0,0.48,0.52
1,310,27,1110,18,8.77,1128,35.0,0.48,0.52
1,310,27,1110,18,8.77,1128,35.0,0.48,0.52
1,310,27,1110,18,8.77,1128,35.0,0.48,0.52
1,310,27,1110,18,8.77,1128,35.0,0.48,0.52
9,459,35,1115,5,2.72,1120,13.86,0.53,0.55
9,459,35,1115,5,2.72,1120,13.86,0.53,0.55
9,459,35,1115,5,2.72,1120,13.86,0.53,0.55
9,459,35,1115,5,2.72,1120,13.86,0.53,0.55
9,459,35,1115,5,2.72,1120,13.86,0.53,0.55
9,459,35,1115,5,2.72,1120,13.86,0.53,0.55
9,459,35,1115,5,2.72,1120,13.86,0.53,0.55
9,341,35,1158,6,2.7600000000000002,1164,14.7,0.53,0.54
9,341,35,1158,6,2.7600000000000002,1164,14.7,0.53,0.54
9,341,35,1158,6,2.7600000000000002,1164,14.7,0.53,0.54
9,341,35,1158,6,2.7600000000000002,1164,14.7,0.53,0.54
9,341,35,1158,6,2.7600000000000002,1164,14.7,0.53,0.54
9,341,35,1158,6,2.7600000000000002,1164,14.7,0.53,0.54
9,341,35,1158,6,2.7600000000000002,1164,14.7,0.53,0.54
9,993,35,1182,11,5.47,1193,23.54,0.5,0.53
9,993,35,1182,11,5.47,1193,23.54,0.5,0.53
9,993,35,1182,11,5.47,1193,23.54,0.5,0.53
9,993,35,1182,11,5.47,1193,23.54,0.5,0.53
9,993,35,1182,11,5.47,1193,23.54,0.5,0.53
9,993,35,1182,11,5.47,1193,23.54,0.5,0.53
9,993,35,1182,11,5.47,1193,23.54,0.5,0.53
6,622,28,1237,12,6.09,1249,25.44,0.5,0.53
6,622,28,1237,12,6.09,1249,25.44,0.5,0.53
6,622,28,1237,12,6.09,1249,25.44,0.5,0.53
6,622,28,1237,12,6.09,1249,25.44,0.5,0.53
6,622,28,1237,12,6.09,1249,25.44,0.5,0.53
6,622,28,1237,12,6.09,1249,25.44,0.5,0.53
6,622,28,1237,12,6.09,1249,25.44,0.5,0.53
6,718,28,1276,15,7.35,1291,30.07,0.49,0.52
6,718,28,1276,15,7.35,1291,30.07,0.49,0.52
6,718,28,1276,15,7.35,1291,30.07,0.49,0.52
6,718,28,1276,15,7.35,1291,30.07,0.49,0.52
6,718,28,1276,15,7.35,1291,30.07,0.49,0.52
6,718,28,1276,15,7.35,1291,30.07,0.49,0.52
6,718,28,1276,15,7.35,1291,30.07,0.49,0.52
14,572,39,1288,14,6.76,1302,28.23,0.49,0.53
14,572,39,1288,14,6.76,1302,28.23,0.49,0.53
14,572,39,1288,14,6.76,1302,28.23,0.49,0.53
14,572,39,1288,14,6.76,1302,28.23,0.49,0.53
14,572,39,1288,14,6.76,1302,28.23,0.49,0.53
14,572,39,1288,14,6.76,1302,28.23,0.49,0.53
14,572,39,1288,14,6.76,1302,28.23,0.49,0.53
6,622,28,1303,12,5.96,1315,25.22,0.5,0.53
6,622,28,1303,12,5.96,1315,25.22,0.5,0.53
6,622,28,1303,12,5.96,1315,25.22,0.5,0.53
6,622,28,1303,12,5.96,1315,25.22,0.5,0.53
6,622,28,1303,12,5.96,1315,25.22,0.5,0.53
6,622,28,1303,12,5.96,1315,25.22,0.5,0.53
6,622,28,1303,12,5.96,1315,25.22,0.5,0.53
6,514,28,1346,7,3.48,1353,16.8,0.52,0.54
6,514,28,1346,7,3.48,1353,16.8,0.52,0.54
6,514,28,1346,7,3.48,1353,16.8,0.52,0.54
6,514,28,1346,7,3.48,1353,16.8,0.52,0.54
6,514,28,1346,7,3.48,1353,16.8,0.52,0.54
6,514,28,1346,7,3.48,1353,16.8,0.52,0.54
6,514,28,1346,7,3.48,1353,16.8,0.52,0.54
12,747,31,1341,7,3.39,1348,16.64,0.52,0.54
12,747,31,1341,7,3.39,1348,16.64,0.52,0.54
12,747,31,1341,7,3.39,1348,16.64,0.52,0.54
12,747,31,1341,7,3.39,1348,16.64,0.52,0.54
12,747,31,1341,7,3.39,1348,16.64,0.52,0.54
12,747,31,1341,7,3.39,1348,16.64,0.52,0.54
12,747,31,1341,7,3.39,1348,16.64,0.52,0.54
14,655,39,1346,16,7.92,1362,31.89,0.48,0.52
14,655,39,1346,16,7.92,1362,31.89,0.48,0.52
14,655,39,1346,16,7.92,1362,31.89,0.48,0.52
14,655,39,1346,16,7.92,1362,31.89,0.48,0.52
14,655,39,1346,16,7.92,1362,31.89,0.48,0.52
14,655,39,1346,16,7.92,1362,31.89,0.48,0.52
14,655,39,1346,16,7.92,1362,31.89,0.48,0.52
10,683,85,1366,10,4.84,1376,21.61,0.51,0.54
10,683,85,1366,10,4.84,1376,21.61,0.51,0.54
10,683,85,1366,10,4.84,1376,21.61,0.51,0.54
10,683,85,1366,10,4.84,1376,21.61,0.51,0.54
10,683,85,1366,10,4.84,1376,21.61,0.51,0.54
10,683,85,1366,10,4.84,1376,21.61,0.51,0.54
10,683,85,1366,10,4.84,1376,21.61,0.51,0.54
12,598,31,1374,12,6.03,1386,25.33,0.5,0.53
12,598,31,1374,12,6.03,1386,25.33,0.5,0.53
12,598,31,1374,12,6.03,1386,25.33,0.5,0.53
12,598,31,1374,12,6.03,1386,25.33,0.5,0.53
12,598,31,1374,12,6.03,1386,25.33,0.5,0.53
12,598,31,1374,12,6.03,1386,25.33,0.5,0.53
12,598,31,1374,12,6.03,1386,25.33,0.5,0.53
12,683,31,1391,2,1.02,1393,8.41,0.54,0.55
12,683,31,1391,2,1.02,1393,8.41,0.54,0.55
12,683,31,1391,2,1.02,1393,8.41,0.54,0.55
12,683,31,1391,2,1.02,1393,8.41,0.54,0.55
12,683,31,1391,2,1.02,1393,8.41,0.54,0.55
12,683,31,1391,2,1.02,1393,8.41,0.54,0.55
12,683,31,1391,2,1.02,1393,8.41,0.54,0.55
14,826,39,1386,8,4.14,1394,18.77,0.52,0.54
14,826,39,1386,8,4.14,1394,18.77,0.52,0.54
14,826,39,1386,8,4.14,1394,18.77,0.52,0.54
14,826,39,1386,8,4.14,1394,18.77,0.52,0.54
14,826,39,1386,8,4.14,1394,18.77,0.52,0.54
14,826,39,1386,8,4.14,1394,18.77,0.52,0.54
14,826,39,1386,8,4.14,1394,18.77,0.52,0.54
10,724,85,1428,5,2.69,1433,13.79,0.53,0.55
10,724,85,1428,5,2.69,1433,13.79,0.53,0.55
10,724,85,1428,5,2.69,1433,13.79,0.53,0.55
10,724,85,1428,5,2.69,1433,13.79,0.53,0.55
10,724,85,1428,5,2.69,1433,13.79,0.53,0.55
10,724,85,1428,5,2.69,1433,13.79,0.53,0.55
10,724,85,1428,5,2.69,1433,13.79,0.53,0.55
