square_index,rider_id,driver_idx,trip_start_timestamp,trip_duration,ride_miles,trip_end_timestamp,price_of_ride,rider_acceptance_prob,driver_acceptance_prob
5,901,44,172,3,1.27,175,9.64,0.54,0.55
0,754,89,326,11,5.3,337,23.22,0.5,0.53
12,838,77,318,16,7.87,334,31.81,0.48,0.52
14,735,64,350,7,3.41,357,16.67,0.52,0.54
0,92,89,360,23,11.34,383,43.58,0.45,0.51
14,784,64,367,7,3.26,374,16.39,0.52,0.54
0,544,89,412,20,9.84,432,38.5,0.47000000000000003,0.51
5,106,44,441,9,4.46,450,20.14,0.51,0.54
4,23,32,479,16,7.83,495,31.73,0.48,0.52
5,823,44,458,9,4.52,467,20.25,0.51,0.54
14,151,64,465,7,3.68,472,17.16,0.52,0.54
7,72,51,507,15,7.61,522,30.55,0.49,0.52
7,57,51,517,10,5.2,527,22.27,0.51,0.53
12,139,73,516,13,6.3,529,26.6,0.5,0.53
3,77,0,574,16,7.92,590,31.9,0.48,0.52
14,96,64,573,17,8.39,590,33.53,0.48,0.52
9,855,42,676,10,4.91,686,21.73,0.51,0.54
6,954,29,832,5,2.33,837,13.14,0.53,0.55
1,854,40,851,11,5.59,862,23.75,0.5,0.53
1,404,40,1005,5,2.61,1010,13.66,0.53,0.55
3,287,45,1039,4,1.96,1043,11.69,0.53,0.55
3,348,45,1074,7,3.7,1081,17.19,0.52,0.54
8,479,11,1075,8,3.89,1083,18.31,0.52,0.54
9,257,31,1052,8,3.77,1060,18.1,0.52,0.54
13,263,46,1075,9,4.63,1084,20.46,0.51,0.54
8,320,11,1104,17,8.53,1121,33.79,0.48,0.52
9,339,31,1095,4,1.95,1099,11.67,0.53,0.55
13,886,46,1095,9,4.35,1104,19.93,0.51,0.54
8,317,11,1115,9,4.7,1124,20.58,0.51,0.54
13,879,46,1129,10,5.2,1139,22.26,0.51,0.53
3,262,45,1161,17,8.5,1178,33.73,0.48,0.52
3,897,45,1187,14,6.81,1201,28.32,0.49,0.53
13,738,46,1194,5,2.48,1199,13.41,0.53,0.55
3,893,45,1221,19,9.53,1240,37.16,0.47000000000000003,0.52
8,718,11,1243,16,7.86,1259,31.79,0.48,0.52
13,501,46,1285,9,4.46,1294,20.14,0.51,0.54
3,715,45,1313,4,1.82,1317,11.43,0.53,0.55
13,921,46,1304,11,5.37,1315,23.35,0.5,0.53
13,886,46,1340,16,7.86,1356,31.79,0.48,0.52
13,567,46,1364,12,5.89,1376,25.07,0.5,0.53
9,703,31,1386,13,6.41,1399,26.8,0.5,0.53
9,780,31,1429,14,6.92,1443,28.52,0.49,0.53
1,753,11,126,3,1.33,129,9.75,0.54,0.55
1,753,11,126,3,1.33,129,9.75,0.54,0.55
13,791,40,229,6,3.23,235,15.57,0.52,0.54
13,791,40,229,6,3.23,235,15.57,0.52,0.54
10,775,31,269,10,5.14,279,22.15,0.51,0.53
10,775,31,269,10,5.14,279,22.15,0.51,0.53
4,913,12,312,7,3.55,319,16.93,0.52,0.54
4,913,12,312,7,3.55,319,16.93,0.52,0.54
11,759,88,307,8,4.1,315,18.7,0.52,0.54
11,759,88,307,8,4.1,315,18.7,0.52,0.54
1,4,11,371,8,3.85,379,18.25,0.52,0.54
1,4,11,371,8,3.85,379,18.25,0.52,0.54
10,222,31,374,16,8.22,390,32.43,0.48,0.52
10,222,31,374,16,8.22,390,32.43,0.48,0.52
11,63,88,414,15,7.65,429,30.63,0.49,0.52
11,63,88,414,15,7.65,429,30.63,0.49,0.52
1,992,11,428,4,1.84,432,11.47,0.53,0.55
1,992,11,428,4,1.84,432,11.47,0.53,0.55
1,123,11,476,6,2.97,482,15.08,0.52,0.54
1,123,11,476,6,2.97,482,15.08,0.52,0.54
4,956,12,460,5,2.54,465,13.52,0.53,0.55
4,956,12,460,5,2.54,465,13.52,0.53,0.55
8,755,98,464,14,7.1,478,28.84,0.49,0.53
8,755,98,464,14,7.1,478,28.84,0.49,0.53
8,220,98,488,2,1.11,490,8.59,0.54,0.55
8,220,98,488,2,1.11,490,8.59,0.54,0.55
10,8,31,504,14,6.82,518,28.33,0.49,0.53
10,8,31,504,14,6.82,518,28.33,0.49,0.53
1,55,11,532,3,1.72,535,10.48,0.54,0.55
1,55,11,532,3,1.72,535,10.48,0.54,0.55
8,957,98,531,19,9.74,550,37.55,0.47000000000000003,0.52
8,957,98,531,19,9.74,550,37.55,0.47000000000000003,0.52
6,65,59,549,3,1.62,552,10.28,0.54,0.55
6,65,59,549,3,1.62,552,10.28,0.54,0.55
8,179,98,550,1,0.62,551,6.9,0.55,0.55
8,179,98,550,1,0.62,551,6.9,0.55,0.55
9,63,55,551,13,6.27,564,26.54,0.5,0.53
9,63,55,551,13,6.27,564,26.54,0.5,0.53
15,234,70,554,13,6.6,567,27.16,0.49,0.53
15,234,70,554,13,6.6,567,27.16,0.49,0.53
6,83,59,586,7,3.46,593,16.77,0.52,0.54
6,83,59,586,7,3.46,593,16.77,0.52,0.54
14,787,99,597,10,4.93,607,21.78,0.51,0.54
14,787,99,597,10,4.93,607,21.78,0.51,0.54
9,858,55,616,9,4.58,625,20.35,0.51,0.54
9,858,55,616,9,4.58,625,20.35,0.51,0.54
14,865,99,603,7,3.31,610,16.48,0.52,0.54
14,865,99,603,7,3.31,610,16.48,0.52,0.54
14,979,99,656,13,6.39,669,26.77,0.5,0.53
14,979,99,656,13,6.39,669,26.77,0.5,0.53
4,795,12,773,12,6.04,785,25.34,0.5,0.53
4,795,12,773,12,6.04,785,25.34,0.5,0.53
4,938,12,836,9,4.65,845,20.47,0.51,0.54
4,938,12,836,9,4.65,845,20.47,0.51,0.54
1,840,8,840,19,9.53,859,37.16,0.47000000000000003,0.52
1,840,8,840,19,9.53,859,37.16,0.47000000000000003,0.52
7,836,5,867,4,2.18,871,12.09,0.53,0.55
7,836,5,867,4,2.18,871,12.09,0.53,0.55
14,962,99,946,7,3.6,953,17.02,0.52,0.54
14,962,99,946,7,3.6,953,17.02,0.52,0.54
8,479,66,997,16,7.76,1013,31.61,0.48,0.52
8,479,66,997,16,7.76,1013,31.61,0.48,0.52
14,967,99,1005,11,5.46,1016,23.51,0.5,0.53
14,967,99,1005,11,5.46,1016,23.51,0.5,0.53
8,321,66,1048,15,7.41,1063,30.19,0.49,0.52
8,321,66,1048,15,7.41,1063,30.19,0.49,0.52
14,399,99,1033,11,5.35,1044,23.31,0.5,0.53
14,399,99,1033,11,5.35,1044,23.31,0.5,0.53
4,377,12,1069,8,4.24,1077,18.96,0.52,0.54
4,377,12,1069,8,4.24,1077,18.96,0.52,0.54
14,324,99,1066,17,8.49,1083,33.72,0.48,0.52
14,324,99,1066,17,8.49,1083,33.72,0.48,0.52
4,432,12,1089,7,3.29,1096,16.44,0.52,0.54
4,432,12,1089,7,3.29,1096,16.44,0.52,0.54
14,986,99,1081,3,1.69,1084,10.41,0.54,0.55
14,986,99,1081,3,1.69,1084,10.41,0.54,0.55
4,297,12,1132,10,5.19,1142,22.25,0.51,0.53
4,297,12,1132,10,5.19,1142,22.25,0.51,0.53
7,348,5,1134,13,6.52,1147,27.0,0.5,0.53
7,348,5,1134,13,6.52,1147,27.0,0.5,0.53
8,267,66,1134,14,6.95,1148,28.57,0.49,0.53
8,267,66,1134,14,6.95,1148,28.57,0.49,0.53
15,338,33,1113,13,6.41,1126,26.81,0.5,0.53
15,338,33,1113,13,6.41,1126,26.81,0.5,0.53
8,282,66,1161,10,4.9,1171,21.71,0.51,0.54
8,282,66,1161,10,4.9,1171,21.71,0.51,0.54
14,537,99,1156,20,9.77,1176,38.37,0.47000000000000003,0.51
14,537,99,1156,20,9.77,1176,38.37,0.47000000000000003,0.51
15,493,33,1167,14,6.84,1181,28.38,0.49,0.53
15,493,33,1167,14,6.84,1181,28.38,0.49,0.53
7,440,5,1187,6,2.98,1193,15.1,0.52,0.54
7,440,5,1187,6,2.98,1193,15.1,0.52,0.54
8,336,66,1173,7,3.53,1180,16.89,0.52,0.54
8,336,66,1173,7,3.53,1180,16.89,0.52,0.54
15,620,33,1215,10,5.01,1225,21.93,0.51,0.54
15,620,33,1215,10,5.01,1225,21.93,0.51,0.54
7,506,5,1251,3,1.71,1254,10.45,0.54,0.55
7,506,5,1251,3,1.71,1254,10.45,0.54,0.55
14,506,99,1234,10,5.11,1244,22.1,0.51,0.53
14,506,99,1234,10,5.11,1244,22.1,0.51,0.53
7,574,5,1278,2,1.23,1280,8.79,0.54,0.55
7,574,5,1278,2,1.23,1280,8.79,0.54,0.55
15,523,33,1311,10,5.16,1321,22.19,0.51,0.53
15,523,33,1311,10,5.16,1321,22.19,0.51,0.53
15,655,33,1348,1,0.62,1349,6.91,0.55,0.55
15,655,33,1348,1,0.62,1349,6.91,0.55,0.55
15,583,33,1355,16,7.83,1371,31.73,0.48,0.52
15,583,33,1355,16,7.83,1371,31.73,0.48,0.52
7,836,5,1438,13,6.61,1451,27.17,0.49,0.53
7,836,5,1438,13,6.61,1451,27.17,0.49,0.53
15,557,33,1427,16,8.22,1443,32.44,0.48,0.52
15,557,33,1427,16,8.22,1443,32.44,0.48,0.52
7,893,21,141,9,4.74,150,20.64,0.51,0.54
7,893,21,141,9,4.74,150,20.64,0.51,0.54
7,893,21,141,9,4.74,150,20.64,0.51,0.54
9,772,36,171,7,3.58,178,16.97,0.52,0.54
9,772,36,171,7,3.58,178,16.97,0.52,0.54
9,772,36,171,7,3.58,178,16.97,0.52,0.54
1,56,63,385,18,9.16,403,35.71,0.47000000000000003,0.52
1,56,63,385,18,9.16,403,35.71,0.47000000000000003,0.52
1,56,63,385,18,9.16,403,35.71,0.47000000000000003,0.52
2,199,86,391,11,5.58,402,23.73,0.5,0.53
2,199,86,391,11,5.58,402,23.73,0.5,0.53
2,199,86,391,11,5.58,402,23.73,0.5,0.53
9,65,36,407,11,5.35,418,23.31,0.5,0.53
9,65,36,407,11,5.35,418,23.31,0.5,0.53
9,65,36,407,11,5.35,418,23.31,0.5,0.53
9,106,36,443,13,6.56,456,27.07,0.49,0.53
9,106,36,443,13,6.56,456,27.07,0.49,0.53
9,106,36,443,13,6.56,456,27.07,0.49,0.53
4,8,43,465,5,2.65,470,13.71,0.53,0.55
4,8,43,465,5,2.65,470,13.71,0.53,0.55
4,8,43,465,5,2.65,470,13.71,0.53,0.55
6,17,61,497,6,2.77,503,14.73,0.53,0.54
6,17,61,497,6,2.77,503,14.73,0.53,0.54
6,17,61,497,6,2.77,503,14.73,0.53,0.54
11,122,88,509,17,8.29,526,33.34,0.48,0.52
11,122,88,509,17,8.29,526,33.34,0.48,0.52
11,122,88,509,17,8.29,526,33.34,0.48,0.52
12,961,71,507,18,8.86,525,35.17,0.47000000000000003,0.52
12,961,71,507,18,8.86,525,35.17,0.47000000000000003,0.52
12,961,71,507,18,8.86,525,35.17,0.47000000000000003,0.52
6,169,61,531,13,6.26,544,26.54,0.5,0.53
6,169,61,531,13,6.26,544,26.54,0.5,0.53
6,169,61,531,13,6.26,544,26.54,0.5,0.53
8,38,91,538,6,3.2,544,15.5,0.52,0.54
8,38,91,538,6,3.2,544,15.5,0.52,0.54
8,38,91,538,6,3.2,544,15.5,0.52,0.54
10,222,20,517,13,6.45,530,26.89,0.5,0.53
10,222,20,517,13,6.45,530,26.89,0.5,0.53
10,222,20,517,13,6.45,530,26.89,0.5,0.53
11,106,88,526,18,9.16,544,35.7,0.47000000000000003,0.52
11,106,88,526,18,9.16,544,35.7,0.47000000000000003,0.52
11,106,88,526,18,9.16,544,35.7,0.47000000000000003,0.52
15,131,66,520,12,6.08,532,25.43,0.5,0.53
15,131,66,520,12,6.08,532,25.43,0.5,0.53
15,131,66,520,12,6.08,532,25.43,0.5,0.53
0,167,24,544,6,3.24,550,15.57,0.52,0.54
0,167,24,544,6,3.24,550,15.57,0.52,0.54
0,167,24,544,6,3.24,550,15.57,0.52,0.54
8,232,91,546,6,3.01,552,15.15,0.52,0.54
8,232,91,546,6,3.01,552,15.15,0.52,0.54
8,232,91,546,6,3.01,552,15.15,0.52,0.54
12,130,71,542,16,8.22,558,32.44,0.48,0.52
12,130,71,542,16,8.22,558,32.44,0.48,0.52
12,130,71,542,16,8.22,558,32.44,0.48,0.52
0,222,24,585,17,8.62,602,33.94,0.48,0.52
0,222,24,585,17,8.62,602,33.94,0.48,0.52
0,222,24,585,17,8.62,602,33.94,0.48,0.52
8,834,91,573,4,2.14,577,12.02,0.53,0.55
8,834,91,573,4,2.14,577,12.02,0.53,0.55
8,834,91,573,4,2.14,577,12.02,0.53,0.55
13,839,80,607,8,4.1,615,18.7,0.52,0.54
13,839,80,607,8,4.1,615,18.7,0.52,0.54
13,839,80,607,8,4.1,615,18.7,0.52,0.54
10,991,20,730,15,7.27,745,29.93,0.49,0.53
10,991,20,730,15,7.27,745,29.93,0.49,0.53
10,991,20,730,15,7.27,745,29.93,0.49,0.53
6,780,45,972,10,4.94,982,21.79,0.51,0.54
6,780,45,972,10,4.94,982,21.79,0.51,0.54
6,780,45,972,10,4.94,982,21.79,0.51,0.54
10,457,97,1035,12,5.8,1047,24.92,0.5,0.53
10,457,97,1035,12,5.8,1047,24.92,0.5,0.53
10,457,97,1035,12,5.8,1047,24.92,0.5,0.53
14,397,67,1049,19,9.67,1068,37.42,0.47000000000000003,0.52
14,397,67,1049,19,9.67,1068,37.42,0.47000000000000003,0.52
14,397,67,1049,19,9.67,1068,37.42,0.47000000000000003,0.52
3,290,84,1054,18,9.14,1072,35.67,0.47000000000000003,0.52
3,290,84,1054,18,9.14,1072,35.67,0.47000000000000003,0.52
3,290,84,1054,18,9.14,1072,35.67,0.47000000000000003,0.52
10,255,97,1079,14,6.8,1093,28.29,0.49,0.53
10,255,97,1079,14,6.8,1093,28.29,0.49,0.53
10,255,97,1079,14,6.8,1093,28.29,0.49,0.53
14,336,67,1062,8,4.21,1070,18.91,0.52,0.54
14,336,67,1062,8,4.21,1070,18.91,0.52,0.54
14,336,67,1062,8,4.21,1070,18.91,0.52,0.54
9,629,17,1295,11,5.36,1306,23.34,0.5,0.53
9,629,17,1295,11,5.36,1306,23.34,0.5,0.53
9,629,17,1295,11,5.36,1306,23.34,0.5,0.53
11,574,35,1303,13,6.3,1316,26.61,0.5,0.53
11,574,35,1303,13,6.3,1316,26.61,0.5,0.53
11,574,35,1303,13,6.3,1316,26.61,0.5,0.53
15,621,41,1329,16,7.93,1345,31.91,0.48,0.52
15,621,41,1329,16,7.93,1345,31.91,0.48,0.52
15,621,41,1329,16,7.93,1345,31.91,0.48,0.52
15,715,41,1378,14,7.15,1392,28.93,0.49,0.53
15,715,41,1378,14,7.15,1392,28.93,0.49,0.53
15,715,41,1378,14,7.15,1392,28.93,0.49,0.53
11,617,35,1381,11,5.27,1392,23.17,0.5,0.53
11,617,35,1381,11,5.27,1392,23.17,0.5,0.53
11,617,35,1381,11,5.27,1392,23.17,0.5,0.53
15,697,41,1390,18,9.19,1408,35.77,0.47000000000000003,0.52
15,697,41,1390,18,9.19,1408,35.77,0.47000000000000003,0.52
15,697,41,1390,18,9.19,1408,35.77,0.47000000000000003,0.52
2,520,46,1415,13,6.68,1428,27.29,0.49,0.53
2,520,46,1415,13,6.68,1428,27.29,0.49,0.53
2,520,46,1415,13,6.68,1428,27.29,0.49,0.53
3,869,32,1420,19,9.31,1439,36.77,0.47000000000000003,0.52
3,869,32,1420,19,9.31,1439,36.77,0.47000000000000003,0.52
3,869,32,1420,19,9.31,1439,36.77,0.47000000000000003,0.52
11,901,35,1435,9,4.67,1444,20.51,0.51,0.54
11,901,35,1435,9,4.67,1444,20.51,0.51,0.54
11,901,35,1435,9,4.67,1444,20.51,0.51,0.54
5,949,35,185,8,3.85,193,18.24,0.52,0.54
5,949,35,185,8,3.85,193,18.24,0.52,0.54
5,949,35,185,8,3.85,193,18.24,0.52,0.54
5,949,35,185,8,3.85,193,18.24,0.52,0.54
11,942,67,225,14,7.04,239,28.73,0.49,0.53
11,942,67,225,14,7.04,239,28.73,0.49,0.53
11,942,67,225,14,7.04,239,28.73,0.49,0.53
11,942,67,225,14,7.04,239,28.73,0.49,0.53
0,851,51,314,17,8.74,331,34.16,0.48,0.52
0,851,51,314,17,8.74,331,34.16,0.48,0.52
0,851,51,314,17,8.74,331,34.16,0.48,0.52
0,851,51,314,17,8.74,331,34.16,0.48,0.52
1,892,18,302,17,8.59,319,33.89,0.48,0.52
1,892,18,302,17,8.59,319,33.89,0.48,0.52
1,892,18,302,17,8.59,319,33.89,0.48,0.52
1,892,18,302,17,8.59,319,33.89,0.48,0.52
5,816,35,321,2,0.85,323,8.11,0.54,0.55
5,816,35,321,2,0.85,323,8.11,0.54,0.55
5,816,35,321,2,0.85,323,8.11,0.54,0.55
5,816,35,321,2,0.85,323,8.11,0.54,0.55
0,205,51,339,8,4.11,347,18.71,0.52,0.54
0,205,51,339,8,4.11,347,18.71,0.52,0.54
0,205,51,339,8,4.11,347,18.71,0.52,0.54
0,205,51,339,8,4.11,347,18.71,0.52,0.54
5,869,35,366,11,5.56,377,23.7,0.5,0.53
5,869,35,366,11,5.56,377,23.7,0.5,0.53
5,869,35,366,11,5.56,377,23.7,0.5,0.53
5,869,35,366,11,5.56,377,23.7,0.5,0.53
1,26,18,414,7,3.53,421,16.88,0.52,0.54
1,26,18,414,7,3.53,421,16.88,0.52,0.54
1,26,18,414,7,3.53,421,16.88,0.52,0.54
1,26,18,414,7,3.53,421,16.88,0.52,0.54
5,213,35,408,13,6.29,421,26.58,0.5,0.53
5,213,35,408,13,6.29,421,26.58,0.5,0.53
5,213,35,408,13,6.29,421,26.58,0.5,0.53
5,213,35,408,13,6.29,421,26.58,0.5,0.53
1,65,18,429,7,3.6,436,17.0,0.52,0.54
1,65,18,429,7,3.6,436,17.0,0.52,0.54
1,65,18,429,7,3.6,436,17.0,0.52,0.54
1,65,18,429,7,3.6,436,17.0,0.52,0.54
4,23,66,427,13,6.48,440,26.93,0.5,0.53
4,23,66,427,13,6.48,440,26.93,0.5,0.53
4,23,66,427,13,6.48,440,26.93,0.5,0.53
4,23,66,427,13,6.48,440,26.93,0.5,0.53
5,83,35,445,9,4.74,454,20.65,0.51,0.54
5,83,35,445,9,4.74,454,20.65,0.51,0.54
5,83,35,445,9,4.74,454,20.65,0.51,0.54
5,83,35,445,9,4.74,454,20.65,0.51,0.54
8,63,0,432,4,1.8900000000000001,436,11.57,0.53,0.55
8,63,0,432,4,1.8900000000000001,436,11.57,0.53,0.55
8,63,0,432,4,1.8900000000000001,436,11.57,0.53,0.55
8,63,0,432,4,1.8900000000000001,436,11.57,0.53,0.55
14,196,4,446,18,9.12,464,35.64,0.47000000000000003,0.52
14,196,4,446,18,9.12,464,35.64,0.47000000000000003,0.52
14,196,4,446,18,9.12,464,35.64,0.47000000000000003,0.52
14,196,4,446,18,9.12,464,35.64,0.47000000000000003,0.52
4,23,66,473,18,8.81,491,35.07,0.47000000000000003,0.52
4,23,66,473,18,8.81,491,35.07,0.47000000000000003,0.52
4,23,66,473,18,8.81,491,35.07,0.47000000000000003,0.52
4,23,66,473,18,8.81,491,35.07,0.47000000000000003,0.52
6,19,64,463,12,6.01,475,25.31,0.5,0.53
6,19,64,463,12,6.01,475,25.31,0.5,0.53
6,19,64,463,12,6.01,475,25.31,0.5,0.53
6,19,64,463,12,6.01,475,25.31,0.5,0.53
15,64,17,472,8,4.05,480,18.61,0.52,0.54
15,64,17,472,8,4.05,480,18.61,0.52,0.54
15,64,17,472,8,4.05,480,18.61,0.52,0.54
15,64,17,472,8,4.05,480,18.61,0.52,0.54
1,153,18,490,9,4.43,499,20.09,0.51,0.54
1,153,18,490,9,4.43,499,20.09,0.51,0.54
1,153,18,490,9,4.43,499,20.09,0.51,0.54
1,153,18,490,9,4.43,499,20.09,0.51,0.54
2,89,72,481,12,6.09,493,25.44,0.5,0.53
2,89,72,481,12,6.09,493,25.44,0.5,0.53
2,89,72,481,12,6.09,493,25.44,0.5,0.53
2,89,72,481,12,6.09,493,25.44,0.5,0.53
4,85,66,496,6,2.91,502,14.97,0.53,0.54
4,85,66,496,6,2.91,502,14.97,0.53,0.54
4,85,66,496,6,2.91,502,14.97,0.53,0.54
4,85,66,496,6,2.91,502,14.97,0.53,0.54
6,74,64,492,14,6.93,506,28.54,0.49,0.53
6,74,64,492,14,6.93,506,28.54,0.49,0.53
6,74,64,492,14,6.93,506,28.54,0.49,0.53
6,74,64,492,14,6.93,506,28.54,0.49,0.53
11,72,67,505,1,0.67,506,7.01,0.54,0.55
11,72,67,505,1,0.67,506,7.01,0.54,0.55
11,72,67,505,1,0.67,506,7.01,0.54,0.55
11,72,67,505,1,0.67,506,7.01,0.54,0.55
14,57,4,494,10,5.04,504,21.97,0.51,0.53
14,57,4,494,10,5.04,504,21.97,0.51,0.53
14,57,4,494,10,5.04,504,21.97,0.51,0.53
14,57,4,494,10,5.04,504,21.97,0.51,0.53
15,38,17,482,8,4.24,490,18.95,0.52,0.54
15,38,17,482,8,4.24,490,18.95,0.52,0.54
15,38,17,482,8,4.24,490,18.95,0.52,0.54
15,38,17,482,8,4.24,490,18.95,0.52,0.54
6,234,64,526,4,2.09,530,11.92,0.53,0.55
6,234,64,526,4,2.09,530,11.92,0.53,0.55
6,234,64,526,4,2.09,530,11.92,0.53,0.55
6,234,64,526,4,2.09,530,11.92,0.53,0.55
11,974,67,537,12,5.98,549,25.25,0.5,0.53
11,974,67,537,12,5.98,549,25.25,0.5,0.53
11,974,67,537,12,5.98,549,25.25,0.5,0.53
11,974,67,537,12,5.98,549,25.25,0.5,0.53
14,112,4,532,7,3.56,539,16.94,0.52,0.54
14,112,4,532,7,3.56,539,16.94,0.52,0.54
14,112,4,532,7,3.56,539,16.94,0.52,0.54
14,112,4,532,7,3.56,539,16.94,0.52,0.54
15,221,17,534,16,7.88,550,31.81,0.48,0.52
15,221,17,534,16,7.88,550,31.81,0.48,0.52
15,221,17,534,16,7.88,550,31.81,0.48,0.52
15,221,17,534,16,7.88,550,31.81,0.48,0.52
11,234,67,566,16,7.91,582,31.88,0.48,0.52
11,234,67,566,16,7.91,582,31.88,0.48,0.52
11,234,67,566,16,7.91,582,31.88,0.48,0.52
11,234,67,566,16,7.91,582,31.88,0.48,0.52
14,891,4,595,16,8.03,611,32.09,0.48,0.52
14,891,4,595,16,8.03,611,32.09,0.48,0.52
14,891,4,595,16,8.03,611,32.09,0.48,0.52
14,891,4,595,16,8.03,611,32.09,0.48,0.52
15,79,17,582,17,8.41,599,33.56,0.48,0.52
15,79,17,582,17,8.41,599,33.56,0.48,0.52
15,79,17,582,17,8.41,599,33.56,0.48,0.52
15,79,17,582,17,8.41,599,33.56,0.48,0.52
2,776,72,744,1,0.35000000000000003,745,6.43,0.55,0.55
2,776,72,744,1,0.35000000000000003,745,6.43,0.55,0.55
2,776,72,744,1,0.35000000000000003,745,6.43,0.55,0.55
2,776,72,744,1,0.35000000000000003,745,6.43,0.55,0.55
14,988,4,741,2,1.19,743,8.73,0.54,0.55
14,988,4,741,2,1.19,743,8.73,0.54,0.55
14,988,4,741,2,1.19,743,8.73,0.54,0.55
14,988,4,741,2,1.19,743,8.73,0.54,0.55
0,764,16,871,15,7.42,886,30.2,0.49,0.52
0,764,16,871,15,7.42,886,30.2,0.49,0.52
0,764,16,871,15,7.42,886,30.2,0.49,0.52
0,764,16,871,15,7.42,886,30.2,0.49,0.52
0,876,16,977,5,2.43,982,13.33,0.53,0.55
0,876,16,977,5,2.43,982,13.33,0.53,0.55
0,876,16,977,5,2.43,982,13.33,0.53,0.55
0,876,16,977,5,2.43,982,13.33,0.53,0.55
9,301,39,999,5,2.66,1004,13.74,0.53,0.55
9,301,39,999,5,2.66,1004,13.74,0.53,0.55
9,301,39,999,5,2.66,1004,13.74,0.53,0.55
9,301,39,999,5,2.66,1004,13.74,0.53,0.55
14,810,4,993,10,5.23,1003,22.31,0.51,0.53
14,810,4,993,10,5.23,1003,22.31,0.51,0.53
14,810,4,993,10,5.23,1003,22.31,0.51,0.53
14,810,4,993,10,5.23,1003,22.31,0.51,0.53
0,420,16,1022,19,9.45,1041,37.02,0.47000000000000003,0.52
0,420,16,1022,19,9.45,1041,37.02,0.47000000000000003,0.52
0,420,16,1022,19,9.45,1041,37.02,0.47000000000000003,0.52
0,420,16,1022,19,9.45,1041,37.02,0.47000000000000003,0.52
0,478,16,1079,8,4.04,1087,18.6,0.52,0.54
0,478,16,1079,8,4.04,1087,18.6,0.52,0.54
0,478,16,1079,8,4.04,1087,18.6,0.52,0.54
0,478,16,1079,8,4.04,1087,18.6,0.52,0.54
2,352,72,1069,13,6.6,1082,27.15,0.49,0.53
2,352,72,1069,13,6.6,1082,27.15,0.49,0.53
2,352,72,1069,13,6.6,1082,27.15,0.49,0.53
2,352,72,1069,13,6.6,1082,27.15,0.49,0.53
9,363,39,1054,9,4.51,1063,20.22,0.51,0.54
9,363,39,1054,9,4.51,1063,20.22,0.51,0.54
9,363,39,1054,9,4.51,1063,20.22,0.51,0.54
9,363,39,1054,9,4.51,1063,20.22,0.51,0.54
14,479,4,1074,18,9.08,1092,35.56,0.47000000000000003,0.52
14,479,4,1074,18,9.08,1092,35.56,0.47000000000000003,0.52
14,479,4,1074,18,9.08,1092,35.56,0.47000000000000003,0.52
14,479,4,1074,18,9.08,1092,35.56,0.47000000000000003,0.52
0,303,16,1104,8,4.07,1112,18.65,0.52,0.54
0,303,16,1104,8,4.07,1112,18.65,0.52,0.54
0,303,16,1104,8,4.07,1112,18.65,0.52,0.54
0,303,16,1104,8,4.07,1112,18.65,0.52,0.54
2,317,72,1098,6,2.81,1104,14.79,0.53,0.54
2,317,72,1098,6,2.81,1104,14.79,0.53,0.54
2,317,72,1098,6,2.81,1104,14.79,0.53,0.54
2,317,72,1098,6,2.81,1104,14.79,0.53,0.54
9,339,39,1083,14,6.92,1097,28.51,0.49,0.53
9,339,39,1083,14,6.92,1097,28.51,0.49,0.53
9,339,39,1083,14,6.92,1097,28.51,0.49,0.53
9,339,39,1083,14,6.92,1097,28.51,0.49,0.53
9,312,39,1125,9,4.42,1134,20.06,0.51,0.54
9,312,39,1125,9,4.42,1134,20.06,0.51,0.54
9,312,39,1125,9,4.42,1134,20.06,0.51,0.54
9,312,39,1125,9,4.42,1134,20.06,0.51,0.54
14,294,4,1114,8,3.78,1122,18.11,0.52,0.54
14,294,4,1114,8,3.78,1122,18.11,0.52,0.54
14,294,4,1114,8,3.78,1122,18.11,0.52,0.54
14,294,4,1114,8,3.78,1122,18.11,0.52,0.54
12,463,28,1156,7,3.38,1163,16.61,0.52,0.54
12,463,28,1156,7,3.38,1163,16.61,0.52,0.54
12,463,28,1156,7,3.38,1163,16.61,0.52,0.54
12,463,28,1156,7,3.38,1163,16.61,0.52,0.54
14,370,4,1160,14,6.78,1174,28.26,0.49,0.53
14,370,4,1160,14,6.78,1174,28.26,0.49,0.53
14,370,4,1160,14,6.78,1174,28.26,0.49,0.53
14,370,4,1160,14,6.78,1174,28.26,0.49,0.53
12,425,28,1180,9,4.3,1189,19.84,0.51,0.54
12,425,28,1180,9,4.3,1189,19.84,0.51,0.54
12,425,28,1180,9,4.3,1189,19.84,0.51,0.54
12,425,28,1180,9,4.3,1189,19.84,0.51,0.54
3,670,71,1227,10,4.94,1237,21.79,0.51,0.54
3,670,71,1227,10,4.94,1237,21.79,0.51,0.54
3,670,71,1227,10,4.94,1237,21.79,0.51,0.54
3,670,71,1227,10,4.94,1237,21.79,0.51,0.54
8,518,44,1244,17,8.35,1261,33.46,0.48,0.52
8,518,44,1244,17,8.35,1261,33.46,0.48,0.52
8,518,44,1244,17,8.35,1261,33.46,0.48,0.52
8,518,44,1244,17,8.35,1261,33.46,0.48,0.52
14,742,4,1264,16,8.21,1280,32.42,0.48,0.52
14,742,4,1264,16,8.21,1280,32.42,0.48,0.52
14,742,4,1264,16,8.21,1280,32.42,0.48,0.52
14,742,4,1264,16,8.21,1280,32.42,0.48,0.52
3,735,71,1292,17,8.35,1309,33.46,0.48,0.52
3,735,71,1292,17,8.35,1309,33.46,0.48,0.52
3,735,71,1292,17,8.35,1309,33.46,0.48,0.52
3,735,71,1292,17,8.35,1309,33.46,0.48,0.52
8,506,44,1302,1,0.59,1303,6.85,0.55,0.55
8,506,44,1302,1,0.59,1303,6.85,0.55,0.55
8,506,44,1302,1,0.59,1303,6.85,0.55,0.55
8,506,44,1302,1,0.59,1303,6.85,0.55,0.55
14,565,4,1302,12,6.04,1314,25.35,0.5,0.53
14,565,4,1302,12,6.04,1314,25.35,0.5,0.53
14,565,4,1302,12,6.04,1314,25.35,0.5,0.53
14,565,4,1302,12,6.04,1314,25.35,0.5,0.53
3,724,71,1363,25,12.74,1388,47.69,0.44,0.5
3,724,71,1363,25,12.74,1388,47.69,0.44,0.5
3,724,71,1363,25,12.74,1388,47.69,0.44,0.5
3,724,71,1363,25,12.74,1388,47.69,0.44,0.5
14,621,4,1368,11,5.45,1379,23.5,0.5,0.53
14,621,4,1368,11,5.45,1379,23.5,0.5,0.53
14,621,4,1368,11,5.45,1379,23.5,0.5,0.53
14,621,4,1368,11,5.45,1379,23.5,0.5,0.53
14,742,4,1387,11,5.74,1398,24.03,0.5,0.53
14,742,4,1387,11,5.74,1398,24.03,0.5,0.53
14,742,4,1387,11,5.74,1398,24.03,0.5,0.53
14,742,4,1387,11,5.74,1398,24.03,0.5,0.53
3,967,52,93,8,4.06,101,18.63,0.52,0.54
3,967,52,93,8,4.06,101,18.63,0.52,0.54
3,967,52,93,8,4.06,101,18.63,0.52,0.54
3,967,52,93,8,4.06,101,18.63,0.52,0.54
3,967,52,93,8,4.06,101,18.63,0.52,0.54
7,921,63,192,19,9.64,211,37.36,0.47000000000000003,0.52
7,921,63,192,19,9.64,211,37.36,0.47000000000000003,0.52
7,921,63,192,19,9.64,211,37.36,0.47000000000000003,0.52
7,921,63,192,19,9.64,211,37.36,0.47000000000000003,0.52
7,921,63,192,19,9.64,211,37.36,0.47000000000000003,0.52
15,850,13,196,20,9.86,216,38.54,0.47000000000000003,0.51
15,850,13,196,20,9.86,216,38.54,0.47000000000000003,0.51
15,850,13,196,20,9.86,216,38.54,0.47000000000000003,0.51
15,850,13,196,20,9.86,216,38.54,0.47000000000000003,0.51
15,850,13,196,20,9.86,216,38.54,0.47000000000000003,0.51
7,102,63,388,18,8.82,406,35.1,0.47000000000000003,0.52
7,102,63,388,18,8.82,406,35.1,0.47000000000000003,0.52
7,102,63,388,18,8.82,406,35.1,0.47000000000000003,0.52
7,102,63,388,18,8.82,406,35.1,0.47000000000000003,0.52
7,102,63,388,18,8.82,406,35.1,0.47000000000000003,0.52
13,73,67,414,6,2.8,420,14.78,0.53,0.54
13,73,67,414,6,2.8,420,14.78,0.53,0.54
13,73,67,414,6,2.8,420,14.78,0.53,0.54
13,73,67,414,6,2.8,420,14.78,0.53,0.54
13,73,67,414,6,2.8,420,14.78,0.53,0.54
15,169,13,405,12,5.96,417,25.2,0.5,0.53
15,169,13,405,12,5.96,417,25.2,0.5,0.53
15,169,13,405,12,5.96,417,25.2,0.5,0.53
15,169,13,405,12,5.96,417,25.2,0.5,0.53
15,169,13,405,12,5.96,417,25.2,0.5,0.53
6,99,22,429,12,5.87,441,25.04,0.5,0.53
6,99,22,429,12,5.87,441,25.04,0.5,0.53
6,99,22,429,12,5.87,441,25.04,0.5,0.53
6,99,22,429,12,5.87,441,25.04,0.5,0.53
6,99,22,429,12,5.87,441,25.04,0.5,0.53
15,222,13,449,17,8.59,466,33.89,0.48,0.52
15,222,13,449,17,8.59,466,33.89,0.48,0.52
15,222,13,449,17,8.59,466,33.89,0.48,0.52
15,222,13,449,17,8.59,466,33.89,0.48,0.52
15,222,13,449,17,8.59,466,33.89,0.48,0.52
13,127,67,475,9,4.74,484,20.65,0.51,0.54
13,127,67,475,9,4.74,484,20.65,0.51,0.54
13,127,67,475,9,4.74,484,20.65,0.51,0.54
13,127,67,475,9,4.74,484,20.65,0.51,0.54
13,127,67,475,9,4.74,484,20.65,0.51,0.54
2,836,35,515,16,8.03,531,32.09,0.48,0.52
2,836,35,515,16,8.03,531,32.09,0.48,0.52
2,836,35,515,16,8.03,531,32.09,0.48,0.52
2,836,35,515,16,8.03,531,32.09,0.48,0.52
2,836,35,515,16,8.03,531,32.09,0.48,0.52
6,1,22,538,9,4.35,547,19.94,0.51,0.54
6,1,22,538,9,4.35,547,19.94,0.51,0.54
6,1,22,538,9,4.35,547,19.94,0.51,0.54
6,1,22,538,9,4.35,547,19.94,0.51,0.54
6,1,22,538,9,4.35,547,19.94,0.51,0.54
15,228,13,516,15,7.56,531,30.46,0.49,0.52
15,228,13,516,15,7.56,531,30.46,0.49,0.52
15,228,13,516,15,7.56,531,30.46,0.49,0.52
15,228,13,516,15,7.56,531,30.46,0.49,0.52
15,228,13,516,15,7.56,531,30.46,0.49,0.52
11,902,56,552,8,3.8,560,18.15,0.52,0.54
11,902,56,552,8,3.8,560,18.15,0.52,0.54
11,902,56,552,8,3.8,560,18.15,0.52,0.54
11,902,56,552,8,3.8,560,18.15,0.52,0.54
11,902,56,552,8,3.8,560,18.15,0.52,0.54
11,960,56,706,8,4.2,714,18.89,0.52,0.54
11,960,56,706,8,4.2,714,18.89,0.52,0.54
11,960,56,706,8,4.2,714,18.89,0.52,0.54
11,960,56,706,8,4.2,714,18.89,0.52,0.54
11,960,56,706,8,4.2,714,18.89,0.52,0.54
9,293,8,1009,5,2.73,1014,13.86,0.53,0.55
9,293,8,1009,5,2.73,1014,13.86,0.53,0.55
9,293,8,1009,5,2.73,1014,13.86,0.53,0.55
9,293,8,1009,5,2.73,1014,13.86,0.53,0.55
9,293,8,1009,5,2.73,1014,13.86,0.53,0.55
11,402,72,1012,10,5.09,1022,22.07,0.51,0.53
11,402,72,1012,10,5.09,1022,22.07,0.51,0.53
11,402,72,1012,10,5.09,1022,22.07,0.51,0.53
11,402,72,1012,10,5.09,1022,22.07,0.51,0.53
11,402,72,1012,10,5.09,1022,22.07,0.51,0.53
14,320,64,1006,9,4.36,1015,19.95,0.51,0.54
14,320,64,1006,9,4.36,1015,19.95,0.51,0.54
14,320,64,1006,9,4.36,1015,19.95,0.51,0.54
14,320,64,1006,9,4.36,1015,19.95,0.51,0.54
14,320,64,1006,9,4.36,1015,19.95,0.51,0.54
5,311,9,1027,6,3.08,1033,15.28,0.52,0.54
5,311,9,1027,6,3.08,1033,15.28,0.52,0.54
5,311,9,1027,6,3.08,1033,15.28,0.52,0.54
5,311,9,1027,6,3.08,1033,15.28,0.52,0.54
5,311,9,1027,6,3.08,1033,15.28,0.52,0.54
11,392,72,1023,13,6.27,1036,26.56,0.5,0.53
11,392,72,1023,13,6.27,1036,26.56,0.5,0.53
11,392,72,1023,13,6.27,1036,26.56,0.5,0.53
11,392,72,1023,13,6.27,1036,26.56,0.5,0.53
11,392,72,1023,13,6.27,1036,26.56,0.5,0.53
14,293,64,1042,16,7.94,1058,31.92,0.48,0.52
14,293,64,1042,16,7.94,1058,31.92,0.48,0.52
14,293,64,1042,16,7.94,1058,31.92,0.48,0.52
14,293,64,1042,16,7.94,1058,31.92,0.48,0.52
14,293,64,1042,16,7.94,1058,31.92,0.48,0.52
7,416,33,1066,13,6.45,1079,26.87,0.5,0.53
7,416,33,1066,13,6.45,1079,26.87,0.5,0.53
7,416,33,1066,13,6.45,1079,26.87,0.5,0.53
7,416,33,1066,13,6.45,1079,26.87,0.5,0.53
7,416,33,1066,13,6.45,1079,26.87,0.5,0.53
11,456,72,1057,17,8.28,1074,33.32,0.48,0.52
11,456,72,1057,17,8.28,1074,33.32,0.48,0.52
11,456,72,1057,17,8.28,1074,33.32,0.48,0.52
11,456,72,1057,17,8.28,1074,33.32,0.48,0.52
11,456,72,1057,17,8.28,1074,33.32,0.48,0.52
7,461,33,1104,2,0.96,1106,8.3,0.54,0.55
7,461,33,1104,2,0.96,1106,8.3,0.54,0.55
7,461,33,1104,2,0.96,1106,8.3,0.54,0.55
7,461,33,1104,2,0.96,1106,8.3,0.54,0.55
7,461,33,1104,2,0.96,1106,8.3,0.54,0.55
14,260,64,1101,10,5.14,1111,22.16,0.51,0.53
14,260,64,1101,10,5.14,1111,22.16,0.51,0.53
14,260,64,1101,10,5.14,1111,22.16,0.51,0.53
14,260,64,1101,10,5.14,1111,22.16,0.51,0.53
14,260,64,1101,10,5.14,1111,22.16,0.51,0.53
7,788,33,1128,3,1.6,1131,10.25,0.54,0.55
7,788,33,1128,3,1.6,1131,10.25,0.54,0.55
7,788,33,1128,3,1.6,1131,10.25,0.54,0.55
7,788,33,1128,3,1.6,1131,10.25,0.54,0.55
7,788,33,1128,3,1.6,1131,10.25,0.54,0.55
14,343,64,1116,3,1.48,1119,10.03,0.54,0.55
14,343,64,1116,3,1.48,1119,10.03,0.54,0.55
14,343,64,1116,3,1.48,1119,10.03,0.54,0.55
14,343,64,1116,3,1.48,1119,10.03,0.54,0.55
14,343,64,1116,3,1.48,1119,10.03,0.54,0.55
0,621,92,1338,9,4.27,1347,19.79,0.51,0.54
0,621,92,1338,9,4.27,1347,19.79,0.51,0.54
0,621,92,1338,9,4.27,1347,19.79,0.51,0.54
0,621,92,1338,9,4.27,1347,19.79,0.51,0.54
0,621,92,1338,9,4.27,1347,19.79,0.51,0.54
0,697,92,1355,19,9.27,1374,36.69,0.47000000000000003,0.52
0,697,92,1355,19,9.27,1374,36.69,0.47000000000000003,0.52
0,697,92,1355,19,9.27,1374,36.69,0.47000000000000003,0.52
0,697,92,1355,19,9.27,1374,36.69,0.47000000000000003,0.52
0,697,92,1355,19,9.27,1374,36.69,0.47000000000000003,0.52
1,869,14,137,10,5.17,147,22.21,0.51,0.53
1,869,14,137,10,5.17,147,22.21,0.51,0.53
1,869,14,137,10,5.17,147,22.21,0.51,0.53
1,869,14,137,10,5.17,147,22.21,0.51,0.53
1,869,14,137,10,5.17,147,22.21,0.51,0.53
1,869,14,137,10,5.17,147,22.21,0.51,0.53
7,838,81,149,6,2.87,155,14.9,0.53,0.54
7,838,81,149,6,2.87,155,14.9,0.53,0.54
7,838,81,149,6,2.87,155,14.9,0.53,0.54
7,838,81,149,6,2.87,155,14.9,0.53,0.54
7,838,81,149,6,2.87,155,14.9,0.53,0.54
7,838,81,149,6,2.87,155,14.9,0.53,0.54
7,836,81,159,6,3.1,165,15.32,0.52,0.54
7,836,81,159,6,3.1,165,15.32,0.52,0.54
7,836,81,159,6,3.1,165,15.32,0.52,0.54
7,836,81,159,6,3.1,165,15.32,0.52,0.54
7,836,81,159,6,3.1,165,15.32,0.52,0.54
7,836,81,159,6,3.1,165,15.32,0.52,0.54
1,851,14,277,16,8.0,293,32.03,0.48,0.52
1,851,14,277,16,8.0,293,32.03,0.48,0.52
1,851,14,277,16,8.0,293,32.03,0.48,0.52
1,851,14,277,16,8.0,293,32.03,0.48,0.52
1,851,14,277,16,8.0,293,32.03,0.48,0.52
1,851,14,277,16,8.0,293,32.03,0.48,0.52
10,834,36,388,17,8.4,405,33.54,0.48,0.52
10,834,36,388,17,8.4,405,33.54,0.48,0.52
10,834,36,388,17,8.4,405,33.54,0.48,0.52
10,834,36,388,17,8.4,405,33.54,0.48,0.52
10,834,36,388,17,8.4,405,33.54,0.48,0.52
10,834,36,388,17,8.4,405,33.54,0.48,0.52
1,229,14,416,18,8.87,434,35.18,0.47000000000000003,0.52
1,229,14,416,18,8.87,434,35.18,0.47000000000000003,0.52
1,229,14,416,18,8.87,434,35.18,0.47000000000000003,0.52
1,229,14,416,18,8.87,434,35.18,0.47000000000000003,0.52
1,229,14,416,18,8.87,434,35.18,0.47000000000000003,0.52
1,229,14,416,18,8.87,434,35.18,0.47000000000000003,0.52
1,92,14,442,21,10.68,463,40.82,0.46,0.51
1,92,14,442,21,10.68,463,40.82,0.46,0.51
1,92,14,442,21,10.68,463,40.82,0.46,0.51
1,92,14,442,21,10.68,463,40.82,0.46,0.51
1,92,14,442,21,10.68,463,40.82,0.46,0.51
1,92,14,442,21,10.68,463,40.82,0.46,0.51
3,141,24,436,15,7.51,451,30.37,0.49,0.52
3,141,24,436,15,7.51,451,30.37,0.49,0.52
3,141,24,436,15,7.51,451,30.37,0.49,0.52
3,141,24,436,15,7.51,451,30.37,0.49,0.52
3,141,24,436,15,7.51,451,30.37,0.49,0.52
3,141,24,436,15,7.51,451,30.37,0.49,0.52
10,66,36,441,1,0.6900000000000001,442,7.03,0.54,0.55
10,66,36,441,1,0.6900000000000001,442,7.03,0.54,0.55
10,66,36,441,1,0.6900000000000001,442,7.03,0.54,0.55
10,66,36,441,1,0.6900000000000001,442,7.03,0.54,0.55
10,66,36,441,1,0.6900000000000001,442,7.03,0.54,0.55
10,66,36,441,1,0.6900000000000001,442,7.03,0.54,0.55
11,65,49,447,4,1.93,451,11.63,0.53,0.55
11,65,49,447,4,1.93,451,11.63,0.53,0.55
11,65,49,447,4,1.93,451,11.63,0.53,0.55
11,65,49,447,4,1.93,451,11.63,0.53,0.55
11,65,49,447,4,1.93,451,11.63,0.53,0.55
11,65,49,447,4,1.93,451,11.63,0.53,0.55
12,98,95,427,20,10.07,447,38.93,0.47000000000000003,0.51
12,98,95,427,20,10.07,447,38.93,0.47000000000000003,0.51
12,98,95,427,20,10.07,447,38.93,0.47000000000000003,0.51
12,98,95,427,20,10.07,447,38.93,0.47000000000000003,0.51
12,98,95,427,20,10.07,447,38.93,0.47000000000000003,0.51
12,98,95,427,20,10.07,447,38.93,0.47000000000000003,0.51
1,126,14,473,12,6.21,485,25.67,0.5,0.53
1,126,14,473,12,6.21,485,25.67,0.5,0.53
1,126,14,473,12,6.21,485,25.67,0.5,0.53
1,126,14,473,12,6.21,485,25.67,0.5,0.53
1,126,14,473,12,6.21,485,25.67,0.5,0.53
1,126,14,473,12,6.21,485,25.67,0.5,0.53
2,92,87,473,10,4.86,483,21.65,0.51,0.54
2,92,87,473,10,4.86,483,21.65,0.51,0.54
2,92,87,473,10,4.86,483,21.65,0.51,0.54
2,92,87,473,10,4.86,483,21.65,0.51,0.54
2,92,87,473,10,4.86,483,21.65,0.51,0.54
2,92,87,473,10,4.86,483,21.65,0.51,0.54
8,83,91,457,3,1.3,460,9.7,0.54,0.55
8,83,91,457,3,1.3,460,9.7,0.54,0.55
8,83,91,457,3,1.3,460,9.7,0.54,0.55
8,83,91,457,3,1.3,460,9.7,0.54,0.55
8,83,91,457,3,1.3,460,9.7,0.54,0.55
8,83,91,457,3,1.3,460,9.7,0.54,0.55
11,133,49,452,16,7.91,468,31.87,0.48,0.52
11,133,49,452,16,7.91,468,31.87,0.48,0.52
11,133,49,452,16,7.91,468,31.87,0.48,0.52
11,133,49,452,16,7.91,468,31.87,0.48,0.52
11,133,49,452,16,7.91,468,31.87,0.48,0.52
11,133,49,452,16,7.91,468,31.87,0.48,0.52
0,73,58,509,8,4.14,517,18.78,0.52,0.54
0,73,58,509,8,4.14,517,18.78,0.52,0.54
0,73,58,509,8,4.14,517,18.78,0.52,0.54
0,73,58,509,8,4.14,517,18.78,0.52,0.54
0,73,58,509,8,4.14,517,18.78,0.52,0.54
0,73,58,509,8,4.14,517,18.78,0.52,0.54
5,133,38,481,11,5.61,492,23.78,0.5,0.53
5,133,38,481,11,5.61,492,23.78,0.5,0.53
5,133,38,481,11,5.61,492,23.78,0.5,0.53
5,133,38,481,11,5.61,492,23.78,0.5,0.53
5,133,38,481,11,5.61,492,23.78,0.5,0.53
5,133,38,481,11,5.61,492,23.78,0.5,0.53
12,183,95,493,7,3.46,500,16.75,0.52,0.54
12,183,95,493,7,3.46,500,16.75,0.52,0.54
12,183,95,493,7,3.46,500,16.75,0.52,0.54
12,183,95,493,7,3.46,500,16.75,0.52,0.54
12,183,95,493,7,3.46,500,16.75,0.52,0.54
12,183,95,493,7,3.46,500,16.75,0.52,0.54
12,220,95,539,15,7.49,554,30.33,0.49,0.52
12,220,95,539,15,7.49,554,30.33,0.49,0.52
12,220,95,539,15,7.49,554,30.33,0.49,0.52
12,220,95,539,15,7.49,554,30.33,0.49,0.52
12,220,95,539,15,7.49,554,30.33,0.49,0.52
12,220,95,539,15,7.49,554,30.33,0.49,0.52
14,896,17,730,8,3.98,738,18.48,0.52,0.54
14,896,17,730,8,3.98,738,18.48,0.52,0.54
14,896,17,730,8,3.98,738,18.48,0.52,0.54
14,896,17,730,8,3.98,738,18.48,0.52,0.54
14,896,17,730,8,3.98,738,18.48,0.52,0.54
14,896,17,730,8,3.98,738,18.48,0.52,0.54
2,851,87,973,1,0.33,974,6.38,0.55,0.55
2,851,87,973,1,0.33,974,6.38,0.55,0.55
2,851,87,973,1,0.33,974,6.38,0.55,0.55
2,851,87,973,1,0.33,974,6.38,0.55,0.55
2,851,87,973,1,0.33,974,6.38,0.55,0.55
2,851,87,973,1,0.33,974,6.38,0.55,0.55
9,439,94,989,2,0.93,991,8.25,0.54,0.55
9,439,94,989,2,0.93,991,8.25,0.54,0.55
9,439,94,989,2,0.93,991,8.25,0.54,0.55
9,439,94,989,2,0.93,991,8.25,0.54,0.55
9,439,94,989,2,0.93,991,8.25,0.54,0.55
9,439,94,989,2,0.93,991,8.25,0.54,0.55
2,298,87,1007,5,2.42,1012,13.3,0.53,0.55
2,298,87,1007,5,2.42,1012,13.3,0.53,0.55
2,298,87,1007,5,2.42,1012,13.3,0.53,0.55
2,298,87,1007,5,2.42,1012,13.3,0.53,0.55
2,298,87,1007,5,2.42,1012,13.3,0.53,0.55
2,298,87,1007,5,2.42,1012,13.3,0.53,0.55
9,836,94,999,4,1.8800000000000001,1003,11.54,0.53,0.55
9,836,94,999,4,1.8800000000000001,1003,11.54,0.53,0.55
9,836,94,999,4,1.8800000000000001,1003,11.54,0.53,0.55
9,836,94,999,4,1.8800000000000001,1003,11.54,0.53,0.55
9,836,94,999,4,1.8800000000000001,1003,11.54,0.53,0.55
9,836,94,999,4,1.8800000000000001,1003,11.54,0.53,0.55
3,287,69,1022,6,3.01,1028,15.16,0.52,0.54
3,287,69,1022,6,3.01,1028,15.16,0.52,0.54
3,287,69,1022,6,3.01,1028,15.16,0.52,0.54
3,287,69,1022,6,3.01,1028,15.16,0.52,0.54
3,287,69,1022,6,3.01,1028,15.16,0.52,0.54
3,287,69,1022,6,3.01,1028,15.16,0.52,0.54
9,933,94,1041,3,1.72,1044,10.48,0.54,0.55
9,933,94,1041,3,1.72,1044,10.48,0.54,0.55
9,933,94,1041,3,1.72,1044,10.48,0.54,0.55
9,933,94,1041,3,1.72,1044,10.48,0.54,0.55
9,933,94,1041,3,1.72,1044,10.48,0.54,0.55
9,933,94,1041,3,1.72,1044,10.48,0.54,0.55
2,295,87,1058,10,4.98,1068,21.87,0.51,0.54
2,295,87,1058,10,4.98,1068,21.87,0.51,0.54
2,295,87,1058,10,4.98,1068,21.87,0.51,0.54
2,295,87,1058,10,4.98,1068,21.87,0.51,0.54
2,295,87,1058,10,4.98,1068,21.87,0.51,0.54
2,295,87,1058,10,4.98,1068,21.87,0.51,0.54
3,339,69,1056,7,3.66,1063,17.13,0.52,0.54
3,339,69,1056,7,3.66,1063,17.13,0.52,0.54
3,339,69,1056,7,3.66,1063,17.13,0.52,0.54
3,339,69,1056,7,3.66,1063,17.13,0.52,0.54
3,339,69,1056,7,3.66,1063,17.13,0.52,0.54
3,339,69,1056,7,3.66,1063,17.13,0.52,0.54
9,324,94,1053,9,4.3,1062,19.85,0.51,0.54
9,324,94,1053,9,4.3,1062,19.85,0.51,0.54
9,324,94,1053,9,4.3,1062,19.85,0.51,0.54
9,324,94,1053,9,4.3,1062,19.85,0.51,0.54
9,324,94,1053,9,4.3,1062,19.85,0.51,0.54
9,324,94,1053,9,4.3,1062,19.85,0.51,0.54
9,267,94,1104,11,5.65,1115,23.86,0.5,0.53
9,267,94,1104,11,5.65,1115,23.86,0.5,0.53
9,267,94,1104,11,5.65,1115,23.86,0.5,0.53
9,267,94,1104,11,5.65,1115,23.86,0.5,0.53
9,267,94,1104,11,5.65,1115,23.86,0.5,0.53
9,267,94,1104,11,5.65,1115,23.86,0.5,0.53
3,348,69,1127,14,6.87,1141,28.43,0.49,0.53
3,348,69,1127,14,6.87,1141,28.43,0.49,0.53
3,348,69,1127,14,6.87,1141,28.43,0.49,0.53
3,348,69,1127,14,6.87,1141,28.43,0.49,0.53
3,348,69,1127,14,6.87,1141,28.43,0.49,0.53
3,348,69,1127,14,6.87,1141,28.43,0.49,0.53
14,411,17,1199,7,3.5,1206,16.83,0.52,0.54
14,411,17,1199,7,3.5,1206,16.83,0.52,0.54
14,411,17,1199,7,3.5,1206,16.83,0.52,0.54
14,411,17,1199,7,3.5,1206,16.83,0.52,0.54
14,411,17,1199,7,3.5,1206,16.83,0.52,0.54
14,411,17,1199,7,3.5,1206,16.83,0.52,0.54
8,616,75,1246,8,3.85,1254,18.24,0.52,0.54
8,616,75,1246,8,3.85,1254,18.24,0.52,0.54
8,616,75,1246,8,3.85,1254,18.24,0.52,0.54
8,616,75,1246,8,3.85,1254,18.24,0.52,0.54
8,616,75,1246,8,3.85,1254,18.24,0.52,0.54
8,616,75,1246,8,3.85,1254,18.24,0.52,0.54
12,550,51,1251,14,6.92,1265,28.51,0.49,0.53
12,550,51,1251,14,6.92,1265,28.51,0.49,0.53
12,550,51,1251,14,6.92,1265,28.51,0.49,0.53
12,550,51,1251,14,6.92,1265,28.51,0.49,0.53
12,550,51,1251,14,6.92,1265,28.51,0.49,0.53
12,550,51,1251,14,6.92,1265,28.51,0.49,0.53
5,711,44,1287,12,5.91,1299,25.11,0.5,0.53
5,711,44,1287,12,5.91,1299,25.11,0.5,0.53
5,711,44,1287,12,5.91,1299,25.11,0.5,0.53
5,711,44,1287,12,5.91,1299,25.11,0.5,0.53
5,711,44,1287,12,5.91,1299,25.11,0.5,0.53
5,711,44,1287,12,5.91,1299,25.11,0.5,0.53
12,654,51,1285,3,1.36,1288,9.82,0.54,0.55
12,654,51,1285,3,1.36,1288,9.82,0.54,0.55
12,654,51,1285,3,1.36,1288,9.82,0.54,0.55
12,654,51,1285,3,1.36,1288,9.82,0.54,0.55
12,654,51,1285,3,1.36,1288,9.82,0.54,0.55
12,654,51,1285,3,1.36,1288,9.82,0.54,0.55
5,694,44,1291,9,4.36,1300,19.96,0.51,0.54
5,694,44,1291,9,4.36,1300,19.96,0.51,0.54
5,694,44,1291,9,4.36,1300,19.96,0.51,0.54
5,694,44,1291,9,4.36,1300,19.96,0.51,0.54
5,694,44,1291,9,4.36,1300,19.96,0.51,0.54
5,694,44,1291,9,4.36,1300,19.96,0.51,0.54
12,602,51,1298,5,2.41,1303,13.29,0.53,0.55
12,602,51,1298,5,2.41,1303,13.29,0.53,0.55
12,602,51,1298,5,2.41,1303,13.29,0.53,0.55
12,602,51,1298,5,2.41,1303,13.29,0.53,0.55
12,602,51,1298,5,2.41,1303,13.29,0.53,0.55
12,602,51,1298,5,2.41,1303,13.29,0.53,0.55
5,880,2,205,6,2.88,211,14.92,0.53,0.54
5,880,2,205,6,2.88,211,14.92,0.53,0.54
5,880,2,205,6,2.88,211,14.92,0.53,0.54
5,880,2,205,6,2.88,211,14.92,0.53,0.54
5,880,2,205,6,2.88,211,14.92,0.53,0.54
5,880,2,205,6,2.88,211,14.92,0.53,0.54
5,880,2,205,6,2.88,211,14.92,0.53,0.54
14,824,96,210,19,9.38,229,36.89,0.47000000000000003,0.52
14,824,96,210,19,9.38,229,36.89,0.47000000000000003,0.52
14,824,96,210,19,9.38,229,36.89,0.47000000000000003,0.52
14,824,96,210,19,9.38,229,36.89,0.47000000000000003,0.52
14,824,96,210,19,9.38,229,36.89,0.47000000000000003,0.52
14,824,96,210,19,9.38,229,36.89,0.47000000000000003,0.52
14,824,96,210,19,9.38,229,36.89,0.47000000000000003,0.52
5,957,2,272,4,2.21,276,12.14,0.53,0.55
5,957,2,272,4,2.21,276,12.14,0.53,0.55
5,957,2,272,4,2.21,276,12.14,0.53,0.55
5,957,2,272,4,2.21,276,12.14,0.53,0.55
5,957,2,272,4,2.21,276,12.14,0.53,0.55
5,957,2,272,4,2.21,276,12.14,0.53,0.55
5,957,2,272,4,2.21,276,12.14,0.53,0.55
5,4,2,351,8,3.99,359,18.5,0.52,0.54
5,4,2,351,8,3.99,359,18.5,0.52,0.54
5,4,2,351,8,3.99,359,18.5,0.52,0.54
5,4,2,351,8,3.99,359,18.5,0.52,0.54
5,4,2,351,8,3.99,359,18.5,0.52,0.54
5,4,2,351,8,3.99,359,18.5,0.52,0.54
5,4,2,351,8,3.99,359,18.5,0.52,0.54
14,954,96,387,13,6.37,400,26.73,0.5,0.53
14,954,96,387,13,6.37,400,26.73,0.5,0.53
14,954,96,387,13,6.37,400,26.73,0.5,0.53
14,954,96,387,13,6.37,400,26.73,0.5,0.53
14,954,96,387,13,6.37,400,26.73,0.5,0.53
14,954,96,387,13,6.37,400,26.73,0.5,0.53
14,954,96,387,13,6.37,400,26.73,0.5,0.53
5,65,2,418,5,2.73,423,13.87,0.53,0.55
5,65,2,418,5,2.73,423,13.87,0.53,0.55
5,65,2,418,5,2.73,423,13.87,0.53,0.55
5,65,2,418,5,2.73,423,13.87,0.53,0.55
5,65,2,418,5,2.73,423,13.87,0.53,0.55
5,65,2,418,5,2.73,423,13.87,0.53,0.55
5,65,2,418,5,2.73,423,13.87,0.53,0.55
14,858,96,407,21,10.68,428,40.81,0.46,0.51
14,858,96,407,21,10.68,428,40.81,0.46,0.51
14,858,96,407,21,10.68,428,40.81,0.46,0.51
14,858,96,407,21,10.68,428,40.81,0.46,0.51
14,858,96,407,21,10.68,428,40.81,0.46,0.51
14,858,96,407,21,10.68,428,40.81,0.46,0.51
14,858,96,407,21,10.68,428,40.81,0.46,0.51
0,35,84,424,2,1.19,426,8.73,0.54,0.55
0,35,84,424,2,1.19,426,8.73,0.54,0.55
0,35,84,424,2,1.19,426,8.73,0.54,0.55
0,35,84,424,2,1.19,426,8.73,0.54,0.55
0,35,84,424,2,1.19,426,8.73,0.54,0.55
0,35,84,424,2,1.19,426,8.73,0.54,0.55
0,35,84,424,2,1.19,426,8.73,0.54,0.55
5,88,2,442,11,5.33,453,23.29,0.5,0.53
5,88,2,442,11,5.33,453,23.29,0.5,0.53
5,88,2,442,11,5.33,453,23.29,0.5,0.53
5,88,2,442,11,5.33,453,23.29,0.5,0.53
5,88,2,442,11,5.33,453,23.29,0.5,0.53
5,88,2,442,11,5.33,453,23.29,0.5,0.53
5,88,2,442,11,5.33,453,23.29,0.5,0.53
9,54,6,446,10,4.96,456,21.83,0.51,0.54
9,54,6,446,10,4.96,456,21.83,0.51,0.54
9,54,6,446,10,4.96,456,21.83,0.51,0.54
9,54,6,446,10,4.96,456,21.83,0.51,0.54
9,54,6,446,10,4.96,456,21.83,0.51,0.54
9,54,6,446,10,4.96,456,21.83,0.51,0.54
9,54,6,446,10,4.96,456,21.83,0.51,0.54
14,82,96,445,10,4.93,455,21.77,0.51,0.54
14,82,96,445,10,4.93,455,21.77,0.51,0.54
14,82,96,445,10,4.93,455,21.77,0.51,0.54
14,82,96,445,10,4.93,455,21.77,0.51,0.54
14,82,96,445,10,4.93,455,21.77,0.51,0.54
14,82,96,445,10,4.93,455,21.77,0.51,0.54
14,82,96,445,10,4.93,455,21.77,0.51,0.54
1,221,8,476,14,7.08,490,28.81,0.49,0.53
1,221,8,476,14,7.08,490,28.81,0.49,0.53
1,221,8,476,14,7.08,490,28.81,0.49,0.53
1,221,8,476,14,7.08,490,28.81,0.49,0.53
1,221,8,476,14,7.08,490,28.81,0.49,0.53
1,221,8,476,14,7.08,490,28.81,0.49,0.53
1,221,8,476,14,7.08,490,28.81,0.49,0.53
9,65,6,470,7,3.46,477,16.76,0.52,0.54
9,65,6,470,7,3.46,477,16.76,0.52,0.54
9,65,6,470,7,3.46,477,16.76,0.52,0.54
9,65,6,470,7,3.46,477,16.76,0.52,0.54
9,65,6,470,7,3.46,477,16.76,0.52,0.54
9,65,6,470,7,3.46,477,16.76,0.52,0.54
9,65,6,470,7,3.46,477,16.76,0.52,0.54
11,67,90,454,7,3.28,461,16.42,0.52,0.54
11,67,90,454,7,3.28,461,16.42,0.52,0.54
11,67,90,454,7,3.28,461,16.42,0.52,0.54
11,67,90,454,7,3.28,461,16.42,0.52,0.54
11,67,90,454,7,3.28,461,16.42,0.52,0.54
11,67,90,454,7,3.28,461,16.42,0.52,0.54
11,67,90,454,7,3.28,461,16.42,0.52,0.54
9,98,6,480,11,5.69,491,23.93,0.5,0.53
9,98,6,480,11,5.69,491,23.93,0.5,0.53
9,98,6,480,11,5.69,491,23.93,0.5,0.53
9,98,6,480,11,5.69,491,23.93,0.5,0.53
9,98,6,480,11,5.69,491,23.93,0.5,0.53
9,98,6,480,11,5.69,491,23.93,0.5,0.53
9,98,6,480,11,5.69,491,23.93,0.5,0.53
10,208,27,495,12,5.82,507,24.94,0.5,0.53
10,208,27,495,12,5.82,507,24.94,0.5,0.53
10,208,27,495,12,5.82,507,24.94,0.5,0.53
10,208,27,495,12,5.82,507,24.94,0.5,0.53
10,208,27,495,12,5.82,507,24.94,0.5,0.53
10,208,27,495,12,5.82,507,24.94,0.5,0.53
10,208,27,495,12,5.82,507,24.94,0.5,0.53
14,168,96,509,12,6.19,521,25.63,0.5,0.53
14,168,96,509,12,6.19,521,25.63,0.5,0.53
14,168,96,509,12,6.19,521,25.63,0.5,0.53
14,168,96,509,12,6.19,521,25.63,0.5,0.53
14,168,96,509,12,6.19,521,25.63,0.5,0.53
14,168,96,509,12,6.19,521,25.63,0.5,0.53
14,168,96,509,12,6.19,521,25.63,0.5,0.53
0,29,84,518,9,4.68,527,20.53,0.51,0.54
0,29,84,518,9,4.68,527,20.53,0.51,0.54
0,29,84,518,9,4.68,527,20.53,0.51,0.54
0,29,84,518,9,4.68,527,20.53,0.51,0.54
0,29,84,518,9,4.68,527,20.53,0.51,0.54
0,29,84,518,9,4.68,527,20.53,0.51,0.54
0,29,84,518,9,4.68,527,20.53,0.51,0.54
8,72,10,518,5,2.66,523,13.73,0.53,0.55
8,72,10,518,5,2.66,523,13.73,0.53,0.55
8,72,10,518,5,2.66,523,13.73,0.53,0.55
8,72,10,518,5,2.66,523,13.73,0.53,0.55
8,72,10,518,5,2.66,523,13.73,0.53,0.55
8,72,10,518,5,2.66,523,13.73,0.53,0.55
8,72,10,518,5,2.66,523,13.73,0.53,0.55
10,82,27,530,5,2.46,535,13.37,0.53,0.55
10,82,27,530,5,2.46,535,13.37,0.53,0.55
10,82,27,530,5,2.46,535,13.37,0.53,0.55
10,82,27,530,5,2.46,535,13.37,0.53,0.55
10,82,27,530,5,2.46,535,13.37,0.53,0.55
10,82,27,530,5,2.46,535,13.37,0.53,0.55
10,82,27,530,5,2.46,535,13.37,0.53,0.55
12,239,25,524,17,8.41,541,33.56,0.48,0.52
12,239,25,524,17,8.41,541,33.56,0.48,0.52
12,239,25,524,17,8.41,541,33.56,0.48,0.52
12,239,25,524,17,8.41,541,33.56,0.48,0.52
12,239,25,524,17,8.41,541,33.56,0.48,0.52
12,239,25,524,17,8.41,541,33.56,0.48,0.52
12,239,25,524,17,8.41,541,33.56,0.48,0.52
14,249,96,514,18,9.24,532,35.85,0.47000000000000003,0.52
14,249,96,514,18,9.24,532,35.85,0.47000000000000003,0.52
14,249,96,514,18,9.24,532,35.85,0.47000000000000003,0.52
14,249,96,514,18,9.24,532,35.85,0.47000000000000003,0.52
14,249,96,514,18,9.24,532,35.85,0.47000000000000003,0.52
14,249,96,514,18,9.24,532,35.85,0.47000000000000003,0.52
14,249,96,514,18,9.24,532,35.85,0.47000000000000003,0.52
0,173,84,546,11,5.49,557,23.58,0.5,0.53
0,173,84,546,11,5.49,557,23.58,0.5,0.53
0,173,84,546,11,5.49,557,23.58,0.5,0.53
0,173,84,546,11,5.49,557,23.58,0.5,0.53
0,173,84,546,11,5.49,557,23.58,0.5,0.53
0,173,84,546,11,5.49,557,23.58,0.5,0.53
0,173,84,546,11,5.49,557,23.58,0.5,0.53
2,106,48,548,6,3.04,554,15.21,0.52,0.54
2,106,48,548,6,3.04,554,15.21,0.52,0.54
2,106,48,548,6,3.04,554,15.21,0.52,0.54
2,106,48,548,6,3.04,554,15.21,0.52,0.54
2,106,48,548,6,3.04,554,15.21,0.52,0.54
2,106,48,548,6,3.04,554,15.21,0.52,0.54
2,106,48,548,6,3.04,554,15.21,0.52,0.54
9,108,6,568,3,1.31,571,9.72,0.54,0.55
9,108,6,568,3,1.31,571,9.72,0.54,0.55
9,108,6,568,3,1.31,571,9.72,0.54,0.55
9,108,6,568,3,1.31,571,9.72,0.54,0.55
9,108,6,568,3,1.31,571,9.72,0.54,0.55
9,108,6,568,3,1.31,571,9.72,0.54,0.55
9,108,6,568,3,1.31,571,9.72,0.54,0.55
6,173,71,578,1,0.42,579,6.55,0.55,0.55
6,173,71,578,1,0.42,579,6.55,0.55,0.55
6,173,71,578,1,0.42,579,6.55,0.55,0.55
6,173,71,578,1,0.42,579,6.55,0.55,0.55
6,173,71,578,1,0.42,579,6.55,0.55,0.55
6,173,71,578,1,0.42,579,6.55,0.55,0.55
6,173,71,578,1,0.42,579,6.55,0.55,0.55
12,215,25,579,21,10.71,600,40.87,0.46,0.51
12,215,25,579,21,10.71,600,40.87,0.46,0.51
12,215,25,579,21,10.71,600,40.87,0.46,0.51
12,215,25,579,21,10.71,600,40.87,0.46,0.51
12,215,25,579,21,10.71,600,40.87,0.46,0.51
12,215,25,579,21,10.71,600,40.87,0.46,0.51
12,215,25,579,21,10.71,600,40.87,0.46,0.51
1,992,8,637,8,4.2,645,18.88,0.52,0.54
1,992,8,637,8,4.2,645,18.88,0.52,0.54
1,992,8,637,8,4.2,645,18.88,0.52,0.54
1,992,8,637,8,4.2,645,18.88,0.52,0.54
1,992,8,637,8,4.2,645,18.88,0.52,0.54
1,992,8,637,8,4.2,645,18.88,0.52,0.54
1,992,8,637,8,4.2,645,18.88,0.52,0.54
1,764,8,661,9,4.48,670,20.17,0.51,0.54
1,764,8,661,9,4.48,670,20.17,0.51,0.54
1,764,8,661,9,4.48,670,20.17,0.51,0.54
1,764,8,661,9,4.48,670,20.17,0.51,0.54
1,764,8,661,9,4.48,670,20.17,0.51,0.54
1,764,8,661,9,4.48,670,20.17,0.51,0.54
1,764,8,661,9,4.48,670,20.17,0.51,0.54
10,974,27,695,8,4.1,703,18.69,0.52,0.54
10,974,27,695,8,4.1,703,18.69,0.52,0.54
10,974,27,695,8,4.1,703,18.69,0.52,0.54
10,974,27,695,8,4.1,703,18.69,0.52,0.54
10,974,27,695,8,4.1,703,18.69,0.52,0.54
10,974,27,695,8,4.1,703,18.69,0.52,0.54
10,974,27,695,8,4.1,703,18.69,0.52,0.54
13,897,87,733,12,6.02,745,25.32,0.5,0.53
13,897,87,733,12,6.02,745,25.32,0.5,0.53
13,897,87,733,12,6.02,745,25.32,0.5,0.53
13,897,87,733,12,6.02,745,25.32,0.5,0.53
13,897,87,733,12,6.02,745,25.32,0.5,0.53
13,897,87,733,12,6.02,745,25.32,0.5,0.53
13,897,87,733,12,6.02,745,25.32,0.5,0.53
10,836,26,905,7,3.69,912,17.17,0.52,0.54
10,836,26,905,7,3.69,912,17.17,0.52,0.54
10,836,26,905,7,3.69,912,17.17,0.52,0.54
10,836,26,905,7,3.69,912,17.17,0.52,0.54
10,836,26,905,7,3.69,912,17.17,0.52,0.54
10,836,26,905,7,3.69,912,17.17,0.52,0.54
10,836,26,905,7,3.69,912,17.17,0.52,0.54
0,750,88,937,7,3.44,944,16.73,0.52,0.54
0,750,88,937,7,3.44,944,16.73,0.52,0.54
0,750,88,937,7,3.44,944,16.73,0.52,0.54
0,750,88,937,7,3.44,944,16.73,0.52,0.54
0,750,88,937,7,3.44,944,16.73,0.52,0.54
0,750,88,937,7,3.44,944,16.73,0.52,0.54
0,750,88,937,7,3.44,944,16.73,0.52,0.54
7,962,15,974,15,7.59,989,30.51,0.49,0.52
7,962,15,974,15,7.59,989,30.51,0.49,0.52
7,962,15,974,15,7.59,989,30.51,0.49,0.52
7,962,15,974,15,7.59,989,30.51,0.49,0.52
7,962,15,974,15,7.59,989,30.51,0.49,0.52
7,962,15,974,15,7.59,989,30.51,0.49,0.52
7,962,15,974,15,7.59,989,30.51,0.49,0.52
0,364,88,1013,7,3.66,1020,17.11,0.52,0.54
0,364,88,1013,7,3.66,1020,17.11,0.52,0.54
0,364,88,1013,7,3.66,1020,17.11,0.52,0.54
0,364,88,1013,7,3.66,1020,17.11,0.52,0.54
0,364,88,1013,7,3.66,1020,17.11,0.52,0.54
0,364,88,1013,7,3.66,1020,17.11,0.52,0.54
0,364,88,1013,7,3.66,1020,17.11,0.52,0.54
7,425,15,1005,6,3.01,1011,15.16,0.52,0.54
7,425,15,1005,6,3.01,1011,15.16,0.52,0.54
7,425,15,1005,6,3.01,1011,15.16,0.52,0.54
7,425,15,1005,6,3.01,1011,15.16,0.52,0.54
7,425,15,1005,6,3.01,1011,15.16,0.52,0.54
7,425,15,1005,6,3.01,1011,15.16,0.52,0.54
7,425,15,1005,6,3.01,1011,15.16,0.52,0.54
12,439,35,1073,13,6.38,1086,26.75,0.5,0.53
12,439,35,1073,13,6.38,1086,26.75,0.5,0.53
12,439,35,1073,13,6.38,1086,26.75,0.5,0.53
12,439,35,1073,13,6.38,1086,26.75,0.5,0.53
12,439,35,1073,13,6.38,1086,26.75,0.5,0.53
12,439,35,1073,13,6.38,1086,26.75,0.5,0.53
12,439,35,1073,13,6.38,1086,26.75,0.5,0.53
12,442,35,1097,17,8.54,1114,33.8,0.48,0.52
12,442,35,1097,17,8.54,1114,33.8,0.48,0.52
12,442,35,1097,17,8.54,1114,33.8,0.48,0.52
12,442,35,1097,17,8.54,1114,33.8,0.48,0.52
12,442,35,1097,17,8.54,1114,33.8,0.48,0.52
12,442,35,1097,17,8.54,1114,33.8,0.48,0.52
12,442,35,1097,17,8.54,1114,33.8,0.48,0.52
12,539,35,1110,6,3.1,1116,15.32,0.52,0.54
12,539,35,1110,6,3.1,1116,15.32,0.52,0.54
12,539,35,1110,6,3.1,1116,15.32,0.52,0.54
12,539,35,1110,6,3.1,1116,15.32,0.52,0.54
12,539,35,1110,6,3.1,1116,15.32,0.52,0.54
12,539,35,1110,6,3.1,1116,15.32,0.52,0.54
12,539,35,1110,6,3.1,1116,15.32,0.52,0.54
4,901,91,1173,4,2.18,1177,12.09,0.53,0.55
4,901,91,1173,4,2.18,1177,12.09,0.53,0.55
4,901,91,1173,4,2.18,1177,12.09,0.53,0.55
4,901,91,1173,4,2.18,1177,12.09,0.53,0.55
4,901,91,1173,4,2.18,1177,12.09,0.53,0.55
4,901,91,1173,4,2.18,1177,12.09,0.53,0.55
4,901,91,1173,4,2.18,1177,12.09,0.53,0.55
1,662,8,1239,13,6.54,1252,27.04,0.49,0.53
1,662,8,1239,13,6.54,1252,27.04,0.49,0.53
1,662,8,1239,13,6.54,1252,27.04,0.49,0.53
1,662,8,1239,13,6.54,1252,27.04,0.49,0.53
1,662,8,1239,13,6.54,1252,27.04,0.49,0.53
1,662,8,1239,13,6.54,1252,27.04,0.49,0.53
1,662,8,1239,13,6.54,1252,27.04,0.49,0.53
1,655,8,1304,14,6.76,1318,28.22,0.49,0.53
1,655,8,1304,14,6.76,1318,28.22,0.49,0.53
1,655,8,1304,14,6.76,1318,28.22,0.49,0.53
1,655,8,1304,14,6.76,1318,28.22,0.49,0.53
1,655,8,1304,14,6.76,1318,28.22,0.49,0.53
1,655,8,1304,14,6.76,1318,28.22,0.49,0.53
1,655,8,1304,14,6.76,1318,28.22,0.49,0.53
4,672,91,1316,13,6.43,1329,26.85,0.5,0.53
4,672,91,1316,13,6.43,1329,26.85,0.5,0.53
4,672,91,1316,13,6.43,1329,26.85,0.5,0.53
4,672,91,1316,13,6.43,1329,26.85,0.5,0.53
4,672,91,1316,13,6.43,1329,26.85,0.5,0.53
4,672,91,1316,13,6.43,1329,26.85,0.5,0.53
4,672,91,1316,13,6.43,1329,26.85,0.5,0.53
10,553,29,1311,12,5.85,1323,25.01,0.5,0.53
10,553,29,1311,12,5.85,1323,25.01,0.5,0.53
10,553,29,1311,12,5.85,1323,25.01,0.5,0.53
10,553,29,1311,12,5.85,1323,25.01,0.5,0.53
10,553,29,1311,12,5.85,1323,25.01,0.5,0.53
10,553,29,1311,12,5.85,1323,25.01,0.5,0.53
10,553,29,1311,12,5.85,1323,25.01,0.5,0.53
1,576,8,1332,4,2.16,1336,12.05,0.53,0.55
1,576,8,1332,4,2.16,1336,12.05,0.53,0.55
1,576,8,1332,4,2.16,1336,12.05,0.53,0.55
1,576,8,1332,4,2.16,1336,12.05,0.53,0.55
1,576,8,1332,4,2.16,1336,12.05,0.53,0.55
1,576,8,1332,4,2.16,1336,12.05,0.53,0.55
1,576,8,1332,4,2.16,1336,12.05,0.53,0.55
10,738,29,1320,13,6.7,1333,27.34,0.49,0.53
10,738,29,1320,13,6.7,1333,27.34,0.49,0.53
10,738,29,1320,13,6.7,1333,27.34,0.49,0.53
10,738,29,1320,13,6.7,1333,27.34,0.49,0.53
10,738,29,1320,13,6.7,1333,27.34,0.49,0.53
10,738,29,1320,13,6.7,1333,27.34,0.49,0.53
10,738,29,1320,13,6.7,1333,27.34,0.49,0.53
10,574,29,1397,8,4.14,1405,18.77,0.52,0.54
10,574,29,1397,8,4.14,1405,18.77,0.52,0.54
10,574,29,1397,8,4.14,1405,18.77,0.52,0.54
10,574,29,1397,8,4.14,1405,18.77,0.52,0.54
10,574,29,1397,8,4.14,1405,18.77,0.52,0.54
10,574,29,1397,8,4.14,1405,18.77,0.52,0.54
10,574,29,1397,8,4.14,1405,18.77,0.52,0.54
