square_index,rider_id,driver_idx,trip_start_timestamp,trip_duration,ride_miles,trip_end_timestamp,price_of_ride,rider_acceptance_prob,driver_acceptance_prob
3,20,12,471,25,12.26,496,46.81,0.45,0.5
14,36,17,455,5,2.38,460,13.24,0.53,0.55
4,164,99,488,12,5.96,500,25.2,0.5,0.53
7,240,84,505,15,7.38,520,30.13,0.49,0.52
4,178,99,537,7,3.43,544,16.71,0.52,0.54
7,226,84,532,9,4.29,541,19.82,0.51,0.54
4,169,99,625,13,6.52,638,27.01,0.49,0.53
11,768,1,701,2,1.04,703,8.46,0.54,0.55
2,965,94,800,18,9.08,818,35.57,0.47000000000000003,0.52
2,950,94,812,7,3.37,819,16.58,0.52,0.54
0,310,45,1032,2,0.9500000000000001,1034,8.28,0.54,0.55
0,339,45,1063,13,6.31,1076,26.62,0.5,0.53
11,448,5,1073,7,3.25,1080,16.38,0.52,0.54
5,326,74,1109,4,2.02,1113,11.8,0.53,0.55
11,478,5,1118,9,4.7,1127,20.58,0.51,0.54
5,475,74,1146,6,3.03,1152,15.2,0.52,0.54
11,742,5,1231,14,7.22,1245,29.05,0.49,0.53
2,283,70,1268,16,8.21,1284,32.42,0.48,0.52
2,584,70,1305,9,4.48,1314,20.17,0.51,0.54
2,534,70,1320,2,1.07,1322,8.51,0.54,0.55
2,573,70,1351,7,3.73,1358,17.25,0.52,0.54
14,809,26,61,14,7.15,75,28.94,0.49,0.53
14,809,26,61,14,7.15,75,28.94,0.49,0.53
3,944,66,171,16,7.99,187,32.03,0.48,0.52
3,944,66,171,16,7.99,187,32.03,0.48,0.52
3,802,66,241,7,3.5100000000000002,248,16.85,0.52,0.54
3,802,66,241,7,3.5100000000000002,248,16.85,0.52,0.54
1,153,35,352,5,2.32,357,13.13,0.53,0.55
1,153,35,352,5,2.32,357,13.13,0.53,0.55
4,874,51,376,14,7.23,390,29.07,0.49,0.53
4,874,51,376,14,7.23,390,29.07,0.49,0.53
0,229,47,411,17,8.72,428,34.14,0.48,0.52
0,229,47,411,17,8.72,428,34.14,0.48,0.52
1,192,35,434,15,7.48,449,30.31,0.49,0.52
1,192,35,434,15,7.48,449,30.31,0.49,0.52
4,117,51,445,19,9.31,464,36.77,0.47000000000000003,0.52
4,117,51,445,19,9.31,464,36.77,0.47000000000000003,0.52
6,214,52,444,2,0.9400000000000001,446,8.27,0.54,0.55
6,214,52,444,2,0.9400000000000001,446,8.27,0.54,0.55
1,86,35,465,10,5.2,475,22.26,0.51,0.53
1,86,35,465,10,5.2,475,22.26,0.51,0.53
6,791,52,464,5,2.63,469,13.69,0.53,0.55
6,791,52,464,5,2.63,469,13.69,0.53,0.55
12,31,98,466,11,5.73,477,24.0,0.5,0.53
12,31,98,466,11,5.73,477,24.0,0.5,0.53
4,233,51,502,4,1.94,506,11.65,0.53,0.55
4,233,51,502,4,1.94,506,11.65,0.53,0.55
10,240,89,525,7,3.39,532,16.63,0.52,0.54
10,240,89,525,7,3.39,532,16.63,0.52,0.54
6,68,52,542,17,8.27,559,33.31,0.48,0.52
6,68,52,542,17,8.27,559,33.31,0.48,0.52
13,86,16,558,7,3.62,565,17.05,0.52,0.54
13,86,16,558,7,3.62,565,17.05,0.52,0.54
1,67,35,579,15,7.4,594,30.17,0.49,0.52
1,67,35,579,15,7.4,594,30.17,0.49,0.52
13,86,16,570,8,4.04,578,18.59,0.52,0.54
13,86,16,570,8,4.04,578,18.59,0.52,0.54
13,209,16,627,12,6.24,639,25.71,0.5,0.53
13,209,16,627,12,6.24,639,25.71,0.5,0.53
6,992,52,763,11,5.28,774,23.2,0.5,0.53
6,992,52,763,11,5.28,774,23.2,0.5,0.53
13,930,16,877,3,1.33,880,9.75,0.54,0.55
13,930,16,877,3,1.33,880,9.75,0.54,0.55
15,825,88,1016,9,4.58,1025,20.35,0.51,0.54
15,825,88,1016,9,4.58,1025,20.35,0.51,0.54
1,267,35,1044,1,0.53,1045,6.74,0.55,0.55
1,267,35,1044,1,0.53,1045,6.74,0.55,0.55
14,294,39,1027,7,3.74,1034,17.27,0.52,0.54
14,294,39,1027,7,3.74,1034,17.27,0.52,0.54
1,354,35,1067,7,3.32,1074,16.5,0.52,0.54
1,354,35,1067,7,3.32,1074,16.5,0.52,0.54
14,308,39,1067,10,5.13,1077,22.14,0.51,0.53
14,308,39,1067,10,5.13,1077,22.14,0.51,0.53
6,455,52,1083,10,4.87,1093,21.66,0.51,0.54
6,455,52,1083,10,4.87,1093,21.66,0.51,0.54
10,381,96,1108,9,4.66,1117,20.49,0.51,0.54
10,381,96,1108,9,4.66,1117,20.49,0.51,0.54
14,334,39,1082,1,0.45,1083,6.6,0.55,0.55
14,334,39,1082,1,0.45,1083,6.6,0.55,0.55
14,364,39,1135,3,1.73,1138,10.5,0.54,0.55
14,364,39,1135,3,1.73,1138,10.5,0.54,0.55
6,449,52,1141,10,4.82,1151,21.56,0.51,0.54
6,449,52,1141,10,4.82,1151,21.56,0.51,0.54
14,292,39,1160,5,2.4,1165,13.26,0.53,0.55
14,292,39,1160,5,2.4,1165,13.26,0.53,0.55
14,751,39,1180,9,4.27,1189,19.79,0.51,0.54
14,751,39,1180,9,4.27,1189,19.79,0.51,0.54
6,708,52,1223,6,3.17,1229,15.45,0.52,0.54
6,708,52,1223,6,3.17,1229,15.45,0.52,0.54
14,650,39,1229,14,6.99,1243,28.64,0.49,0.53
14,650,39,1229,14,6.99,1243,28.64,0.49,0.53
4,617,17,1258,16,7.76,1274,31.61,0.48,0.52
4,617,17,1258,16,7.76,1274,31.61,0.48,0.52
14,436,39,1233,15,7.3,1248,29.98,0.49,0.53
14,436,39,1233,15,7.3,1248,29.98,0.49,0.53
4,536,17,1260,7,3.46,1267,16.75,0.52,0.54
4,536,17,1260,7,3.46,1267,16.75,0.52,0.54
6,710,52,1285,2,0.98,1287,8.34,0.54,0.55
6,710,52,1285,2,0.98,1287,8.34,0.54,0.55
2,724,1,1314,15,7.33,1329,30.03,0.49,0.52
2,724,1,1314,15,7.33,1329,30.03,0.49,0.52
4,634,17,1311,12,5.94,1323,25.17,0.5,0.53
4,634,17,1311,12,5.94,1323,25.17,0.5,0.53
6,519,52,1317,5,2.73,1322,13.86,0.53,0.55
6,519,52,1317,5,2.73,1322,13.86,0.53,0.55
14,733,39,1297,11,5.28,1308,23.19,0.5,0.53
14,733,39,1297,11,5.28,1308,23.19,0.5,0.53
6,629,52,1320,10,5.13,1330,22.14,0.51,0.53
6,629,52,1320,10,5.13,1330,22.14,0.51,0.53
14,650,39,1321,5,2.4,1326,13.28,0.53,0.55
14,650,39,1321,5,2.4,1326,13.28,0.53,0.55
6,907,52,1428,7,3.55,1435,16.92,0.52,0.54
6,907,52,1428,7,3.55,1435,16.92,0.52,0.54
15,971,49,214,16,8.12,230,32.25,0.48,0.52
15,971,49,214,16,8.12,230,32.25,0.48,0.52
15,971,49,214,16,8.12,230,32.25,0.48,0.52
9,938,95,324,7,3.57,331,16.95,0.52,0.54
9,938,95,324,7,3.57,331,16.95,0.52,0.54
9,938,95,324,7,3.57,331,16.95,0.52,0.54
14,944,81,302,16,8.01,318,32.07,0.48,0.52
14,944,81,302,16,8.01,318,32.07,0.48,0.52
14,944,81,302,16,8.01,318,32.07,0.48,0.52
5,703,62,347,7,3.54,354,16.91,0.52,0.54
5,703,62,347,7,3.54,354,16.91,0.52,0.54
5,703,62,347,7,3.54,354,16.91,0.52,0.54
4,219,47,374,3,1.7,377,10.44,0.54,0.55
4,219,47,374,3,1.7,377,10.44,0.54,0.55
4,219,47,374,3,1.7,377,10.44,0.54,0.55
14,27,81,383,12,5.98,395,25.24,0.5,0.53
14,27,81,383,12,5.98,395,25.24,0.5,0.53
14,27,81,383,12,5.98,395,25.24,0.5,0.53
4,114,47,411,16,8.13,427,32.29,0.48,0.52
4,114,47,411,16,8.13,427,32.29,0.48,0.52
4,114,47,411,16,8.13,427,32.29,0.48,0.52
13,225,5,418,11,5.33,429,23.27,0.5,0.53
13,225,5,418,11,5.33,429,23.27,0.5,0.53
13,225,5,418,11,5.33,429,23.27,0.5,0.53
15,194,49,411,14,6.88,425,28.43,0.49,0.53
15,194,49,411,14,6.88,425,28.43,0.49,0.53
15,194,49,411,14,6.88,425,28.43,0.49,0.53
7,160,40,432,14,7.17,446,28.97,0.49,0.53
7,160,40,432,14,7.17,446,28.97,0.49,0.53
7,160,40,432,14,7.17,446,28.97,0.49,0.53
10,47,70,436,8,3.86,444,18.27,0.52,0.54
10,47,70,436,8,3.86,444,18.27,0.52,0.54
10,47,70,436,8,3.86,444,18.27,0.52,0.54
7,89,40,474,16,7.95,490,31.95,0.48,0.52
7,89,40,474,16,7.95,490,31.95,0.48,0.52
7,89,40,474,16,7.95,490,31.95,0.48,0.52
10,197,70,460,8,4.06,468,18.63,0.52,0.54
10,197,70,460,8,4.06,468,18.63,0.52,0.54
10,197,70,460,8,4.06,468,18.63,0.52,0.54
12,118,33,471,16,8.02,487,32.07,0.48,0.52
12,118,33,471,16,8.02,487,32.07,0.48,0.52
12,118,33,471,16,8.02,487,32.07,0.48,0.52
15,62,49,456,3,1.55,459,10.15,0.54,0.55
15,62,49,456,3,1.55,459,10.15,0.54,0.55
15,62,49,456,3,1.55,459,10.15,0.54,0.55
10,9,70,490,7,3.29,497,16.45,0.52,0.54
10,9,70,490,7,3.29,497,16.45,0.52,0.54
10,9,70,490,7,3.29,497,16.45,0.52,0.54
10,73,70,533,7,3.28,540,16.44,0.52,0.54
10,73,70,533,7,3.28,540,16.44,0.52,0.54
10,73,70,533,7,3.28,540,16.44,0.52,0.54
6,170,80,545,7,3.41,552,16.67,0.52,0.54
6,170,80,545,7,3.41,552,16.67,0.52,0.54
6,170,80,545,7,3.41,552,16.67,0.52,0.54
9,206,95,545,10,5.15,555,22.18,0.51,0.53
9,206,95,545,10,5.15,555,22.18,0.51,0.53
9,206,95,545,10,5.15,555,22.18,0.51,0.53
9,164,95,571,8,4.03,579,18.57,0.52,0.54
9,164,95,571,8,4.03,579,18.57,0.52,0.54
9,164,95,571,8,4.03,579,18.57,0.52,0.54
10,976,70,571,5,2.31,576,13.11,0.53,0.55
10,976,70,571,5,2.31,576,13.11,0.53,0.55
10,976,70,571,5,2.31,576,13.11,0.53,0.55
15,830,49,642,20,9.78,662,38.39,0.47000000000000003,0.51
15,830,49,642,20,9.78,662,38.39,0.47000000000000003,0.51
15,830,49,642,20,9.78,662,38.39,0.47000000000000003,0.51
2,904,46,687,10,4.93,697,21.77,0.51,0.54
2,904,46,687,10,4.93,697,21.77,0.51,0.54
2,904,46,687,10,4.93,697,21.77,0.51,0.54
2,800,46,728,4,1.8900000000000001,732,11.57,0.53,0.55
2,800,46,728,4,1.8900000000000001,732,11.57,0.53,0.55
2,800,46,728,4,1.8900000000000001,732,11.57,0.53,0.55
10,826,70,738,12,6.04,750,25.35,0.5,0.53
10,826,70,738,12,6.04,750,25.35,0.5,0.53
10,826,70,738,12,6.04,750,25.35,0.5,0.53
2,842,46,866,11,5.34,877,23.31,0.5,0.53
2,842,46,866,11,5.34,877,23.31,0.5,0.53
2,842,46,866,11,5.34,877,23.31,0.5,0.53
2,807,46,904,3,1.56,907,10.19,0.54,0.55
2,807,46,904,3,1.56,907,10.19,0.54,0.55
2,807,46,904,3,1.56,907,10.19,0.54,0.55
7,390,88,944,4,1.97,948,11.7,0.53,0.55
7,390,88,944,4,1.97,948,11.7,0.53,0.55
7,390,88,944,4,1.97,948,11.7,0.53,0.55
6,322,16,1008,3,1.45,1011,9.99,0.54,0.55
6,322,16,1008,3,1.45,1011,9.99,0.54,0.55
6,322,16,1008,3,1.45,1011,9.99,0.54,0.55
7,356,88,1016,13,6.44,1029,26.86,0.5,0.53
7,356,88,1016,13,6.44,1029,26.86,0.5,0.53
7,356,88,1016,13,6.44,1029,26.86,0.5,0.53
7,259,88,1033,7,3.34,1040,16.54,0.52,0.54
7,259,88,1033,7,3.34,1040,16.54,0.52,0.54
7,259,88,1033,7,3.34,1040,16.54,0.52,0.54
7,399,88,1065,10,5.05,1075,22.0,0.51,0.53
7,399,88,1065,10,5.05,1075,22.0,0.51,0.53
7,399,88,1065,10,5.05,1075,22.0,0.51,0.53
7,463,88,1097,11,5.49,1108,23.57,0.5,0.53
7,463,88,1097,11,5.49,1108,23.57,0.5,0.53
7,463,88,1097,11,5.49,1108,23.57,0.5,0.53
12,348,8,1085,16,7.91,1101,31.87,0.48,0.52
12,348,8,1085,16,7.91,1101,31.87,0.48,0.52
12,348,8,1085,16,7.91,1101,31.87,0.48,0.52
7,301,88,1135,9,4.41,1144,20.04,0.51,0.54
7,301,88,1135,9,4.41,1144,20.04,0.51,0.54
7,301,88,1135,9,4.41,1144,20.04,0.51,0.54
10,436,55,1116,1,0.6000000000000001,1117,6.88,0.55,0.55
10,436,55,1116,1,0.6000000000000001,1117,6.88,0.55,0.55
10,436,55,1116,1,0.6000000000000001,1117,6.88,0.55,0.55
12,426,8,1122,8,3.84,1130,18.23,0.52,0.54
12,426,8,1122,8,3.84,1130,18.23,0.52,0.54
12,426,8,1122,8,3.84,1130,18.23,0.52,0.54
7,441,88,1152,7,3.59,1159,16.99,0.52,0.54
7,441,88,1152,7,3.59,1159,16.99,0.52,0.54
7,441,88,1152,7,3.59,1159,16.99,0.52,0.54
12,376,8,1155,9,4.51,1164,20.23,0.51,0.54
12,376,8,1155,9,4.51,1164,20.23,0.51,0.54
12,376,8,1155,9,4.51,1164,20.23,0.51,0.54
12,533,8,1229,10,4.97,1239,21.85,0.51,0.54
12,533,8,1229,10,4.97,1239,21.85,0.51,0.54
12,533,8,1229,10,4.97,1239,21.85,0.51,0.54
12,695,8,1278,4,1.83,1282,11.46,0.53,0.55
12,695,8,1278,4,1.83,1282,11.46,0.53,0.55
12,695,8,1278,4,1.83,1282,11.46,0.53,0.55
8,508,30,1314,3,1.35,1317,9.8,0.54,0.55
8,508,30,1314,3,1.35,1317,9.8,0.54,0.55
8,508,30,1314,3,1.35,1317,9.8,0.54,0.55
12,565,8,1291,7,3.74,1298,17.26,0.52,0.54
12,565,8,1291,7,3.74,1298,17.26,0.52,0.54
12,565,8,1291,7,3.74,1298,17.26,0.52,0.54
12,508,8,1341,19,9.73,1360,37.52,0.47000000000000003,0.52
12,508,8,1341,19,9.73,1360,37.52,0.47000000000000003,0.52
12,508,8,1341,19,9.73,1360,37.52,0.47000000000000003,0.52
8,565,30,1353,5,2.71,1358,13.83,0.53,0.55
8,565,30,1353,5,2.71,1358,13.83,0.53,0.55
8,565,30,1353,5,2.71,1358,13.83,0.53,0.55
12,847,8,1359,19,9.61,1378,37.31,0.47000000000000003,0.52
12,847,8,1359,19,9.61,1378,37.31,0.47000000000000003,0.52
12,847,8,1359,19,9.61,1378,37.31,0.47000000000000003,0.52
4,920,54,67,8,3.95,75,18.43,0.52,0.54
4,920,54,67,8,3.95,75,18.43,0.52,0.54
4,920,54,67,8,3.95,75,18.43,0.52,0.54
4,920,54,67,8,3.95,75,18.43,0.52,0.54
4,871,54,204,14,6.89,218,28.46,0.49,0.53
4,871,54,204,14,6.89,218,28.46,0.49,0.53
4,871,54,204,14,6.89,218,28.46,0.49,0.53
4,871,54,204,14,6.89,218,28.46,0.49,0.53
2,872,45,343,12,5.97,355,25.22,0.5,0.53
2,872,45,343,12,5.97,355,25.22,0.5,0.53
2,872,45,343,12,5.97,355,25.22,0.5,0.53
2,872,45,343,12,5.97,355,25.22,0.5,0.53
14,137,36,377,11,5.5,388,23.6,0.5,0.53
14,137,36,377,11,5.5,388,23.6,0.5,0.53
14,137,36,377,11,5.5,388,23.6,0.5,0.53
14,137,36,377,11,5.5,388,23.6,0.5,0.53
10,184,19,394,9,4.48,403,20.18,0.51,0.54
10,184,19,394,9,4.48,403,20.18,0.51,0.54
10,184,19,394,9,4.48,403,20.18,0.51,0.54
10,184,19,394,9,4.48,403,20.18,0.51,0.54
14,10,36,409,9,4.57,418,20.33,0.51,0.54
14,10,36,409,9,4.57,418,20.33,0.51,0.54
14,10,36,409,9,4.57,418,20.33,0.51,0.54
14,10,36,409,9,4.57,418,20.33,0.51,0.54
4,164,54,431,2,1.03,433,8.44,0.54,0.55
4,164,54,431,2,1.03,433,8.44,0.54,0.55
4,164,54,431,2,1.03,433,8.44,0.54,0.55
4,164,54,431,2,1.03,433,8.44,0.54,0.55
5,69,76,422,5,2.72,427,13.84,0.53,0.55
5,69,76,422,5,2.72,427,13.84,0.53,0.55
5,69,76,422,5,2.72,427,13.84,0.53,0.55
5,69,76,422,5,2.72,427,13.84,0.53,0.55
9,45,37,433,14,6.86,447,28.4,0.49,0.53
9,45,37,433,14,6.86,447,28.4,0.49,0.53
9,45,37,433,14,6.86,447,28.4,0.49,0.53
9,45,37,433,14,6.86,447,28.4,0.49,0.53
14,204,36,420,10,5.01,430,21.91,0.51,0.54
14,204,36,420,10,5.01,430,21.91,0.51,0.54
14,204,36,420,10,5.01,430,21.91,0.51,0.54
14,204,36,420,10,5.01,430,21.91,0.51,0.54
0,98,50,451,19,9.54,470,37.19,0.47000000000000003,0.52
0,98,50,451,19,9.54,470,37.19,0.47000000000000003,0.52
0,98,50,451,19,9.54,470,37.19,0.47000000000000003,0.52
0,98,50,451,19,9.54,470,37.19,0.47000000000000003,0.52
2,817,45,452,10,4.94,462,21.79,0.51,0.54
2,817,45,452,10,4.94,462,21.79,0.51,0.54
2,817,45,452,10,4.94,462,21.79,0.51,0.54
2,817,45,452,10,4.94,462,21.79,0.51,0.54
5,17,76,455,7,3.31,462,16.48,0.52,0.54
5,17,76,455,7,3.31,462,16.48,0.52,0.54
5,17,76,455,7,3.31,462,16.48,0.52,0.54
5,17,76,455,7,3.31,462,16.48,0.52,0.54
9,802,37,472,11,5.27,483,23.18,0.5,0.53
9,802,37,472,11,5.27,483,23.18,0.5,0.53
9,802,37,472,11,5.27,483,23.18,0.5,0.53
9,802,37,472,11,5.27,483,23.18,0.5,0.53
0,76,50,491,2,1.18,493,8.7,0.54,0.55
0,76,50,491,2,1.18,493,8.7,0.54,0.55
0,76,50,491,2,1.18,493,8.7,0.54,0.55
0,76,50,491,2,1.18,493,8.7,0.54,0.55
4,231,54,495,16,8.23,511,32.47,0.48,0.52
4,231,54,495,16,8.23,511,32.47,0.48,0.52
4,231,54,495,16,8.23,511,32.47,0.48,0.52
4,231,54,495,16,8.23,511,32.47,0.48,0.52
5,170,76,500,2,0.99,502,8.35,0.54,0.55
5,170,76,500,2,0.99,502,8.35,0.54,0.55
5,170,76,500,2,0.99,502,8.35,0.54,0.55
5,170,76,500,2,0.99,502,8.35,0.54,0.55
6,20,92,493,8,4.23,501,18.95,0.52,0.54
6,20,92,493,8,4.23,501,18.95,0.52,0.54
6,20,92,493,8,4.23,501,18.95,0.52,0.54
6,20,92,493,8,4.23,501,18.95,0.52,0.54
9,122,37,492,11,5.39,503,23.4,0.5,0.53
9,122,37,492,11,5.39,503,23.4,0.5,0.53
9,122,37,492,11,5.39,503,23.4,0.5,0.53
9,122,37,492,11,5.39,503,23.4,0.5,0.53
0,79,50,518,9,4.32,527,19.88,0.51,0.54
0,79,50,518,9,4.32,527,19.88,0.51,0.54
0,79,50,518,9,4.32,527,19.88,0.51,0.54
0,79,50,518,9,4.32,527,19.88,0.51,0.54
4,0,54,511,16,7.9,527,31.86,0.48,0.52
4,0,54,511,16,7.9,527,31.86,0.48,0.52
4,0,54,511,16,7.9,527,31.86,0.48,0.52
4,0,54,511,16,7.9,527,31.86,0.48,0.52
6,169,92,514,9,4.47,523,20.15,0.51,0.54
6,169,92,514,9,4.47,523,20.15,0.51,0.54
6,169,92,514,9,4.47,523,20.15,0.51,0.54
6,169,92,514,9,4.47,523,20.15,0.51,0.54
8,705,11,522,1,0.37,523,6.46,0.55,0.55
8,705,11,522,1,0.37,523,6.46,0.55,0.55
8,705,11,522,1,0.37,523,6.46,0.55,0.55
8,705,11,522,1,0.37,523,6.46,0.55,0.55
4,163,54,566,8,3.77,574,18.1,0.52,0.54
4,163,54,566,8,3.77,574,18.1,0.52,0.54
4,163,54,566,8,3.77,574,18.1,0.52,0.54
4,163,54,566,8,3.77,574,18.1,0.52,0.54
9,222,37,573,7,3.5,580,16.83,0.52,0.54
9,222,37,573,7,3.5,580,16.83,0.52,0.54
9,222,37,573,7,3.5,580,16.83,0.52,0.54
9,222,37,573,7,3.5,580,16.83,0.52,0.54
9,176,37,614,6,3.0,620,15.13,0.52,0.54
9,176,37,614,6,3.0,620,15.13,0.52,0.54
9,176,37,614,6,3.0,620,15.13,0.52,0.54
9,176,37,614,6,3.0,620,15.13,0.52,0.54
6,803,92,709,5,2.56,714,13.56,0.53,0.55
6,803,92,709,5,2.56,714,13.56,0.53,0.55
6,803,92,709,5,2.56,714,13.56,0.53,0.55
6,803,92,709,5,2.56,714,13.56,0.53,0.55
7,809,28,746,18,9.01,764,35.44,0.47000000000000003,0.52
7,809,28,746,18,9.01,764,35.44,0.47000000000000003,0.52
7,809,28,746,18,9.01,764,35.44,0.47000000000000003,0.52
7,809,28,746,18,9.01,764,35.44,0.47000000000000003,0.52
14,860,36,762,16,7.95,778,31.95,0.48,0.52
14,860,36,762,16,7.95,778,31.95,0.48,0.52
14,860,36,762,16,7.95,778,31.95,0.48,0.52
14,860,36,762,16,7.95,778,31.95,0.48,0.52
15,940,33,764,10,5.13,774,22.13,0.51,0.53
15,940,33,764,10,5.13,774,22.13,0.51,0.53
15,940,33,764,10,5.13,774,22.13,0.51,0.53
15,940,33,764,10,5.13,774,22.13,0.51,0.53
9,999,37,816,3,1.54,819,10.15,0.54,0.55
9,999,37,816,3,1.54,819,10.15,0.54,0.55
9,999,37,816,3,1.54,819,10.15,0.54,0.55
9,999,37,816,3,1.54,819,10.15,0.54,0.55
9,316,37,1013,13,6.68,1026,27.3,0.49,0.53
9,316,37,1013,13,6.68,1026,27.3,0.49,0.53
9,316,37,1013,13,6.68,1026,27.3,0.49,0.53
9,316,37,1013,13,6.68,1026,27.3,0.49,0.53
9,954,37,1039,10,5.0,1049,21.89,0.51,0.54
9,954,37,1039,10,5.0,1049,21.89,0.51,0.54
9,954,37,1039,10,5.0,1049,21.89,0.51,0.54
9,954,37,1039,10,5.0,1049,21.89,0.51,0.54
9,312,37,1071,13,6.34,1084,26.67,0.5,0.53
9,312,37,1071,13,6.34,1084,26.67,0.5,0.53
9,312,37,1071,13,6.34,1084,26.67,0.5,0.53
9,312,37,1071,13,6.34,1084,26.67,0.5,0.53
9,440,37,1103,8,3.95,1111,18.43,0.52,0.54
9,440,37,1103,8,3.95,1111,18.43,0.52,0.54
9,440,37,1103,8,3.95,1111,18.43,0.52,0.54
9,440,37,1103,8,3.95,1111,18.43,0.52,0.54
9,458,37,1168,8,3.96,1176,18.45,0.52,0.54
9,458,37,1168,8,3.96,1176,18.45,0.52,0.54
9,458,37,1168,8,3.96,1176,18.45,0.52,0.54
9,458,37,1168,8,3.96,1176,18.45,0.52,0.54
9,838,37,1199,8,4.18,1207,18.85,0.52,0.54
9,838,37,1199,8,4.18,1207,18.85,0.52,0.54
9,838,37,1199,8,4.18,1207,18.85,0.52,0.54
9,838,37,1199,8,4.18,1207,18.85,0.52,0.54
4,902,24,1247,17,8.51,1264,33.76,0.48,0.52
4,902,24,1247,17,8.51,1264,33.76,0.48,0.52
4,902,24,1247,17,8.51,1264,33.76,0.48,0.52
4,902,24,1247,17,8.51,1264,33.76,0.48,0.52
10,509,75,1381,3,1.27,1384,9.66,0.54,0.55
10,509,75,1381,3,1.27,1384,9.66,0.54,0.55
10,509,75,1381,3,1.27,1384,9.66,0.54,0.55
10,509,75,1381,3,1.27,1384,9.66,0.54,0.55
3,73,73,368,7,3.73,375,17.26,0.52,0.54
3,73,73,368,7,3.73,375,17.26,0.52,0.54
3,73,73,368,7,3.73,375,17.26,0.52,0.54
3,73,73,368,7,3.73,375,17.26,0.52,0.54
3,73,73,368,7,3.73,375,17.26,0.52,0.54
0,193,59,435,13,6.6,448,27.15,0.49,0.53
0,193,59,435,13,6.6,448,27.15,0.49,0.53
0,193,59,435,13,6.6,448,27.15,0.49,0.53
0,193,59,435,13,6.6,448,27.15,0.49,0.53
0,193,59,435,13,6.6,448,27.15,0.49,0.53
2,211,56,431,7,3.44,438,16.72,0.52,0.54
2,211,56,431,7,3.44,438,16.72,0.52,0.54
2,211,56,431,7,3.44,438,16.72,0.52,0.54
2,211,56,431,7,3.44,438,16.72,0.52,0.54
2,211,56,431,7,3.44,438,16.72,0.52,0.54
4,85,78,446,3,1.59,449,10.23,0.54,0.55
4,85,78,446,3,1.59,449,10.23,0.54,0.55
4,85,78,446,3,1.59,449,10.23,0.54,0.55
4,85,78,446,3,1.59,449,10.23,0.54,0.55
4,85,78,446,3,1.59,449,10.23,0.54,0.55
7,91,36,422,16,7.91,438,31.87,0.48,0.52
7,91,36,422,16,7.91,438,31.87,0.48,0.52
7,91,36,422,16,7.91,438,31.87,0.48,0.52
7,91,36,422,16,7.91,438,31.87,0.48,0.52
7,91,36,422,16,7.91,438,31.87,0.48,0.52
12,161,15,447,17,8.36,464,33.48,0.48,0.52
12,161,15,447,17,8.36,464,33.48,0.48,0.52
12,161,15,447,17,8.36,464,33.48,0.48,0.52
12,161,15,447,17,8.36,464,33.48,0.48,0.52
12,161,15,447,17,8.36,464,33.48,0.48,0.52
14,60,89,430,13,6.36,443,26.71,0.5,0.53
14,60,89,430,13,6.36,443,26.71,0.5,0.53
14,60,89,430,13,6.36,443,26.71,0.5,0.53
14,60,89,430,13,6.36,443,26.71,0.5,0.53
14,60,89,430,13,6.36,443,26.71,0.5,0.53
2,56,56,470,7,3.3,477,16.46,0.52,0.54
2,56,56,470,7,3.3,477,16.46,0.52,0.54
2,56,56,470,7,3.3,477,16.46,0.52,0.54
2,56,56,470,7,3.3,477,16.46,0.52,0.54
2,56,56,470,7,3.3,477,16.46,0.52,0.54
7,216,36,464,12,5.83,476,24.98,0.5,0.53
7,216,36,464,12,5.83,476,24.98,0.5,0.53
7,216,36,464,12,5.83,476,24.98,0.5,0.53
7,216,36,464,12,5.83,476,24.98,0.5,0.53
7,216,36,464,12,5.83,476,24.98,0.5,0.53
12,187,15,455,12,5.91,467,25.12,0.5,0.53
12,187,15,455,12,5.91,467,25.12,0.5,0.53
12,187,15,455,12,5.91,467,25.12,0.5,0.53
12,187,15,455,12,5.91,467,25.12,0.5,0.53
12,187,15,455,12,5.91,467,25.12,0.5,0.53
12,194,15,503,10,4.83,513,21.59,0.51,0.54
12,194,15,503,10,4.83,513,21.59,0.51,0.54
12,194,15,503,10,4.83,513,21.59,0.51,0.54
12,194,15,503,10,4.83,513,21.59,0.51,0.54
12,194,15,503,10,4.83,513,21.59,0.51,0.54
7,45,36,531,15,7.42,546,30.2,0.49,0.52
7,45,36,531,15,7.42,546,30.2,0.49,0.52
7,45,36,531,15,7.42,546,30.2,0.49,0.52
7,45,36,531,15,7.42,546,30.2,0.49,0.52
7,45,36,531,15,7.42,546,30.2,0.49,0.52
7,776,36,541,10,5.09,551,22.06,0.51,0.53
7,776,36,541,10,5.09,551,22.06,0.51,0.53
7,776,36,541,10,5.09,551,22.06,0.51,0.53
7,776,36,541,10,5.09,551,22.06,0.51,0.53
7,776,36,541,10,5.09,551,22.06,0.51,0.53
10,174,64,557,13,6.52,570,27.01,0.49,0.53
10,174,64,557,13,6.52,570,27.01,0.49,0.53
10,174,64,557,13,6.52,570,27.01,0.49,0.53
10,174,64,557,13,6.52,570,27.01,0.49,0.53
10,174,64,557,13,6.52,570,27.01,0.49,0.53
13,157,16,549,13,6.67,562,27.29,0.49,0.53
13,157,16,549,13,6.67,562,27.29,0.49,0.53
13,157,16,549,13,6.67,562,27.29,0.49,0.53
13,157,16,549,13,6.67,562,27.29,0.49,0.53
13,157,16,549,13,6.67,562,27.29,0.49,0.53
10,187,64,582,2,1.1,584,8.55,0.54,0.55
10,187,64,582,2,1.1,584,8.55,0.54,0.55
10,187,64,582,2,1.1,584,8.55,0.54,0.55
10,187,64,582,2,1.1,584,8.55,0.54,0.55
10,187,64,582,2,1.1,584,8.55,0.54,0.55
12,179,15,584,4,1.81,588,11.41,0.53,0.55
12,179,15,584,4,1.81,588,11.41,0.53,0.55
12,179,15,584,4,1.81,588,11.41,0.53,0.55
12,179,15,584,4,1.81,588,11.41,0.53,0.55
12,179,15,584,4,1.81,588,11.41,0.53,0.55
14,131,89,582,14,6.93,596,28.54,0.49,0.53
14,131,89,582,14,6.93,596,28.54,0.49,0.53
14,131,89,582,14,6.93,596,28.54,0.49,0.53
14,131,89,582,14,6.93,596,28.54,0.49,0.53
14,131,89,582,14,6.93,596,28.54,0.49,0.53
9,750,71,622,6,3.04,628,15.21,0.52,0.54
9,750,71,622,6,3.04,628,15.21,0.52,0.54
9,750,71,622,6,3.04,628,15.21,0.52,0.54
9,750,71,622,6,3.04,628,15.21,0.52,0.54
9,750,71,622,6,3.04,628,15.21,0.52,0.54
11,791,21,627,10,4.87,637,21.66,0.51,0.54
11,791,21,627,10,4.87,637,21.66,0.51,0.54
11,791,21,627,10,4.87,637,21.66,0.51,0.54
11,791,21,627,10,4.87,637,21.66,0.51,0.54
11,791,21,627,10,4.87,637,21.66,0.51,0.54
12,977,15,660,12,6.1,672,25.45,0.5,0.53
12,977,15,660,12,6.1,672,25.45,0.5,0.53
12,977,15,660,12,6.1,672,25.45,0.5,0.53
12,977,15,660,12,6.1,672,25.45,0.5,0.53
12,977,15,660,12,6.1,672,25.45,0.5,0.53
8,790,61,749,9,4.67,758,20.52,0.51,0.54
8,790,61,749,9,4.67,758,20.52,0.51,0.54
8,790,61,749,9,4.67,758,20.52,0.51,0.54
8,790,61,749,9,4.67,758,20.52,0.51,0.54
8,790,61,749,9,4.67,758,20.52,0.51,0.54
13,867,81,801,4,1.84,805,11.48,0.53,0.55
13,867,81,801,4,1.84,805,11.48,0.53,0.55
13,867,81,801,4,1.84,805,11.48,0.53,0.55
13,867,81,801,4,1.84,805,11.48,0.53,0.55
13,867,81,801,4,1.84,805,11.48,0.53,0.55
0,779,45,929,3,1.26,932,9.64,0.54,0.55
0,779,45,929,3,1.26,932,9.64,0.54,0.55
0,779,45,929,3,1.26,932,9.64,0.54,0.55
0,779,45,929,3,1.26,932,9.64,0.54,0.55
0,779,45,929,3,1.26,932,9.64,0.54,0.55
13,318,81,1049,11,5.42,1060,23.44,0.5,0.53
13,318,81,1049,11,5.42,1060,23.44,0.5,0.53
13,318,81,1049,11,5.42,1060,23.44,0.5,0.53
13,318,81,1049,11,5.42,1060,23.44,0.5,0.53
13,318,81,1049,11,5.42,1060,23.44,0.5,0.53
14,263,0,1021,5,2.39,1026,13.25,0.53,0.55
14,263,0,1021,5,2.39,1026,13.25,0.53,0.55
14,263,0,1021,5,2.39,1026,13.25,0.53,0.55
14,263,0,1021,5,2.39,1026,13.25,0.53,0.55
14,263,0,1021,5,2.39,1026,13.25,0.53,0.55
11,470,90,1143,9,4.56,1152,20.31,0.51,0.54
11,470,90,1143,9,4.56,1152,20.31,0.51,0.54
11,470,90,1143,9,4.56,1152,20.31,0.51,0.54
11,470,90,1143,9,4.56,1152,20.31,0.51,0.54
11,470,90,1143,9,4.56,1152,20.31,0.51,0.54
14,665,0,1296,8,4.11,1304,18.73,0.52,0.54
14,665,0,1296,8,4.11,1304,18.73,0.52,0.54
14,665,0,1296,8,4.11,1304,18.73,0.52,0.54
14,665,0,1296,8,4.11,1304,18.73,0.52,0.54
14,665,0,1296,8,4.11,1304,18.73,0.52,0.54
5,502,31,1324,2,0.8200000000000001,1326,8.06,0.54,0.55
5,502,31,1324,2,0.8200000000000001,1326,8.06,0.54,0.55
5,502,31,1324,2,0.8200000000000001,1326,8.06,0.54,0.55
5,502,31,1324,2,0.8200000000000001,1326,8.06,0.54,0.55
5,502,31,1324,2,0.8200000000000001,1326,8.06,0.54,0.55
5,502,31,1383,13,6.32,1396,26.64,0.5,0.53
5,502,31,1383,13,6.32,1396,26.64,0.5,0.53
5,502,31,1383,13,6.32,1396,26.64,0.5,0.53
5,502,31,1383,13,6.32,1396,26.64,0.5,0.53
5,502,31,1383,13,6.32,1396,26.64,0.5,0.53
6,847,71,91,7,3.41,98,16.66,0.52,0.54
6,847,71,91,7,3.41,98,16.66,0.52,0.54
6,847,71,91,7,3.41,98,16.66,0.52,0.54
6,847,71,91,7,3.41,98,16.66,0.52,0.54
6,847,71,91,7,3.41,98,16.66,0.52,0.54
6,847,71,91,7,3.41,98,16.66,0.52,0.54
9,948,24,174,9,4.7,183,20.57,0.51,0.54
9,948,24,174,9,4.7,183,20.57,0.51,0.54
9,948,24,174,9,4.7,183,20.57,0.51,0.54
9,948,24,174,9,4.7,183,20.57,0.51,0.54
9,948,24,174,9,4.7,183,20.57,0.51,0.54
9,948,24,174,9,4.7,183,20.57,0.51,0.54
7,825,67,186,14,7.1,200,28.85,0.49,0.53
7,825,67,186,14,7.1,200,28.85,0.49,0.53
7,825,67,186,14,7.1,200,28.85,0.49,0.53
7,825,67,186,14,7.1,200,28.85,0.49,0.53
7,825,67,186,14,7.1,200,28.85,0.49,0.53
7,825,67,186,14,7.1,200,28.85,0.49,0.53
2,815,34,327,3,1.27,330,9.64,0.54,0.55
2,815,34,327,3,1.27,330,9.64,0.54,0.55
2,815,34,327,3,1.27,330,9.64,0.54,0.55
2,815,34,327,3,1.27,330,9.64,0.54,0.55
2,815,34,327,3,1.27,330,9.64,0.54,0.55
2,815,34,327,3,1.27,330,9.64,0.54,0.55
12,94,94,355,4,1.9000000000000001,359,11.58,0.53,0.55
12,94,94,355,4,1.9000000000000001,359,11.58,0.53,0.55
12,94,94,355,4,1.9000000000000001,359,11.58,0.53,0.55
12,94,94,355,4,1.9000000000000001,359,11.58,0.53,0.55
12,94,94,355,4,1.9000000000000001,359,11.58,0.53,0.55
12,94,94,355,4,1.9000000000000001,359,11.58,0.53,0.55
2,241,34,385,7,3.65,392,17.1,0.52,0.54
2,241,34,385,7,3.65,392,17.1,0.52,0.54
2,241,34,385,7,3.65,392,17.1,0.52,0.54
2,241,34,385,7,3.65,392,17.1,0.52,0.54
2,241,34,385,7,3.65,392,17.1,0.52,0.54
2,241,34,385,7,3.65,392,17.1,0.52,0.54
11,36,3,419,10,5.11,429,22.1,0.51,0.53
11,36,3,419,10,5.11,429,22.1,0.51,0.53
11,36,3,419,10,5.11,429,22.1,0.51,0.53
11,36,3,419,10,5.11,429,22.1,0.51,0.53
11,36,3,419,10,5.11,429,22.1,0.51,0.53
11,36,3,419,10,5.11,429,22.1,0.51,0.53
2,46,34,433,14,7.21,447,29.04,0.49,0.53
2,46,34,433,14,7.21,447,29.04,0.49,0.53
2,46,34,433,14,7.21,447,29.04,0.49,0.53
2,46,34,433,14,7.21,447,29.04,0.49,0.53
2,46,34,433,14,7.21,447,29.04,0.49,0.53
2,46,34,433,14,7.21,447,29.04,0.49,0.53
15,153,99,420,18,9.06,438,35.53,0.47000000000000003,0.52
15,153,99,420,18,9.06,438,35.53,0.47000000000000003,0.52
15,153,99,420,18,9.06,438,35.53,0.47000000000000003,0.52
15,153,99,420,18,9.06,438,35.53,0.47000000000000003,0.52
15,153,99,420,18,9.06,438,35.53,0.47000000000000003,0.52
15,153,99,420,18,9.06,438,35.53,0.47000000000000003,0.52
2,45,34,455,18,8.79,473,35.04,0.47000000000000003,0.52
2,45,34,455,18,8.79,473,35.04,0.47000000000000003,0.52
2,45,34,455,18,8.79,473,35.04,0.47000000000000003,0.52
2,45,34,455,18,8.79,473,35.04,0.47000000000000003,0.52
2,45,34,455,18,8.79,473,35.04,0.47000000000000003,0.52
2,45,34,455,18,8.79,473,35.04,0.47000000000000003,0.52
10,99,65,476,12,5.92,488,25.14,0.5,0.53
10,99,65,476,12,5.92,488,25.14,0.5,0.53
10,99,65,476,12,5.92,488,25.14,0.5,0.53
10,99,65,476,12,5.92,488,25.14,0.5,0.53
10,99,65,476,12,5.92,488,25.14,0.5,0.53
10,99,65,476,12,5.92,488,25.14,0.5,0.53
10,944,65,491,6,3.07,497,15.27,0.52,0.54
10,944,65,491,6,3.07,497,15.27,0.52,0.54
10,944,65,491,6,3.07,497,15.27,0.52,0.54
10,944,65,491,6,3.07,497,15.27,0.52,0.54
10,944,65,491,6,3.07,497,15.27,0.52,0.54
10,944,65,491,6,3.07,497,15.27,0.52,0.54
11,920,3,508,4,1.86,512,11.5,0.53,0.55
11,920,3,508,4,1.86,512,11.5,0.53,0.55
11,920,3,508,4,1.86,512,11.5,0.53,0.55
11,920,3,508,4,1.86,512,11.5,0.53,0.55
11,920,3,508,4,1.86,512,11.5,0.53,0.55
11,920,3,508,4,1.86,512,11.5,0.53,0.55
15,109,99,487,21,10.58,508,40.64,0.46,0.51
15,109,99,487,21,10.58,508,40.64,0.46,0.51
15,109,99,487,21,10.58,508,40.64,0.46,0.51
15,109,99,487,21,10.58,508,40.64,0.46,0.51
15,109,99,487,21,10.58,508,40.64,0.46,0.51
15,109,99,487,21,10.58,508,40.64,0.46,0.51
2,989,34,515,17,8.73,532,34.15,0.48,0.52
2,989,34,515,17,8.73,532,34.15,0.48,0.52
2,989,34,515,17,8.73,532,34.15,0.48,0.52
2,989,34,515,17,8.73,532,34.15,0.48,0.52
2,989,34,515,17,8.73,532,34.15,0.48,0.52
2,989,34,515,17,8.73,532,34.15,0.48,0.52
3,233,69,526,17,8.72,543,34.12,0.48,0.52
3,233,69,526,17,8.72,543,34.12,0.48,0.52
3,233,69,526,17,8.72,543,34.12,0.48,0.52
3,233,69,526,17,8.72,543,34.12,0.48,0.52
3,233,69,526,17,8.72,543,34.12,0.48,0.52
3,233,69,526,17,8.72,543,34.12,0.48,0.52
10,240,65,529,6,3.11,535,15.34,0.52,0.54
10,240,65,529,6,3.11,535,15.34,0.52,0.54
10,240,65,529,6,3.11,535,15.34,0.52,0.54
10,240,65,529,6,3.11,535,15.34,0.52,0.54
10,240,65,529,6,3.11,535,15.34,0.52,0.54
10,240,65,529,6,3.11,535,15.34,0.52,0.54
11,172,3,523,14,6.8,537,28.3,0.49,0.53
11,172,3,523,14,6.8,537,28.3,0.49,0.53
11,172,3,523,14,6.8,537,28.3,0.49,0.53
11,172,3,523,14,6.8,537,28.3,0.49,0.53
11,172,3,523,14,6.8,537,28.3,0.49,0.53
11,172,3,523,14,6.8,537,28.3,0.49,0.53
12,239,94,516,3,1.57,519,10.2,0.54,0.55
12,239,94,516,3,1.57,519,10.2,0.54,0.55
12,239,94,516,3,1.57,519,10.2,0.54,0.55
12,239,94,516,3,1.57,519,10.2,0.54,0.55
12,239,94,516,3,1.57,519,10.2,0.54,0.55
12,239,94,516,3,1.57,519,10.2,0.54,0.55
1,157,95,541,11,5.58,552,23.73,0.5,0.53
1,157,95,541,11,5.58,552,23.73,0.5,0.53
1,157,95,541,11,5.58,552,23.73,0.5,0.53
1,157,95,541,11,5.58,552,23.73,0.5,0.53
1,157,95,541,11,5.58,552,23.73,0.5,0.53
1,157,95,541,11,5.58,552,23.73,0.5,0.53
10,987,65,567,9,4.69,576,20.56,0.51,0.54
10,987,65,567,9,4.69,576,20.56,0.51,0.54
10,987,65,567,9,4.69,576,20.56,0.51,0.54
10,987,65,567,9,4.69,576,20.56,0.51,0.54
10,987,65,567,9,4.69,576,20.56,0.51,0.54
10,987,65,567,9,4.69,576,20.56,0.51,0.54
3,825,69,579,11,5.27,590,23.17,0.5,0.53
3,825,69,579,11,5.27,590,23.17,0.5,0.53
3,825,69,579,11,5.27,590,23.17,0.5,0.53
3,825,69,579,11,5.27,590,23.17,0.5,0.53
3,825,69,579,11,5.27,590,23.17,0.5,0.53
3,825,69,579,11,5.27,590,23.17,0.5,0.53
15,988,99,584,9,4.43,593,20.09,0.51,0.54
15,988,99,584,9,4.43,593,20.09,0.51,0.54
15,988,99,584,9,4.43,593,20.09,0.51,0.54
15,988,99,584,9,4.43,593,20.09,0.51,0.54
15,988,99,584,9,4.43,593,20.09,0.51,0.54
15,988,99,584,9,4.43,593,20.09,0.51,0.54
1,850,95,604,7,3.75,611,17.28,0.52,0.54
1,850,95,604,7,3.75,611,17.28,0.52,0.54
1,850,95,604,7,3.75,611,17.28,0.52,0.54
1,850,95,604,7,3.75,611,17.28,0.52,0.54
1,850,95,604,7,3.75,611,17.28,0.52,0.54
1,850,95,604,7,3.75,611,17.28,0.52,0.54
15,987,99,600,10,5.08,610,22.04,0.51,0.53
15,987,99,600,10,5.08,610,22.04,0.51,0.53
15,987,99,600,10,5.08,610,22.04,0.51,0.53
15,987,99,600,10,5.08,610,22.04,0.51,0.53
15,987,99,600,10,5.08,610,22.04,0.51,0.53
15,987,99,600,10,5.08,610,22.04,0.51,0.53
5,890,16,741,7,3.35,748,16.56,0.52,0.54
5,890,16,741,7,3.35,748,16.56,0.52,0.54
5,890,16,741,7,3.35,748,16.56,0.52,0.54
5,890,16,741,7,3.35,748,16.56,0.52,0.54
5,890,16,741,7,3.35,748,16.56,0.52,0.54
5,890,16,741,7,3.35,748,16.56,0.52,0.54
5,460,76,1035,12,6.07,1047,25.41,0.5,0.53
5,460,76,1035,12,6.07,1047,25.41,0.5,0.53
5,460,76,1035,12,6.07,1047,25.41,0.5,0.53
5,460,76,1035,12,6.07,1047,25.41,0.5,0.53
5,460,76,1035,12,6.07,1047,25.41,0.5,0.53
5,460,76,1035,12,6.07,1047,25.41,0.5,0.53
8,442,66,1020,19,9.57,1039,37.24,0.47000000000000003,0.52
8,442,66,1020,19,9.57,1039,37.24,0.47000000000000003,0.52
8,442,66,1020,19,9.57,1039,37.24,0.47000000000000003,0.52
8,442,66,1020,19,9.57,1039,37.24,0.47000000000000003,0.52
8,442,66,1020,19,9.57,1039,37.24,0.47000000000000003,0.52
8,442,66,1020,19,9.57,1039,37.24,0.47000000000000003,0.52
5,436,76,1075,12,5.87,1087,25.05,0.5,0.53
5,436,76,1075,12,5.87,1087,25.05,0.5,0.53
5,436,76,1075,12,5.87,1087,25.05,0.5,0.53
5,436,76,1075,12,5.87,1087,25.05,0.5,0.53
5,436,76,1075,12,5.87,1087,25.05,0.5,0.53
5,436,76,1075,12,5.87,1087,25.05,0.5,0.53
8,357,66,1085,8,4.17,1093,18.82,0.52,0.54
8,357,66,1085,8,4.17,1093,18.82,0.52,0.54
8,357,66,1085,8,4.17,1093,18.82,0.52,0.54
8,357,66,1085,8,4.17,1093,18.82,0.52,0.54
8,357,66,1085,8,4.17,1093,18.82,0.52,0.54
8,357,66,1085,8,4.17,1093,18.82,0.52,0.54
9,401,77,1087,10,5.12,1097,22.13,0.51,0.53
9,401,77,1087,10,5.12,1097,22.13,0.51,0.53
9,401,77,1087,10,5.12,1097,22.13,0.51,0.53
9,401,77,1087,10,5.12,1097,22.13,0.51,0.53
9,401,77,1087,10,5.12,1097,22.13,0.51,0.53
9,401,77,1087,10,5.12,1097,22.13,0.51,0.53
8,477,66,1120,4,2.13,1124,12.0,0.53,0.55
8,477,66,1120,4,2.13,1124,12.0,0.53,0.55
8,477,66,1120,4,2.13,1124,12.0,0.53,0.55
8,477,66,1120,4,2.13,1124,12.0,0.53,0.55
8,477,66,1120,4,2.13,1124,12.0,0.53,0.55
8,477,66,1120,4,2.13,1124,12.0,0.53,0.55
9,401,77,1123,15,7.59,1138,30.51,0.49,0.52
9,401,77,1123,15,7.59,1138,30.51,0.49,0.52
9,401,77,1123,15,7.59,1138,30.51,0.49,0.52
9,401,77,1123,15,7.59,1138,30.51,0.49,0.52
9,401,77,1123,15,7.59,1138,30.51,0.49,0.52
9,401,77,1123,15,7.59,1138,30.51,0.49,0.52
1,965,12,1267,10,5.02,1277,21.93,0.51,0.54
1,965,12,1267,10,5.02,1277,21.93,0.51,0.54
1,965,12,1267,10,5.02,1277,21.93,0.51,0.54
1,965,12,1267,10,5.02,1277,21.93,0.51,0.54
1,965,12,1267,10,5.02,1277,21.93,0.51,0.54
1,965,12,1267,10,5.02,1277,21.93,0.51,0.54
12,736,54,1272,9,4.74,1281,20.65,0.51,0.54
12,736,54,1272,9,4.74,1281,20.65,0.51,0.54
12,736,54,1272,9,4.74,1281,20.65,0.51,0.54
12,736,54,1272,9,4.74,1281,20.65,0.51,0.54
12,736,54,1272,9,4.74,1281,20.65,0.51,0.54
12,736,54,1272,9,4.74,1281,20.65,0.51,0.54
3,742,1,1292,9,4.37,1301,19.98,0.51,0.54
3,742,1,1292,9,4.37,1301,19.98,0.51,0.54
3,742,1,1292,9,4.37,1301,19.98,0.51,0.54
3,742,1,1292,9,4.37,1301,19.98,0.51,0.54
3,742,1,1292,9,4.37,1301,19.98,0.51,0.54
3,742,1,1292,9,4.37,1301,19.98,0.51,0.54
12,584,54,1297,6,2.92,1303,14.99,0.52,0.54
12,584,54,1297,6,2.92,1303,14.99,0.52,0.54
12,584,54,1297,6,2.92,1303,14.99,0.52,0.54
12,584,54,1297,6,2.92,1303,14.99,0.52,0.54
12,584,54,1297,6,2.92,1303,14.99,0.52,0.54
12,584,54,1297,6,2.92,1303,14.99,0.52,0.54
14,540,35,1307,8,4.06,1315,18.63,0.52,0.54
14,540,35,1307,8,4.06,1315,18.63,0.52,0.54
14,540,35,1307,8,4.06,1315,18.63,0.52,0.54
14,540,35,1307,8,4.06,1315,18.63,0.52,0.54
14,540,35,1307,8,4.06,1315,18.63,0.52,0.54
14,540,35,1307,8,4.06,1315,18.63,0.52,0.54
1,569,12,1369,2,0.8300000000000001,1371,8.07,0.54,0.55
1,569,12,1369,2,0.8300000000000001,1371,8.07,0.54,0.55
1,569,12,1369,2,0.8300000000000001,1371,8.07,0.54,0.55
1,569,12,1369,2,0.8300000000000001,1371,8.07,0.54,0.55
1,569,12,1369,2,0.8300000000000001,1371,8.07,0.54,0.55
1,569,12,1369,2,0.8300000000000001,1371,8.07,0.54,0.55
1,628,12,1408,5,2.54,1413,13.52,0.53,0.55
1,628,12,1408,5,2.54,1413,13.52,0.53,0.55
1,628,12,1408,5,2.54,1413,13.52,0.53,0.55
1,628,12,1408,5,2.54,1413,13.52,0.53,0.55
1,628,12,1408,5,2.54,1413,13.52,0.53,0.55
1,628,12,1408,5,2.54,1413,13.52,0.53,0.55
9,719,48,1386,12,5.97,1398,25.22,0.5,0.53
9,719,48,1386,12,5.97,1398,25.22,0.5,0.53
9,719,48,1386,12,5.97,1398,25.22,0.5,0.53
9,719,48,1386,12,5.97,1398,25.22,0.5,0.53
9,719,48,1386,12,5.97,1398,25.22,0.5,0.53
9,719,48,1386,12,5.97,1398,25.22,0.5,0.53
1,892,12,1429,11,5.3,1440,23.23,0.5,0.53
1,892,12,1429,11,5.3,1440,23.23,0.5,0.53
1,892,12,1429,11,5.3,1440,23.23,0.5,0.53
1,892,12,1429,11,5.3,1440,23.23,0.5,0.53
1,892,12,1429,11,5.3,1440,23.23,0.5,0.53
1,892,12,1429,11,5.3,1440,23.23,0.5,0.53
4,733,55,1429,10,4.77,1439,21.48,0.51,0.54
4,733,55,1429,10,4.77,1439,21.48,0.51,0.54
4,733,55,1429,10,4.77,1439,21.48,0.51,0.54
4,733,55,1429,10,4.77,1439,21.48,0.51,0.54
4,733,55,1429,10,4.77,1439,21.48,0.51,0.54
4,733,55,1429,10,4.77,1439,21.48,0.51,0.54
0,825,28,117,10,5.07,127,22.02,0.51,0.53
0,825,28,117,10,5.07,127,22.02,0.51,0.53
0,825,28,117,10,5.07,127,22.02,0.51,0.53
0,825,28,117,10,5.07,127,22.02,0.51,0.53
0,825,28,117,10,5.07,127,22.02,0.51,0.53
0,825,28,117,10,5.07,127,22.02,0.51,0.53
0,825,28,117,10,5.07,127,22.02,0.51,0.53
9,765,22,136,3,1.3800000000000001,139,9.86,0.54,0.55
9,765,22,136,3,1.3800000000000001,139,9.86,0.54,0.55
9,765,22,136,3,1.3800000000000001,139,9.86,0.54,0.55
9,765,22,136,3,1.3800000000000001,139,9.86,0.54,0.55
9,765,22,136,3,1.3800000000000001,139,9.86,0.54,0.55
9,765,22,136,3,1.3800000000000001,139,9.86,0.54,0.55
9,765,22,136,3,1.3800000000000001,139,9.86,0.54,0.55
8,992,64,295,9,4.5,304,20.22,0.51,0.54
8,992,64,295,9,4.5,304,20.22,0.51,0.54
8,992,64,295,9,4.5,304,20.22,0.51,0.54
8,992,64,295,9,4.5,304,20.22,0.51,0.54
8,992,64,295,9,4.5,304,20.22,0.51,0.54
8,992,64,295,9,4.5,304,20.22,0.51,0.54
8,992,64,295,9,4.5,304,20.22,0.51,0.54
8,157,64,315,3,1.62,318,10.29,0.54,0.55
8,157,64,315,3,1.62,318,10.29,0.54,0.55
8,157,64,315,3,1.62,318,10.29,0.54,0.55
8,157,64,315,3,1.62,318,10.29,0.54,0.55
8,157,64,315,3,1.62,318,10.29,0.54,0.55
8,157,64,315,3,1.62,318,10.29,0.54,0.55
8,157,64,315,3,1.62,318,10.29,0.54,0.55
8,946,64,332,16,8.1,348,32.22,0.48,0.52
8,946,64,332,16,8.1,348,32.22,0.48,0.52
8,946,64,332,16,8.1,348,32.22,0.48,0.52
8,946,64,332,16,8.1,348,32.22,0.48,0.52
8,946,64,332,16,8.1,348,32.22,0.48,0.52
8,946,64,332,16,8.1,348,32.22,0.48,0.52
8,946,64,332,16,8.1,348,32.22,0.48,0.52
9,45,22,444,17,8.46,461,33.66,0.48,0.52
9,45,22,444,17,8.46,461,33.66,0.48,0.52
9,45,22,444,17,8.46,461,33.66,0.48,0.52
9,45,22,444,17,8.46,461,33.66,0.48,0.52
9,45,22,444,17,8.46,461,33.66,0.48,0.52
9,45,22,444,17,8.46,461,33.66,0.48,0.52
9,45,22,444,17,8.46,461,33.66,0.48,0.52
0,36,28,467,9,4.62,476,20.42,0.51,0.54
0,36,28,467,9,4.62,476,20.42,0.51,0.54
0,36,28,467,9,4.62,476,20.42,0.51,0.54
0,36,28,467,9,4.62,476,20.42,0.51,0.54
0,36,28,467,9,4.62,476,20.42,0.51,0.54
0,36,28,467,9,4.62,476,20.42,0.51,0.54
0,36,28,467,9,4.62,476,20.42,0.51,0.54
2,11,37,461,7,3.39,468,16.63,0.52,0.54
2,11,37,461,7,3.39,468,16.63,0.52,0.54
2,11,37,461,7,3.39,468,16.63,0.52,0.54
2,11,37,461,7,3.39,468,16.63,0.52,0.54
2,11,37,461,7,3.39,468,16.63,0.52,0.54
2,11,37,461,7,3.39,468,16.63,0.52,0.54
2,11,37,461,7,3.39,468,16.63,0.52,0.54
2,56,37,507,15,7.57,522,30.47,0.49,0.52
2,56,37,507,15,7.57,522,30.47,0.49,0.52
2,56,37,507,15,7.57,522,30.47,0.49,0.52
2,56,37,507,15,7.57,522,30.47,0.49,0.52
2,56,37,507,15,7.57,522,30.47,0.49,0.52
2,56,37,507,15,7.57,522,30.47,0.49,0.52
2,56,37,507,15,7.57,522,30.47,0.49,0.52
4,48,21,500,6,2.87,506,14.91,0.53,0.54
4,48,21,500,6,2.87,506,14.91,0.53,0.54
4,48,21,500,6,2.87,506,14.91,0.53,0.54
4,48,21,500,6,2.87,506,14.91,0.53,0.54
4,48,21,500,6,2.87,506,14.91,0.53,0.54
4,48,21,500,6,2.87,506,14.91,0.53,0.54
4,48,21,500,6,2.87,506,14.91,0.53,0.54
9,217,22,497,3,1.43,500,9.95,0.54,0.55
9,217,22,497,3,1.43,500,9.95,0.54,0.55
9,217,22,497,3,1.43,500,9.95,0.54,0.55
9,217,22,497,3,1.43,500,9.95,0.54,0.55
9,217,22,497,3,1.43,500,9.95,0.54,0.55
9,217,22,497,3,1.43,500,9.95,0.54,0.55
9,217,22,497,3,1.43,500,9.95,0.54,0.55
11,194,86,483,14,6.84,497,28.36,0.49,0.53
11,194,86,483,14,6.84,497,28.36,0.49,0.53
11,194,86,483,14,6.84,497,28.36,0.49,0.53
11,194,86,483,14,6.84,497,28.36,0.49,0.53
11,194,86,483,14,6.84,497,28.36,0.49,0.53
11,194,86,483,14,6.84,497,28.36,0.49,0.53
11,194,86,483,14,6.84,497,28.36,0.49,0.53
13,194,38,480,6,3.11,486,15.34,0.52,0.54
13,194,38,480,6,3.11,486,15.34,0.52,0.54
13,194,38,480,6,3.11,486,15.34,0.52,0.54
13,194,38,480,6,3.11,486,15.34,0.52,0.54
13,194,38,480,6,3.11,486,15.34,0.52,0.54
13,194,38,480,6,3.11,486,15.34,0.52,0.54
13,194,38,480,6,3.11,486,15.34,0.52,0.54
15,46,95,500,7,3.46,507,16.75,0.52,0.54
15,46,95,500,7,3.46,507,16.75,0.52,0.54
15,46,95,500,7,3.46,507,16.75,0.52,0.54
15,46,95,500,7,3.46,507,16.75,0.52,0.54
15,46,95,500,7,3.46,507,16.75,0.52,0.54
15,46,95,500,7,3.46,507,16.75,0.52,0.54
15,46,95,500,7,3.46,507,16.75,0.52,0.54
0,226,28,510,9,4.64,519,20.47,0.51,0.54
0,226,28,510,9,4.64,519,20.47,0.51,0.54
0,226,28,510,9,4.64,519,20.47,0.51,0.54
0,226,28,510,9,4.64,519,20.47,0.51,0.54
0,226,28,510,9,4.64,519,20.47,0.51,0.54
0,226,28,510,9,4.64,519,20.47,0.51,0.54
0,226,28,510,9,4.64,519,20.47,0.51,0.54
2,73,37,517,3,1.36,520,9.82,0.54,0.55
2,73,37,517,3,1.36,520,9.82,0.54,0.55
2,73,37,517,3,1.36,520,9.82,0.54,0.55
2,73,37,517,3,1.36,520,9.82,0.54,0.55
2,73,37,517,3,1.36,520,9.82,0.54,0.55
2,73,37,517,3,1.36,520,9.82,0.54,0.55
2,73,37,517,3,1.36,520,9.82,0.54,0.55
6,186,50,521,8,3.85,529,18.24,0.52,0.54
6,186,50,521,8,3.85,529,18.24,0.52,0.54
6,186,50,521,8,3.85,529,18.24,0.52,0.54
6,186,50,521,8,3.85,529,18.24,0.52,0.54
6,186,50,521,8,3.85,529,18.24,0.52,0.54
6,186,50,521,8,3.85,529,18.24,0.52,0.54
6,186,50,521,8,3.85,529,18.24,0.52,0.54
9,907,22,522,7,3.44,529,16.72,0.52,0.54
9,907,22,522,7,3.44,529,16.72,0.52,0.54
9,907,22,522,7,3.44,529,16.72,0.52,0.54
9,907,22,522,7,3.44,529,16.72,0.52,0.54
9,907,22,522,7,3.44,529,16.72,0.52,0.54
9,907,22,522,7,3.44,529,16.72,0.52,0.54
9,907,22,522,7,3.44,529,16.72,0.52,0.54
13,2,38,523,9,4.57,532,20.34,0.51,0.54
13,2,38,523,9,4.57,532,20.34,0.51,0.54
13,2,38,523,9,4.57,532,20.34,0.51,0.54
13,2,38,523,9,4.57,532,20.34,0.51,0.54
13,2,38,523,9,4.57,532,20.34,0.51,0.54
13,2,38,523,9,4.57,532,20.34,0.51,0.54
13,2,38,523,9,4.57,532,20.34,0.51,0.54
15,708,95,524,4,1.93,528,11.63,0.53,0.55
15,708,95,524,4,1.93,528,11.63,0.53,0.55
15,708,95,524,4,1.93,528,11.63,0.53,0.55
15,708,95,524,4,1.93,528,11.63,0.53,0.55
15,708,95,524,4,1.93,528,11.63,0.53,0.55
15,708,95,524,4,1.93,528,11.63,0.53,0.55
15,708,95,524,4,1.93,528,11.63,0.53,0.55
4,240,21,558,17,8.62,575,33.96,0.48,0.52
4,240,21,558,17,8.62,575,33.96,0.48,0.52
4,240,21,558,17,8.62,575,33.96,0.48,0.52
4,240,21,558,17,8.62,575,33.96,0.48,0.52
4,240,21,558,17,8.62,575,33.96,0.48,0.52
4,240,21,558,17,8.62,575,33.96,0.48,0.52
4,240,21,558,17,8.62,575,33.96,0.48,0.52
6,153,50,549,4,1.93,553,11.63,0.53,0.55
6,153,50,549,4,1.93,553,11.63,0.53,0.55
6,153,50,549,4,1.93,553,11.63,0.53,0.55
6,153,50,549,4,1.93,553,11.63,0.53,0.55
6,153,50,549,4,1.93,553,11.63,0.53,0.55
6,153,50,549,4,1.93,553,11.63,0.53,0.55
6,153,50,549,4,1.93,553,11.63,0.53,0.55
11,240,86,564,7,3.53,571,16.88,0.52,0.54
11,240,86,564,7,3.53,571,16.88,0.52,0.54
11,240,86,564,7,3.53,571,16.88,0.52,0.54
11,240,86,564,7,3.53,571,16.88,0.52,0.54
11,240,86,564,7,3.53,571,16.88,0.52,0.54
11,240,86,564,7,3.53,571,16.88,0.52,0.54
11,240,86,564,7,3.53,571,16.88,0.52,0.54
4,909,21,589,12,5.86,601,25.02,0.5,0.53
4,909,21,589,12,5.86,601,25.02,0.5,0.53
4,909,21,589,12,5.86,601,25.02,0.5,0.53
4,909,21,589,12,5.86,601,25.02,0.5,0.53
4,909,21,589,12,5.86,601,25.02,0.5,0.53
4,909,21,589,12,5.86,601,25.02,0.5,0.53
4,909,21,589,12,5.86,601,25.02,0.5,0.53
6,222,50,596,10,4.91,606,21.73,0.51,0.54
6,222,50,596,10,4.91,606,21.73,0.51,0.54
6,222,50,596,10,4.91,606,21.73,0.51,0.54
6,222,50,596,10,4.91,606,21.73,0.51,0.54
6,222,50,596,10,4.91,606,21.73,0.51,0.54
6,222,50,596,10,4.91,606,21.73,0.51,0.54
6,222,50,596,10,4.91,606,21.73,0.51,0.54
13,945,38,712,16,7.91,728,31.88,0.48,0.52
13,945,38,712,16,7.91,728,31.88,0.48,0.52
13,945,38,712,16,7.91,728,31.88,0.48,0.52
13,945,38,712,16,7.91,728,31.88,0.48,0.52
13,945,38,712,16,7.91,728,31.88,0.48,0.52
13,945,38,712,16,7.91,728,31.88,0.48,0.52
13,945,38,712,16,7.91,728,31.88,0.48,0.52
4,826,21,819,13,6.39,832,26.77,0.5,0.53
4,826,21,819,13,6.39,832,26.77,0.5,0.53
4,826,21,819,13,6.39,832,26.77,0.5,0.53
4,826,21,819,13,6.39,832,26.77,0.5,0.53
4,826,21,819,13,6.39,832,26.77,0.5,0.53
4,826,21,819,13,6.39,832,26.77,0.5,0.53
4,826,21,819,13,6.39,832,26.77,0.5,0.53
13,860,38,881,3,1.48,884,10.03,0.54,0.55
13,860,38,881,3,1.48,884,10.03,0.54,0.55
13,860,38,881,3,1.48,884,10.03,0.54,0.55
13,860,38,881,3,1.48,884,10.03,0.54,0.55
13,860,38,881,3,1.48,884,10.03,0.54,0.55
13,860,38,881,3,1.48,884,10.03,0.54,0.55
13,860,38,881,3,1.48,884,10.03,0.54,0.55
5,871,14,920,14,7.19,934,29.0,0.49,0.53
5,871,14,920,14,7.19,934,29.0,0.49,0.53
5,871,14,920,14,7.19,934,29.0,0.49,0.53
5,871,14,920,14,7.19,934,29.0,0.49,0.53
5,871,14,920,14,7.19,934,29.0,0.49,0.53
5,871,14,920,14,7.19,934,29.0,0.49,0.53
5,871,14,920,14,7.19,934,29.0,0.49,0.53
5,862,14,933,15,7.69,948,30.69,0.49,0.52
5,862,14,933,15,7.69,948,30.69,0.49,0.52
5,862,14,933,15,7.69,948,30.69,0.49,0.52
5,862,14,933,15,7.69,948,30.69,0.49,0.52
5,862,14,933,15,7.69,948,30.69,0.49,0.52
5,862,14,933,15,7.69,948,30.69,0.49,0.52
5,862,14,933,15,7.69,948,30.69,0.49,0.52
13,926,38,956,12,6.18,968,25.61,0.5,0.53
13,926,38,956,12,6.18,968,25.61,0.5,0.53
13,926,38,956,12,6.18,968,25.61,0.5,0.53
13,926,38,956,12,6.18,968,25.61,0.5,0.53
13,926,38,956,12,6.18,968,25.61,0.5,0.53
13,926,38,956,12,6.18,968,25.61,0.5,0.53
13,926,38,956,12,6.18,968,25.61,0.5,0.53
13,977,38,1010,13,6.74,1023,27.41,0.49,0.53
13,977,38,1010,13,6.74,1023,27.41,0.49,0.53
13,977,38,1010,13,6.74,1023,27.41,0.49,0.53
13,977,38,1010,13,6.74,1023,27.41,0.49,0.53
13,977,38,1010,13,6.74,1023,27.41,0.49,0.53
13,977,38,1010,13,6.74,1023,27.41,0.49,0.53
13,977,38,1010,13,6.74,1023,27.41,0.49,0.53
0,318,28,1043,17,8.74,1060,34.17,0.48,0.52
0,318,28,1043,17,8.74,1060,34.17,0.48,0.52
0,318,28,1043,17,8.74,1060,34.17,0.48,0.52
0,318,28,1043,17,8.74,1060,34.17,0.48,0.52
0,318,28,1043,17,8.74,1060,34.17,0.48,0.52
0,318,28,1043,17,8.74,1060,34.17,0.48,0.52
0,318,28,1043,17,8.74,1060,34.17,0.48,0.52
13,352,38,1045,12,6.1,1057,25.47,0.5,0.53
13,352,38,1045,12,6.1,1057,25.47,0.5,0.53
13,352,38,1045,12,6.1,1057,25.47,0.5,0.53
13,352,38,1045,12,6.1,1057,25.47,0.5,0.53
13,352,38,1045,12,6.1,1057,25.47,0.5,0.53
13,352,38,1045,12,6.1,1057,25.47,0.5,0.53
13,352,38,1045,12,6.1,1057,25.47,0.5,0.53
5,371,14,1073,7,3.43,1080,16.69,0.52,0.54
5,371,14,1073,7,3.43,1080,16.69,0.52,0.54
5,371,14,1073,7,3.43,1080,16.69,0.52,0.54
5,371,14,1073,7,3.43,1080,16.69,0.52,0.54
5,371,14,1073,7,3.43,1080,16.69,0.52,0.54
5,371,14,1073,7,3.43,1080,16.69,0.52,0.54
5,371,14,1073,7,3.43,1080,16.69,0.52,0.54
13,281,38,1065,21,10.42,1086,40.34,0.46,0.51
13,281,38,1065,21,10.42,1086,40.34,0.46,0.51
13,281,38,1065,21,10.42,1086,40.34,0.46,0.51
13,281,38,1065,21,10.42,1086,40.34,0.46,0.51
13,281,38,1065,21,10.42,1086,40.34,0.46,0.51
13,281,38,1065,21,10.42,1086,40.34,0.46,0.51
13,281,38,1065,21,10.42,1086,40.34,0.46,0.51
13,915,38,1136,16,8.0,1152,32.05,0.48,0.52
13,915,38,1136,16,8.0,1152,32.05,0.48,0.52
13,915,38,1136,16,8.0,1152,32.05,0.48,0.52
13,915,38,1136,16,8.0,1152,32.05,0.48,0.52
13,915,38,1136,16,8.0,1152,32.05,0.48,0.52
13,915,38,1136,16,8.0,1152,32.05,0.48,0.52
13,915,38,1136,16,8.0,1152,32.05,0.48,0.52
11,364,70,1144,7,3.5,1151,16.84,0.52,0.54
11,364,70,1144,7,3.5,1151,16.84,0.52,0.54
11,364,70,1144,7,3.5,1151,16.84,0.52,0.54
11,364,70,1144,7,3.5,1151,16.84,0.52,0.54
11,364,70,1144,7,3.5,1151,16.84,0.52,0.54
11,364,70,1144,7,3.5,1151,16.84,0.52,0.54
11,364,70,1144,7,3.5,1151,16.84,0.52,0.54
10,952,10,1204,4,1.92,1208,11.61,0.53,0.55
10,952,10,1204,4,1.92,1208,11.61,0.53,0.55
10,952,10,1204,4,1.92,1208,11.61,0.53,0.55
10,952,10,1204,4,1.92,1208,11.61,0.53,0.55
10,952,10,1204,4,1.92,1208,11.61,0.53,0.55
10,952,10,1204,4,1.92,1208,11.61,0.53,0.55
10,952,10,1204,4,1.92,1208,11.61,0.53,0.55
11,759,70,1210,5,2.64,1215,13.7,0.53,0.55
11,759,70,1210,5,2.64,1215,13.7,0.53,0.55
11,759,70,1210,5,2.64,1215,13.7,0.53,0.55
11,759,70,1210,5,2.64,1215,13.7,0.53,0.55
11,759,70,1210,5,2.64,1215,13.7,0.53,0.55
11,759,70,1210,5,2.64,1215,13.7,0.53,0.55
11,759,70,1210,5,2.64,1215,13.7,0.53,0.55
10,584,10,1248,16,8.16,1264,32.33,0.48,0.52
10,584,10,1248,16,8.16,1264,32.33,0.48,0.52
10,584,10,1248,16,8.16,1264,32.33,0.48,0.52
10,584,10,1248,16,8.16,1264,32.33,0.48,0.52
10,584,10,1248,16,8.16,1264,32.33,0.48,0.52
10,584,10,1248,16,8.16,1264,32.33,0.48,0.52
10,584,10,1248,16,8.16,1264,32.33,0.48,0.52
11,730,70,1260,16,7.79,1276,31.66,0.48,0.52
11,730,70,1260,16,7.79,1276,31.66,0.48,0.52
11,730,70,1260,16,7.79,1276,31.66,0.48,0.52
11,730,70,1260,16,7.79,1276,31.66,0.48,0.52
11,730,70,1260,16,7.79,1276,31.66,0.48,0.52
11,730,70,1260,16,7.79,1276,31.66,0.48,0.52
11,730,70,1260,16,7.79,1276,31.66,0.48,0.52
11,629,70,1359,14,6.87,1373,28.42,0.49,0.53
11,629,70,1359,14,6.87,1373,28.42,0.49,0.53
11,629,70,1359,14,6.87,1373,28.42,0.49,0.53
11,629,70,1359,14,6.87,1373,28.42,0.49,0.53
11,629,70,1359,14,6.87,1373,28.42,0.49,0.53
11,629,70,1359,14,6.87,1373,28.42,0.49,0.53
11,629,70,1359,14,6.87,1373,28.42,0.49,0.53
11,567,70,1435,22,11.25,1457,42.63,0.46,0.51
11,567,70,1435,22,11.25,1457,42.63,0.46,0.51
11,567,70,1435,22,11.25,1457,42.63,0.46,0.51
11,567,70,1435,22,11.25,1457,42.63,0.46,0.51
11,567,70,1435,22,11.25,1457,42.63,0.46,0.51
11,567,70,1435,22,11.25,1457,42.63,0.46,0.51
11,567,70,1435,22,11.25,1457,42.63,0.46,0.51
