square_index,rider_id,driver_idx,trip_start_timestamp,trip_duration,ride_miles,trip_end_timestamp,price_of_ride,rider_acceptance_prob,driver_acceptance_prob
8,937,48,68,19,9.33,87,36.81,0.47000000000000003,0.52
14,956,33,271,13,6.68,284,27.31,0.49,0.53
15,773,51,296,20,9.93,316,38.68,0.47000000000000003,0.51
12,851,92,318,5,2.25,323,13.0,0.53,0.55
2,216,91,384,4,2.24,388,12.2,0.53,0.55
7,105,95,388,15,7.55,403,30.45,0.49,0.52
1,524,27,417,1,0.59,418,6.85,0.55,0.55
15,48,51,399,11,5.55,410,23.68,0.5,0.53
0,63,89,437,16,7.9,453,31.85,0.48,0.52
2,152,91,438,3,1.44,441,9.97,0.54,0.55
12,135,92,446,12,5.89,458,25.08,0.5,0.53
13,157,53,440,2,0.93,442,8.25,0.54,0.55
15,32,51,447,10,5.13,457,22.13,0.51,0.53
1,175,27,476,12,6.18,488,25.61,0.5,0.53
2,111,91,453,12,5.92,465,25.14,0.5,0.53
7,217,95,456,13,6.34,469,26.69,0.5,0.53
12,68,92,462,17,8.55,479,33.82,0.48,0.52
15,178,51,465,13,6.38,478,26.74,0.5,0.53
11,142,8,508,7,3.32,515,16.51,0.52,0.54
13,8,53,498,6,3.1,504,15.32,0.52,0.54
15,101,51,484,4,2.24,488,12.19,0.53,0.55
3,157,46,510,14,7.03,524,28.71,0.49,0.53
9,63,6,521,6,3.13,527,15.37,0.52,0.54
11,17,8,516,6,2.82,522,14.81,0.53,0.54
15,175,51,514,10,5.21,524,22.29,0.51,0.53
0,139,89,569,13,6.59,582,27.13,0.49,0.53
12,31,92,562,13,6.49,575,26.95,0.5,0.53
10,852,31,669,5,2.71,674,13.83,0.53,0.55
13,975,53,771,15,7.45,786,30.26,0.49,0.52
3,296,7,1104,8,3.85,1112,18.24,0.52,0.54
4,644,10,1260,10,5.17,1270,22.2,0.51,0.53
12,713,5,1318,18,9.17,1336,35.72,0.47000000000000003,0.52
4,742,10,1334,12,6.05,1346,25.37,0.5,0.53
11,538,93,1332,10,4.99,1342,21.89,0.51,0.54
12,546,5,1348,22,10.9,1370,41.99,0.46,0.51
4,723,10,1358,13,6.69,1371,27.32,0.49,0.53
11,507,93,1367,6,3.03,1373,15.2,0.52,0.54
14,651,4,1369,15,7.27,1384,29.93,0.49,0.53
14,556,4,1390,18,8.8,1408,35.05,0.47000000000000003,0.52
4,249,67,353,15,7.62,368,30.56,0.49,0.52
4,249,67,353,15,7.62,368,30.56,0.49,0.52
12,758,50,331,13,6.49,344,26.95,0.5,0.53
12,758,50,331,13,6.49,344,26.95,0.5,0.53
15,939,47,359,3,1.54,362,10.14,0.54,0.55
15,939,47,359,3,1.54,362,10.14,0.54,0.55
2,941,89,365,19,9.31,384,36.77,0.47000000000000003,0.52
2,941,89,365,19,9.31,384,36.77,0.47000000000000003,0.52
12,995,50,413,4,2.06,417,11.87,0.53,0.55
12,995,50,413,4,2.06,417,11.87,0.53,0.55
13,101,25,408,12,6.15,420,25.54,0.5,0.53
13,101,25,408,12,6.15,420,25.54,0.5,0.53
2,573,89,432,6,3.14,438,15.39,0.52,0.54
2,573,89,432,6,3.14,438,15.39,0.52,0.54
3,158,15,430,1,0.73,431,7.1,0.54,0.55
3,158,15,430,1,0.73,431,7.1,0.54,0.55
12,60,50,422,18,9.21,440,35.79,0.47000000000000003,0.52
12,60,50,422,18,9.21,440,35.79,0.47000000000000003,0.52
14,189,72,431,14,6.85,445,28.38,0.49,0.53
14,189,72,431,14,6.85,445,28.38,0.49,0.53
2,66,89,475,12,6.17,487,25.59,0.5,0.53
2,66,89,475,12,6.17,487,25.59,0.5,0.53
3,975,15,465,16,7.9,481,31.86,0.48,0.52
3,975,15,465,16,7.9,481,31.86,0.48,0.52
5,82,62,479,9,4.32,488,19.89,0.51,0.54
5,82,62,479,9,4.32,488,19.89,0.51,0.54
10,48,18,453,3,1.3800000000000001,456,9.85,0.54,0.55
10,48,18,453,3,1.3800000000000001,456,9.85,0.54,0.55
15,90,47,450,3,1.67,453,10.38,0.54,0.55
15,90,47,450,3,1.67,453,10.38,0.54,0.55
0,191,44,498,8,4.01,506,18.54,0.52,0.54
0,191,44,498,8,4.01,506,18.54,0.52,0.54
1,41,49,492,15,7.62,507,30.57,0.49,0.52
1,41,49,492,15,7.62,507,30.57,0.49,0.52
2,63,89,492,13,6.47,505,26.92,0.5,0.53
2,63,89,492,13,6.47,505,26.92,0.5,0.53
9,662,26,494,12,5.95,506,25.18,0.5,0.53
9,662,26,494,12,5.95,506,25.18,0.5,0.53
12,4,50,488,6,2.99,494,15.12,0.52,0.54
12,4,50,488,6,2.99,494,15.12,0.52,0.54
15,183,47,501,18,8.86,519,35.17,0.47000000000000003,0.52
15,183,47,501,18,8.86,519,35.17,0.47000000000000003,0.52
0,155,44,528,12,6.05,540,25.38,0.5,0.53
0,155,44,528,12,6.05,540,25.38,0.5,0.53
4,192,67,529,10,5.12,539,22.12,0.51,0.53
4,192,67,529,10,5.12,539,22.12,0.51,0.53
9,144,26,538,14,6.8,552,28.3,0.49,0.53
9,144,26,538,14,6.8,552,28.3,0.49,0.53
10,32,18,512,11,5.29,523,23.21,0.5,0.53
10,32,18,512,11,5.29,523,23.21,0.5,0.53
12,190,50,524,16,7.83,540,31.74,0.48,0.52
12,190,50,524,16,7.83,540,31.74,0.48,0.52
15,89,47,535,8,3.93,543,18.38,0.52,0.54
15,89,47,535,8,3.93,543,18.38,0.52,0.54
0,18,44,545,18,9.02,563,35.46,0.47000000000000003,0.52
0,18,44,545,18,9.02,563,35.46,0.47000000000000003,0.52
8,10,48,553,12,5.97,565,25.23,0.5,0.53
8,10,48,553,12,5.97,565,25.23,0.5,0.53
0,135,44,606,11,5.56,617,23.69,0.5,0.53
0,135,44,606,11,5.56,617,23.69,0.5,0.53
4,882,67,641,13,6.48,654,26.93,0.5,0.53
4,882,67,641,13,6.48,654,26.93,0.5,0.53
0,959,44,682,7,3.46,689,16.76,0.52,0.54
0,959,44,682,7,3.46,689,16.76,0.52,0.54
4,977,67,697,3,1.66,700,10.36,0.54,0.55
4,977,67,697,3,1.66,700,10.36,0.54,0.55
8,966,48,747,8,3.87,755,18.29,0.52,0.54
8,966,48,747,8,3.87,755,18.29,0.52,0.54
7,916,33,770,8,4.15,778,18.79,0.52,0.54
7,916,33,770,8,4.15,778,18.79,0.52,0.54
9,832,26,755,8,4.13,763,18.76,0.52,0.54
9,832,26,755,8,4.13,763,18.76,0.52,0.54
14,832,41,871,8,3.8,879,18.16,0.52,0.54
14,832,41,871,8,3.8,879,18.16,0.52,0.54
8,984,48,937,10,5.0,947,21.89,0.51,0.54
8,984,48,937,10,5.0,947,21.89,0.51,0.54
7,258,33,981,8,3.7600000000000002,989,18.08,0.52,0.54
7,258,33,981,8,3.7600000000000002,989,18.08,0.52,0.54
7,304,33,995,5,2.38,1000,13.22,0.53,0.55
7,304,33,995,5,2.38,1000,13.22,0.53,0.55
9,270,26,1005,5,2.39,1010,13.25,0.53,0.55
9,270,26,1005,5,2.39,1010,13.25,0.53,0.55
14,344,41,993,14,7.03,1007,28.72,0.49,0.53
14,344,41,993,14,7.03,1007,28.72,0.49,0.53
7,316,33,1046,14,7.21,1060,29.04,0.49,0.53
7,316,33,1046,14,7.21,1060,29.04,0.49,0.53
9,379,26,1024,7,3.34,1031,16.53,0.52,0.54
9,379,26,1024,7,3.34,1031,16.53,0.52,0.54
9,895,26,1064,14,7.14,1078,28.91,0.49,0.53
9,895,26,1064,14,7.14,1078,28.91,0.49,0.53
14,299,41,1054,11,5.29,1065,23.2,0.5,0.53
14,299,41,1054,11,5.29,1065,23.2,0.5,0.53
5,270,62,1094,12,6.24,1106,25.71,0.5,0.53
5,270,62,1094,12,6.24,1106,25.71,0.5,0.53
14,316,41,1133,18,8.82,1151,35.09,0.47000000000000003,0.52
14,316,41,1133,18,8.82,1151,35.09,0.47000000000000003,0.52
6,365,0,1161,15,7.69,1176,30.7,0.49,0.52
6,365,0,1161,15,7.69,1176,30.7,0.49,0.52
7,289,33,1144,5,2.74,1149,13.9,0.53,0.55
7,289,33,1144,5,2.74,1149,13.9,0.53,0.55
6,295,0,1186,6,3.14,1192,15.39,0.52,0.54
6,295,0,1186,6,3.14,1192,15.39,0.52,0.54
6,580,0,1250,10,5.05,1260,21.98,0.51,0.53
6,580,0,1250,10,5.05,1260,21.98,0.51,0.53
14,653,41,1295,10,5.06,1305,22.01,0.51,0.53
14,653,41,1295,10,5.06,1305,22.01,0.51,0.53
7,568,33,1361,11,5.73,1372,24.0,0.5,0.53
7,568,33,1361,11,5.73,1372,24.0,0.5,0.53
13,977,41,172,7,3.72,179,17.23,0.52,0.54
13,977,41,172,7,3.72,179,17.23,0.52,0.54
13,977,41,172,7,3.72,179,17.23,0.52,0.54
15,850,25,165,8,4.03,173,18.58,0.52,0.54
15,850,25,165,8,4.03,173,18.58,0.52,0.54
15,850,25,165,8,4.03,173,18.58,0.52,0.54
2,961,73,194,9,4.59,203,20.38,0.51,0.54
2,961,73,194,9,4.59,203,20.38,0.51,0.54
2,961,73,194,9,4.59,203,20.38,0.51,0.54
11,992,21,225,8,3.98,233,18.49,0.52,0.54
11,992,21,225,8,3.98,233,18.49,0.52,0.54
11,992,21,225,8,3.98,233,18.49,0.52,0.54
11,218,21,375,14,6.9,389,28.47,0.49,0.53
11,218,21,375,14,6.9,389,28.47,0.49,0.53
11,218,21,375,14,6.9,389,28.47,0.49,0.53
2,33,73,404,18,9.15,422,35.69,0.47000000000000003,0.52
2,33,73,404,18,9.15,422,35.69,0.47000000000000003,0.52
2,33,73,404,18,9.15,422,35.69,0.47000000000000003,0.52
3,146,60,404,17,8.34,421,33.45,0.48,0.52
3,146,60,404,17,8.34,421,33.45,0.48,0.52
3,146,60,404,17,8.34,421,33.45,0.48,0.52
7,229,24,416,1,0.25,417,6.24,0.55,0.55
7,229,24,416,1,0.25,417,6.24,0.55,0.55
7,229,24,416,1,0.25,417,6.24,0.55,0.55
11,91,21,397,7,3.64,404,17.09,0.52,0.54
11,91,21,397,7,3.64,404,17.09,0.52,0.54
11,91,21,397,7,3.64,404,17.09,0.52,0.54
9,242,9,432,7,3.33,439,16.52,0.52,0.54
9,242,9,432,7,3.33,439,16.52,0.52,0.54
9,242,9,432,7,3.33,439,16.52,0.52,0.54
10,614,68,421,4,2.2,425,12.13,0.53,0.55
10,614,68,421,4,2.2,425,12.13,0.53,0.55
10,614,68,421,4,2.2,425,12.13,0.53,0.55
11,5,21,447,16,8.25,463,32.49,0.48,0.52
11,5,21,447,16,8.25,463,32.49,0.48,0.52
11,5,21,447,16,8.25,463,32.49,0.48,0.52
12,113,83,431,5,2.73,436,13.87,0.53,0.55
12,113,83,431,5,2.73,436,13.87,0.53,0.55
12,113,83,431,5,2.73,436,13.87,0.53,0.55
3,181,60,475,17,8.33,492,33.43,0.48,0.52
3,181,60,475,17,8.33,492,33.43,0.48,0.52
3,181,60,475,17,8.33,492,33.43,0.48,0.52
8,180,84,453,5,2.37,458,13.21,0.53,0.55
8,180,84,453,5,2.37,458,13.21,0.53,0.55
8,180,84,453,5,2.37,458,13.21,0.53,0.55
9,105,9,461,4,2.13,465,12.0,0.53,0.55
9,105,9,461,4,2.13,465,12.0,0.53,0.55
9,105,9,461,4,2.13,465,12.0,0.53,0.55
3,192,60,500,5,2.57,505,13.57,0.53,0.55
3,192,60,500,5,2.57,505,13.57,0.53,0.55
3,192,60,500,5,2.57,505,13.57,0.53,0.55
7,5,24,484,9,4.39,493,20.01,0.51,0.54
7,5,24,484,9,4.39,493,20.01,0.51,0.54
7,5,24,484,9,4.39,493,20.01,0.51,0.54
10,47,68,506,12,6.24,518,25.72,0.5,0.53
10,47,68,506,12,6.24,518,25.72,0.5,0.53
10,47,68,506,12,6.24,518,25.72,0.5,0.53
11,184,21,495,14,7.01,509,28.68,0.49,0.53
11,184,21,495,14,7.01,509,28.68,0.49,0.53
11,184,21,495,14,7.01,509,28.68,0.49,0.53
3,48,60,522,14,7.19,536,29.0,0.49,0.53
3,48,60,522,14,7.19,536,29.0,0.49,0.53
3,48,60,522,14,7.19,536,29.0,0.49,0.53
8,865,84,520,13,6.38,533,26.75,0.5,0.53
8,865,84,520,13,6.38,533,26.75,0.5,0.53
8,865,84,520,13,6.38,533,26.75,0.5,0.53
9,144,9,525,4,1.85,529,11.48,0.53,0.55
9,144,9,525,4,1.85,529,11.48,0.53,0.55
9,144,9,525,4,1.85,529,11.48,0.53,0.55
11,158,21,524,19,9.54,543,37.19,0.47000000000000003,0.52
11,158,21,524,19,9.54,543,37.19,0.47000000000000003,0.52
11,158,21,524,19,9.54,543,37.19,0.47000000000000003,0.52
8,38,84,545,17,8.35,562,33.46,0.48,0.52
8,38,84,545,17,8.35,562,33.46,0.48,0.52
8,38,84,545,17,8.35,562,33.46,0.48,0.52
10,162,68,596,6,3.04,602,15.21,0.52,0.54
10,162,68,596,6,3.04,602,15.21,0.52,0.54
10,162,68,596,6,3.04,602,15.21,0.52,0.54
8,895,84,654,6,2.94,660,15.02,0.52,0.54
8,895,84,654,6,2.94,660,15.02,0.52,0.54
8,895,84,654,6,2.94,660,15.02,0.52,0.54
8,962,84,759,11,5.28,770,23.19,0.5,0.53
8,962,84,759,11,5.28,770,23.19,0.5,0.53
8,962,84,759,11,5.28,770,23.19,0.5,0.53
0,839,35,832,15,7.68,847,30.68,0.49,0.52
0,839,35,832,15,7.68,847,30.68,0.49,0.52
0,839,35,832,15,7.68,847,30.68,0.49,0.52
8,864,84,959,8,3.78,967,18.11,0.52,0.54
8,864,84,959,8,3.78,967,18.11,0.52,0.54
8,864,84,959,8,3.78,967,18.11,0.52,0.54
8,415,84,987,8,3.87,995,18.29,0.52,0.54
8,415,84,987,8,3.87,995,18.29,0.52,0.54
8,415,84,987,8,3.87,995,18.29,0.52,0.54
1,304,26,1070,15,7.65,1085,30.62,0.49,0.52
1,304,26,1070,15,7.65,1085,30.62,0.49,0.52
1,304,26,1070,15,7.65,1085,30.62,0.49,0.52
8,493,84,1077,15,7.64,1092,30.61,0.49,0.52
8,493,84,1077,15,7.64,1092,30.61,0.49,0.52
8,493,84,1077,15,7.64,1092,30.61,0.49,0.52
10,271,68,1068,4,1.8900000000000001,1072,11.55,0.53,0.55
10,271,68,1068,4,1.8900000000000001,1072,11.55,0.53,0.55
10,271,68,1068,4,1.8900000000000001,1072,11.55,0.53,0.55
1,459,26,1098,3,1.41,1101,9.91,0.54,0.55
1,459,26,1098,3,1.41,1101,9.91,0.54,0.55
1,459,26,1098,3,1.41,1101,9.91,0.54,0.55
10,343,68,1104,11,5.41,1115,23.42,0.5,0.53
10,343,68,1104,11,5.41,1115,23.42,0.5,0.53
10,343,68,1104,11,5.41,1115,23.42,0.5,0.53
0,524,57,1181,14,6.91,1195,28.5,0.49,0.53
0,524,57,1181,14,6.91,1195,28.5,0.49,0.53
0,524,57,1181,14,6.91,1195,28.5,0.49,0.53
3,663,47,1273,15,7.25,1288,29.9,0.49,0.53
3,663,47,1273,15,7.25,1288,29.9,0.49,0.53
3,663,47,1273,15,7.25,1288,29.9,0.49,0.53
3,524,47,1352,8,4.21,1360,18.89,0.52,0.54
3,524,47,1352,8,4.21,1360,18.89,0.52,0.54
3,524,47,1352,8,4.21,1360,18.89,0.52,0.54
4,628,20,1354,12,5.91,1366,25.12,0.5,0.53
4,628,20,1354,12,5.91,1366,25.12,0.5,0.53
4,628,20,1354,12,5.91,1366,25.12,0.5,0.53
14,601,61,1356,12,5.78,1368,24.88,0.5,0.53
14,601,61,1356,12,5.78,1368,24.88,0.5,0.53
14,601,61,1356,12,5.78,1368,24.88,0.5,0.53
4,540,20,1390,9,4.52,1399,20.24,0.51,0.54
4,540,20,1390,9,4.52,1399,20.24,0.51,0.54
4,540,20,1390,9,4.52,1399,20.24,0.51,0.54
14,984,61,1381,8,4.07,1389,18.64,0.52,0.54
14,984,61,1381,8,4.07,1389,18.64,0.52,0.54
14,984,61,1381,8,4.07,1389,18.64,0.52,0.54
6,578,30,1436,16,7.77,1452,31.62,0.48,0.52
6,578,30,1436,16,7.77,1452,31.62,0.48,0.52
6,578,30,1436,16,7.77,1452,31.62,0.48,0.52
15,960,36,320,21,10.38,341,40.27,0.46,0.51
15,960,36,320,21,10.38,341,40.27,0.46,0.51
15,960,36,320,21,10.38,341,40.27,0.46,0.51
15,960,36,320,21,10.38,341,40.27,0.46,0.51
12,122,93,389,21,10.65,410,40.76,0.46,0.51
12,122,93,389,21,10.65,410,40.76,0.46,0.51
12,122,93,389,21,10.65,410,40.76,0.46,0.51
12,122,93,389,21,10.65,410,40.76,0.46,0.51
12,70,93,403,18,8.98,421,35.38,0.47000000000000003,0.52
12,70,93,403,18,8.98,421,35.38,0.47000000000000003,0.52
12,70,93,403,18,8.98,421,35.38,0.47000000000000003,0.52
12,70,93,403,18,8.98,421,35.38,0.47000000000000003,0.52
13,158,69,406,10,4.81,416,21.56,0.51,0.54
13,158,69,406,10,4.81,416,21.56,0.51,0.54
13,158,69,406,10,4.81,416,21.56,0.51,0.54
13,158,69,406,10,4.81,416,21.56,0.51,0.54
14,201,34,395,4,2.17,399,12.08,0.53,0.55
14,201,34,395,4,2.17,399,12.08,0.53,0.55
14,201,34,395,4,2.17,399,12.08,0.53,0.55
14,201,34,395,4,2.17,399,12.08,0.53,0.55
15,822,36,415,4,1.8900000000000001,419,11.56,0.53,0.55
15,822,36,415,4,1.8900000000000001,419,11.56,0.53,0.55
15,822,36,415,4,1.8900000000000001,419,11.56,0.53,0.55
15,822,36,415,4,1.8900000000000001,419,11.56,0.53,0.55
7,980,56,422,16,7.96,438,31.97,0.48,0.52
7,980,56,422,16,7.96,438,31.97,0.48,0.52
7,980,56,422,16,7.96,438,31.97,0.48,0.52
7,980,56,422,16,7.96,438,31.97,0.48,0.52
9,38,6,425,14,7.03,439,28.71,0.49,0.53
9,38,6,425,14,7.03,439,28.71,0.49,0.53
9,38,6,425,14,7.03,439,28.71,0.49,0.53
9,38,6,425,14,7.03,439,28.71,0.49,0.53
14,5,34,437,13,6.51,450,26.99,0.5,0.53
14,5,34,437,13,6.51,450,26.99,0.5,0.53
14,5,34,437,13,6.51,450,26.99,0.5,0.53
14,5,34,437,13,6.51,450,26.99,0.5,0.53
2,75,65,451,3,1.62,454,10.3,0.54,0.55
2,75,65,451,3,1.62,454,10.3,0.54,0.55
2,75,65,451,3,1.62,454,10.3,0.54,0.55
2,75,65,451,3,1.62,454,10.3,0.54,0.55
7,139,56,453,5,2.32,458,13.12,0.53,0.55
7,139,56,453,5,2.32,458,13.12,0.53,0.55
7,139,56,453,5,2.32,458,13.12,0.53,0.55
7,139,56,453,5,2.32,458,13.12,0.53,0.55
7,183,56,501,12,5.89,513,25.08,0.5,0.53
7,183,56,501,12,5.89,513,25.08,0.5,0.53
7,183,56,501,12,5.89,513,25.08,0.5,0.53
7,183,56,501,12,5.89,513,25.08,0.5,0.53
11,173,72,482,2,1.06,484,8.49,0.54,0.55
11,173,72,482,2,1.06,484,8.49,0.54,0.55
11,173,72,482,2,1.06,484,8.49,0.54,0.55
11,173,72,482,2,1.06,484,8.49,0.54,0.55
11,875,72,518,13,6.37,531,26.73,0.5,0.53
11,875,72,518,13,6.37,531,26.73,0.5,0.53
11,875,72,518,13,6.37,531,26.73,0.5,0.53
11,875,72,518,13,6.37,531,26.73,0.5,0.53
14,24,34,514,4,1.8800000000000001,518,11.54,0.53,0.55
14,24,34,514,4,1.8800000000000001,518,11.54,0.53,0.55
14,24,34,514,4,1.8800000000000001,518,11.54,0.53,0.55
14,24,34,514,4,1.8800000000000001,518,11.54,0.53,0.55
7,188,56,559,11,5.66,570,23.88,0.5,0.53
7,188,56,559,11,5.66,570,23.88,0.5,0.53
7,188,56,559,11,5.66,570,23.88,0.5,0.53
7,188,56,559,11,5.66,570,23.88,0.5,0.53
11,90,72,561,15,7.54,576,30.43,0.49,0.52
11,90,72,561,15,7.54,576,30.43,0.49,0.52
11,90,72,561,15,7.54,576,30.43,0.49,0.52
11,90,72,561,15,7.54,576,30.43,0.49,0.52
0,15,16,595,14,7.09,609,28.82,0.49,0.53
0,15,16,595,14,7.09,609,28.82,0.49,0.53
0,15,16,595,14,7.09,609,28.82,0.49,0.53
0,15,16,595,14,7.09,609,28.82,0.49,0.53
4,189,51,600,12,6.19,612,25.62,0.5,0.53
4,189,51,600,12,6.19,612,25.62,0.5,0.53
4,189,51,600,12,6.19,612,25.62,0.5,0.53
4,189,51,600,12,6.19,612,25.62,0.5,0.53
0,751,16,681,17,8.59,698,33.9,0.48,0.52
0,751,16,681,17,8.59,698,33.9,0.48,0.52
0,751,16,681,17,8.59,698,33.9,0.48,0.52
0,751,16,681,17,8.59,698,33.9,0.48,0.52
5,921,61,713,13,6.42,726,26.83,0.5,0.53
5,921,61,713,13,6.42,726,26.83,0.5,0.53
5,921,61,713,13,6.42,726,26.83,0.5,0.53
5,921,61,713,13,6.42,726,26.83,0.5,0.53
10,757,99,743,8,4.05,751,18.61,0.52,0.54
10,757,99,743,8,4.05,751,18.61,0.52,0.54
10,757,99,743,8,4.05,751,18.61,0.52,0.54
10,757,99,743,8,4.05,751,18.61,0.52,0.54
0,790,16,804,16,8.23,820,32.47,0.48,0.52
0,790,16,804,16,8.23,820,32.47,0.48,0.52
0,790,16,804,16,8.23,820,32.47,0.48,0.52
0,790,16,804,16,8.23,820,32.47,0.48,0.52
10,966,99,794,9,4.51,803,20.22,0.51,0.54
10,966,99,794,9,4.51,803,20.22,0.51,0.54
10,966,99,794,9,4.51,803,20.22,0.51,0.54
10,966,99,794,9,4.51,803,20.22,0.51,0.54
8,498,5,950,11,5.48,961,23.55,0.5,0.53
8,498,5,950,11,5.48,961,23.55,0.5,0.53
8,498,5,950,11,5.48,961,23.55,0.5,0.53
8,498,5,950,11,5.48,961,23.55,0.5,0.53
8,937,5,972,16,7.86,988,31.78,0.48,0.52
8,937,5,972,16,7.86,988,31.78,0.48,0.52
8,937,5,972,16,7.86,988,31.78,0.48,0.52
8,937,5,972,16,7.86,988,31.78,0.48,0.52
15,939,13,989,21,10.3,1010,40.12,0.46,0.51
15,939,13,989,21,10.3,1010,40.12,0.46,0.51
15,939,13,989,21,10.3,1010,40.12,0.46,0.51
15,939,13,989,21,10.3,1010,40.12,0.46,0.51
15,907,13,1000,2,0.84,1002,8.1,0.54,0.55
15,907,13,1000,2,0.84,1002,8.1,0.54,0.55
15,907,13,1000,2,0.84,1002,8.1,0.54,0.55
15,907,13,1000,2,0.84,1002,8.1,0.54,0.55
8,460,5,1044,14,7.11,1058,28.87,0.49,0.53
8,460,5,1044,14,7.11,1058,28.87,0.49,0.53
8,460,5,1044,14,7.11,1058,28.87,0.49,0.53
8,460,5,1044,14,7.11,1058,28.87,0.49,0.53
1,264,7,1069,2,0.84,1071,8.08,0.54,0.55
1,264,7,1069,2,0.84,1071,8.08,0.54,0.55
1,264,7,1069,2,0.84,1071,8.08,0.54,0.55
1,264,7,1069,2,0.84,1071,8.08,0.54,0.55
15,947,13,1064,14,7.12,1078,28.88,0.49,0.53
15,947,13,1064,14,7.12,1078,28.88,0.49,0.53
15,947,13,1064,14,7.12,1078,28.88,0.49,0.53
15,947,13,1064,14,7.12,1078,28.88,0.49,0.53
1,283,7,1088,14,6.89,1102,28.46,0.49,0.53
1,283,7,1088,14,6.89,1102,28.46,0.49,0.53
1,283,7,1088,14,6.89,1102,28.46,0.49,0.53
1,283,7,1088,14,6.89,1102,28.46,0.49,0.53
8,269,5,1098,3,1.62,1101,10.29,0.54,0.55
8,269,5,1098,3,1.62,1101,10.29,0.54,0.55
8,269,5,1098,3,1.62,1101,10.29,0.54,0.55
8,269,5,1098,3,1.62,1101,10.29,0.54,0.55
15,334,13,1100,24,11.9,1124,45.38,0.45,0.51
15,334,13,1100,24,11.9,1124,45.38,0.45,0.51
15,334,13,1100,24,11.9,1124,45.38,0.45,0.51
15,334,13,1100,24,11.9,1124,45.38,0.45,0.51
8,558,5,1174,15,7.29,1189,29.96,0.49,0.53
8,558,5,1174,15,7.29,1189,29.96,0.49,0.53
8,558,5,1174,15,7.29,1189,29.96,0.49,0.53
8,558,5,1174,15,7.29,1189,29.96,0.49,0.53
15,333,13,1180,17,8.3,1197,33.37,0.48,0.52
15,333,13,1180,17,8.3,1197,33.37,0.48,0.52
15,333,13,1180,17,8.3,1197,33.37,0.48,0.52
15,333,13,1180,17,8.3,1197,33.37,0.48,0.52
8,667,5,1282,7,3.49,1289,16.81,0.52,0.54
8,667,5,1282,7,3.49,1289,16.81,0.52,0.54
8,667,5,1282,7,3.49,1289,16.81,0.52,0.54
8,667,5,1282,7,3.49,1289,16.81,0.52,0.54
8,966,5,1313,16,7.98,1329,32.01,0.48,0.52
8,966,5,1313,16,7.98,1329,32.01,0.48,0.52
8,966,5,1313,16,7.98,1329,32.01,0.48,0.52
8,966,5,1313,16,7.98,1329,32.01,0.48,0.52
1,507,7,1328,11,5.68,1339,23.92,0.5,0.53
1,507,7,1328,11,5.68,1339,23.92,0.5,0.53
1,507,7,1328,11,5.68,1339,23.92,0.5,0.53
1,507,7,1328,11,5.68,1339,23.92,0.5,0.53
1,558,7,1388,6,2.95,1394,15.05,0.52,0.54
1,558,7,1388,6,2.95,1394,15.05,0.52,0.54
1,558,7,1388,6,2.95,1394,15.05,0.52,0.54
1,558,7,1388,6,2.95,1394,15.05,0.52,0.54
13,732,4,1425,14,7.13,1439,28.89,0.49,0.53
13,732,4,1425,14,7.13,1439,28.89,0.49,0.53
13,732,4,1425,14,7.13,1439,28.89,0.49,0.53
13,732,4,1425,14,7.13,1439,28.89,0.49,0.53
9,752,35,40,6,2.91,46,14.97,0.53,0.54
9,752,35,40,6,2.91,46,14.97,0.53,0.54
9,752,35,40,6,2.91,46,14.97,0.53,0.54
9,752,35,40,6,2.91,46,14.97,0.53,0.54
9,752,35,40,6,2.91,46,14.97,0.53,0.54
9,966,35,102,10,4.88,112,21.69,0.51,0.54
9,966,35,102,10,4.88,112,21.69,0.51,0.54
9,966,35,102,10,4.88,112,21.69,0.51,0.54
9,966,35,102,10,4.88,112,21.69,0.51,0.54
9,966,35,102,10,4.88,112,21.69,0.51,0.54
2,927,61,159,15,7.48,174,30.32,0.49,0.52
2,927,61,159,15,7.48,174,30.32,0.49,0.52
2,927,61,159,15,7.48,174,30.32,0.49,0.52
2,927,61,159,15,7.48,174,30.32,0.49,0.52
2,927,61,159,15,7.48,174,30.32,0.49,0.52
9,751,35,150,5,2.7,155,13.81,0.53,0.55
9,751,35,150,5,2.7,155,13.81,0.53,0.55
9,751,35,150,5,2.7,155,13.81,0.53,0.55
9,751,35,150,5,2.7,155,13.81,0.53,0.55
9,751,35,150,5,2.7,155,13.81,0.53,0.55
5,848,26,355,10,4.95,365,21.8,0.51,0.54
5,848,26,355,10,4.95,365,21.8,0.51,0.54
5,848,26,355,10,4.95,365,21.8,0.51,0.54
5,848,26,355,10,4.95,365,21.8,0.51,0.54
5,848,26,355,10,4.95,365,21.8,0.51,0.54
5,106,26,415,12,5.93,427,25.15,0.5,0.53
5,106,26,415,12,5.93,427,25.15,0.5,0.53
5,106,26,415,12,5.93,427,25.15,0.5,0.53
5,106,26,415,12,5.93,427,25.15,0.5,0.53
5,106,26,415,12,5.93,427,25.15,0.5,0.53
6,826,78,415,4,2.04,419,11.84,0.53,0.55
6,826,78,415,4,2.04,419,11.84,0.53,0.55
6,826,78,415,4,2.04,419,11.84,0.53,0.55
6,826,78,415,4,2.04,419,11.84,0.53,0.55
6,826,78,415,4,2.04,419,11.84,0.53,0.55
8,144,9,411,8,4.06,419,18.64,0.52,0.54
8,144,9,411,8,4.06,419,18.64,0.52,0.54
8,144,9,411,8,4.06,419,18.64,0.52,0.54
8,144,9,411,8,4.06,419,18.64,0.52,0.54
8,144,9,411,8,4.06,419,18.64,0.52,0.54
9,136,35,396,11,5.53,407,23.65,0.5,0.53
9,136,35,396,11,5.53,407,23.65,0.5,0.53
9,136,35,396,11,5.53,407,23.65,0.5,0.53
9,136,35,396,11,5.53,407,23.65,0.5,0.53
9,136,35,396,11,5.53,407,23.65,0.5,0.53
11,17,33,406,7,3.38,413,16.62,0.52,0.54
11,17,33,406,7,3.38,413,16.62,0.52,0.54
11,17,33,406,7,3.38,413,16.62,0.52,0.54
11,17,33,406,7,3.38,413,16.62,0.52,0.54
11,17,33,406,7,3.38,413,16.62,0.52,0.54
10,237,91,444,8,3.86,452,18.26,0.52,0.54
10,237,91,444,8,3.86,452,18.26,0.52,0.54
10,237,91,444,8,3.86,452,18.26,0.52,0.54
10,237,91,444,8,3.86,452,18.26,0.52,0.54
10,237,91,444,8,3.86,452,18.26,0.52,0.54
11,116,33,449,5,2.61,454,13.65,0.53,0.55
11,116,33,449,5,2.61,454,13.65,0.53,0.55
11,116,33,449,5,2.61,454,13.65,0.53,0.55
11,116,33,449,5,2.61,454,13.65,0.53,0.55
11,116,33,449,5,2.61,454,13.65,0.53,0.55
15,811,28,447,23,11.42,470,43.73,0.45,0.51
15,811,28,447,23,11.42,470,43.73,0.45,0.51
15,811,28,447,23,11.42,470,43.73,0.45,0.51
15,811,28,447,23,11.42,470,43.73,0.45,0.51
15,811,28,447,23,11.42,470,43.73,0.45,0.51
9,783,35,461,0,0.25,461,5.45,0.55,0.56
9,783,35,461,0,0.25,461,5.45,0.55,0.56
9,783,35,461,0,0.25,461,5.45,0.55,0.56
9,783,35,461,0,0.25,461,5.45,0.55,0.56
9,783,35,461,0,0.25,461,5.45,0.55,0.56
10,157,91,450,6,3.07,456,15.27,0.52,0.54
10,157,91,450,6,3.07,456,15.27,0.52,0.54
10,157,91,450,6,3.07,456,15.27,0.52,0.54
10,157,91,450,6,3.07,456,15.27,0.52,0.54
10,157,91,450,6,3.07,456,15.27,0.52,0.54
4,222,6,496,6,2.78,502,14.74,0.53,0.54
4,222,6,496,6,2.78,502,14.74,0.53,0.54
4,222,6,496,6,2.78,502,14.74,0.53,0.54
4,222,6,496,6,2.78,502,14.74,0.53,0.54
4,222,6,496,6,2.78,502,14.74,0.53,0.54
7,232,81,480,10,4.76,490,21.46,0.51,0.54
7,232,81,480,10,4.76,490,21.46,0.51,0.54
7,232,81,480,10,4.76,490,21.46,0.51,0.54
7,232,81,480,10,4.76,490,21.46,0.51,0.54
7,232,81,480,10,4.76,490,21.46,0.51,0.54
11,149,33,514,4,1.85,518,11.48,0.53,0.55
11,149,33,514,4,1.85,518,11.48,0.53,0.55
11,149,33,514,4,1.85,518,11.48,0.53,0.55
11,149,33,514,4,1.85,518,11.48,0.53,0.55
11,149,33,514,4,1.85,518,11.48,0.53,0.55
7,92,81,563,6,2.89,569,14.95,0.53,0.54
7,92,81,563,6,2.89,569,14.95,0.53,0.54
7,92,81,563,6,2.89,569,14.95,0.53,0.54
7,92,81,563,6,2.89,569,14.95,0.53,0.54
7,92,81,563,6,2.89,569,14.95,0.53,0.54
11,33,33,557,17,8.48,574,33.69,0.48,0.52
11,33,33,557,17,8.48,574,33.69,0.48,0.52
11,33,33,557,17,8.48,574,33.69,0.48,0.52
11,33,33,557,17,8.48,574,33.69,0.48,0.52
11,33,33,557,17,8.48,574,33.69,0.48,0.52
11,210,33,581,15,7.73,596,30.77,0.49,0.52
11,210,33,581,15,7.73,596,30.77,0.49,0.52
11,210,33,581,15,7.73,596,30.77,0.49,0.52
11,210,33,581,15,7.73,596,30.77,0.49,0.52
11,210,33,581,15,7.73,596,30.77,0.49,0.52
0,843,2,606,5,2.66,611,13.73,0.53,0.55
0,843,2,606,5,2.66,611,13.73,0.53,0.55
0,843,2,606,5,2.66,611,13.73,0.53,0.55
0,843,2,606,5,2.66,611,13.73,0.53,0.55
0,843,2,606,5,2.66,611,13.73,0.53,0.55
14,864,20,630,18,8.75,648,34.97,0.48,0.52
14,864,20,630,18,8.75,648,34.97,0.48,0.52
14,864,20,630,18,8.75,648,34.97,0.48,0.52
14,864,20,630,18,8.75,648,34.97,0.48,0.52
14,864,20,630,18,8.75,648,34.97,0.48,0.52
3,839,10,722,16,7.87,738,31.81,0.48,0.52
3,839,10,722,16,7.87,738,31.81,0.48,0.52
3,839,10,722,16,7.87,738,31.81,0.48,0.52
3,839,10,722,16,7.87,738,31.81,0.48,0.52
3,839,10,722,16,7.87,738,31.81,0.48,0.52
7,840,81,926,5,2.61,931,13.66,0.53,0.55
7,840,81,926,5,2.61,931,13.66,0.53,0.55
7,840,81,926,5,2.61,931,13.66,0.53,0.55
7,840,81,926,5,2.61,931,13.66,0.53,0.55
7,840,81,926,5,2.61,931,13.66,0.53,0.55
3,502,15,1240,15,7.65,1255,30.62,0.49,0.52
3,502,15,1240,15,7.65,1255,30.62,0.49,0.52
3,502,15,1240,15,7.65,1255,30.62,0.49,0.52
3,502,15,1240,15,7.65,1255,30.62,0.49,0.52
3,502,15,1240,15,7.65,1255,30.62,0.49,0.52
3,609,15,1279,4,2.04,1283,11.84,0.53,0.55
3,609,15,1279,4,2.04,1283,11.84,0.53,0.55
3,609,15,1279,4,2.04,1283,11.84,0.53,0.55
3,609,15,1279,4,2.04,1283,11.84,0.53,0.55
3,609,15,1279,4,2.04,1283,11.84,0.53,0.55
8,743,43,1291,16,8.24,1307,32.47,0.48,0.52
8,743,43,1291,16,8.24,1307,32.47,0.48,0.52
8,743,43,1291,16,8.24,1307,32.47,0.48,0.52
8,743,43,1291,16,8.24,1307,32.47,0.48,0.52
8,743,43,1291,16,8.24,1307,32.47,0.48,0.52
15,558,58,1298,22,10.8,1320,41.82,0.46,0.51
15,558,58,1298,22,10.8,1320,41.82,0.46,0.51
15,558,58,1298,22,10.8,1320,41.82,0.46,0.51
15,558,58,1298,22,10.8,1320,41.82,0.46,0.51
15,558,58,1298,22,10.8,1320,41.82,0.46,0.51
3,720,15,1352,7,3.49,1359,16.81,0.52,0.54
3,720,15,1352,7,3.49,1359,16.81,0.52,0.54
3,720,15,1352,7,3.49,1359,16.81,0.52,0.54
3,720,15,1352,7,3.49,1359,16.81,0.52,0.54
3,720,15,1352,7,3.49,1359,16.81,0.52,0.54
8,743,43,1364,5,2.59,1369,13.61,0.53,0.55
8,743,43,1364,5,2.59,1369,13.61,0.53,0.55
8,743,43,1364,5,2.59,1369,13.61,0.53,0.55
8,743,43,1364,5,2.59,1369,13.61,0.53,0.55
8,743,43,1364,5,2.59,1369,13.61,0.53,0.55
9,175,53,293,6,2.78,299,14.74,0.53,0.54
9,175,53,293,6,2.78,299,14.74,0.53,0.54
9,175,53,293,6,2.78,299,14.74,0.53,0.54
9,175,53,293,6,2.78,299,14.74,0.53,0.54
9,175,53,293,6,2.78,299,14.74,0.53,0.54
9,175,53,293,6,2.78,299,14.74,0.53,0.54
10,113,76,343,16,7.97,359,31.98,0.48,0.52
10,113,76,343,16,7.97,359,31.98,0.48,0.52
10,113,76,343,16,7.97,359,31.98,0.48,0.52
10,113,76,343,16,7.97,359,31.98,0.48,0.52
10,113,76,343,16,7.97,359,31.98,0.48,0.52
10,113,76,343,16,7.97,359,31.98,0.48,0.52
10,891,76,373,14,6.88,387,28.44,0.49,0.53
10,891,76,373,14,6.88,387,28.44,0.49,0.53
10,891,76,373,14,6.88,387,28.44,0.49,0.53
10,891,76,373,14,6.88,387,28.44,0.49,0.53
10,891,76,373,14,6.88,387,28.44,0.49,0.53
10,891,76,373,14,6.88,387,28.44,0.49,0.53
6,121,65,394,11,5.57,405,23.72,0.5,0.53
6,121,65,394,11,5.57,405,23.72,0.5,0.53
6,121,65,394,11,5.57,405,23.72,0.5,0.53
6,121,65,394,11,5.57,405,23.72,0.5,0.53
6,121,65,394,11,5.57,405,23.72,0.5,0.53
6,121,65,394,11,5.57,405,23.72,0.5,0.53
12,101,33,418,14,6.78,432,28.26,0.49,0.53
12,101,33,418,14,6.78,432,28.26,0.49,0.53
12,101,33,418,14,6.78,432,28.26,0.49,0.53
12,101,33,418,14,6.78,432,28.26,0.49,0.53
12,101,33,418,14,6.78,432,28.26,0.49,0.53
12,101,33,418,14,6.78,432,28.26,0.49,0.53
6,903,65,423,12,5.76,435,24.84,0.5,0.53
6,903,65,423,12,5.76,435,24.84,0.5,0.53
6,903,65,423,12,5.76,435,24.84,0.5,0.53
6,903,65,423,12,5.76,435,24.84,0.5,0.53
6,903,65,423,12,5.76,435,24.84,0.5,0.53
6,903,65,423,12,5.76,435,24.84,0.5,0.53
10,122,76,425,3,1.48,428,10.04,0.54,0.55
10,122,76,425,3,1.48,428,10.04,0.54,0.55
10,122,76,425,3,1.48,428,10.04,0.54,0.55
10,122,76,425,3,1.48,428,10.04,0.54,0.55
10,122,76,425,3,1.48,428,10.04,0.54,0.55
10,122,76,425,3,1.48,428,10.04,0.54,0.55
12,142,33,438,10,4.9,448,21.71,0.51,0.54
12,142,33,438,10,4.9,448,21.71,0.51,0.54
12,142,33,438,10,4.9,448,21.71,0.51,0.54
12,142,33,438,10,4.9,448,21.71,0.51,0.54
12,142,33,438,10,4.9,448,21.71,0.51,0.54
12,142,33,438,10,4.9,448,21.71,0.51,0.54
13,246,13,435,3,1.62,438,10.29,0.54,0.55
13,246,13,435,3,1.62,438,10.29,0.54,0.55
13,246,13,435,3,1.62,438,10.29,0.54,0.55
13,246,13,435,3,1.62,438,10.29,0.54,0.55
13,246,13,435,3,1.62,438,10.29,0.54,0.55
13,246,13,435,3,1.62,438,10.29,0.54,0.55
6,116,65,454,10,4.75,464,21.45,0.51,0.54
6,116,65,454,10,4.75,464,21.45,0.51,0.54
6,116,65,454,10,4.75,464,21.45,0.51,0.54
6,116,65,454,10,4.75,464,21.45,0.51,0.54
6,116,65,454,10,4.75,464,21.45,0.51,0.54
6,116,65,454,10,4.75,464,21.45,0.51,0.54
10,74,76,454,7,3.66,461,17.11,0.52,0.54
10,74,76,454,7,3.66,461,17.11,0.52,0.54
10,74,76,454,7,3.66,461,17.11,0.52,0.54
10,74,76,454,7,3.66,461,17.11,0.52,0.54
10,74,76,454,7,3.66,461,17.11,0.52,0.54
10,74,76,454,7,3.66,461,17.11,0.52,0.54
12,76,33,468,8,4.14,476,18.77,0.52,0.54
12,76,33,468,8,4.14,476,18.77,0.52,0.54
12,76,33,468,8,4.14,476,18.77,0.52,0.54
12,76,33,468,8,4.14,476,18.77,0.52,0.54
12,76,33,468,8,4.14,476,18.77,0.52,0.54
12,76,33,468,8,4.14,476,18.77,0.52,0.54
13,121,13,451,14,6.79,465,28.27,0.49,0.53
13,121,13,451,14,6.79,465,28.27,0.49,0.53
13,121,13,451,14,6.79,465,28.27,0.49,0.53
13,121,13,451,14,6.79,465,28.27,0.49,0.53
13,121,13,451,14,6.79,465,28.27,0.49,0.53
13,121,13,451,14,6.79,465,28.27,0.49,0.53
4,801,29,494,7,3.64,501,17.08,0.52,0.54
4,801,29,494,7,3.64,501,17.08,0.52,0.54
4,801,29,494,7,3.64,501,17.08,0.52,0.54
4,801,29,494,7,3.64,501,17.08,0.52,0.54
4,801,29,494,7,3.64,501,17.08,0.52,0.54
4,801,29,494,7,3.64,501,17.08,0.52,0.54
6,101,65,491,9,4.3,500,19.84,0.51,0.54
6,101,65,491,9,4.3,500,19.84,0.51,0.54
6,101,65,491,9,4.3,500,19.84,0.51,0.54
6,101,65,491,9,4.3,500,19.84,0.51,0.54
6,101,65,491,9,4.3,500,19.84,0.51,0.54
6,101,65,491,9,4.3,500,19.84,0.51,0.54
8,181,48,493,22,11.06,515,42.3,0.46,0.51
8,181,48,493,22,11.06,515,42.3,0.46,0.51
8,181,48,493,22,11.06,515,42.3,0.46,0.51
8,181,48,493,22,11.06,515,42.3,0.46,0.51
8,181,48,493,22,11.06,515,42.3,0.46,0.51
8,181,48,493,22,11.06,515,42.3,0.46,0.51
10,167,76,498,4,2.13,502,12.0,0.53,0.55
10,167,76,498,4,2.13,502,12.0,0.53,0.55
10,167,76,498,4,2.13,502,12.0,0.53,0.55
10,167,76,498,4,2.13,502,12.0,0.53,0.55
10,167,76,498,4,2.13,502,12.0,0.53,0.55
10,167,76,498,4,2.13,502,12.0,0.53,0.55
12,106,33,503,0,0.16,503,5.29,0.55,0.56
12,106,33,503,0,0.16,503,5.29,0.55,0.56
12,106,33,503,0,0.16,503,5.29,0.55,0.56
12,106,33,503,0,0.16,503,5.29,0.55,0.56
12,106,33,503,0,0.16,503,5.29,0.55,0.56
12,106,33,503,0,0.16,503,5.29,0.55,0.56
14,41,80,507,10,5.04,517,21.97,0.51,0.53
14,41,80,507,10,5.04,517,21.97,0.51,0.53
14,41,80,507,10,5.04,517,21.97,0.51,0.53
14,41,80,507,10,5.04,517,21.97,0.51,0.53
14,41,80,507,10,5.04,517,21.97,0.51,0.53
14,41,80,507,10,5.04,517,21.97,0.51,0.53
4,28,29,514,5,2.4,519,13.26,0.53,0.55
4,28,29,514,5,2.4,519,13.26,0.53,0.55
4,28,29,514,5,2.4,519,13.26,0.53,0.55
4,28,29,514,5,2.4,519,13.26,0.53,0.55
4,28,29,514,5,2.4,519,13.26,0.53,0.55
4,28,29,514,5,2.4,519,13.26,0.53,0.55
6,41,65,521,11,5.58,532,23.73,0.5,0.53
6,41,65,521,11,5.58,532,23.73,0.5,0.53
6,41,65,521,11,5.58,532,23.73,0.5,0.53
6,41,65,521,11,5.58,532,23.73,0.5,0.53
6,41,65,521,11,5.58,532,23.73,0.5,0.53
6,41,65,521,11,5.58,532,23.73,0.5,0.53
10,912,76,533,9,4.74,542,20.65,0.51,0.54
10,912,76,533,9,4.74,542,20.65,0.51,0.54
10,912,76,533,9,4.74,542,20.65,0.51,0.54
10,912,76,533,9,4.74,542,20.65,0.51,0.54
10,912,76,533,9,4.74,542,20.65,0.51,0.54
10,912,76,533,9,4.74,542,20.65,0.51,0.54
14,28,80,515,21,10.47,536,40.43,0.46,0.51
14,28,80,515,21,10.47,536,40.43,0.46,0.51
14,28,80,515,21,10.47,536,40.43,0.46,0.51
14,28,80,515,21,10.47,536,40.43,0.46,0.51
14,28,80,515,21,10.47,536,40.43,0.46,0.51
14,28,80,515,21,10.47,536,40.43,0.46,0.51
14,87,80,557,15,7.69,572,30.69,0.49,0.52
14,87,80,557,15,7.69,572,30.69,0.49,0.52
14,87,80,557,15,7.69,572,30.69,0.49,0.52
14,87,80,557,15,7.69,572,30.69,0.49,0.52
14,87,80,557,15,7.69,572,30.69,0.49,0.52
14,87,80,557,15,7.69,572,30.69,0.49,0.52
0,100,32,570,20,10.24,590,39.23,0.46,0.51
0,100,32,570,20,10.24,590,39.23,0.46,0.51
0,100,32,570,20,10.24,590,39.23,0.46,0.51
0,100,32,570,20,10.24,590,39.23,0.46,0.51
0,100,32,570,20,10.24,590,39.23,0.46,0.51
0,100,32,570,20,10.24,590,39.23,0.46,0.51
1,916,96,579,10,5.22,589,22.3,0.51,0.53
1,916,96,579,10,5.22,589,22.3,0.51,0.53
1,916,96,579,10,5.22,589,22.3,0.51,0.53
1,916,96,579,10,5.22,589,22.3,0.51,0.53
1,916,96,579,10,5.22,589,22.3,0.51,0.53
1,916,96,579,10,5.22,589,22.3,0.51,0.53
4,777,29,626,4,2.14,630,12.01,0.53,0.55
4,777,29,626,4,2.14,630,12.01,0.53,0.55
4,777,29,626,4,2.14,630,12.01,0.53,0.55
4,777,29,626,4,2.14,630,12.01,0.53,0.55
4,777,29,626,4,2.14,630,12.01,0.53,0.55
4,777,29,626,4,2.14,630,12.01,0.53,0.55
15,939,51,648,13,6.69,661,27.31,0.49,0.53
15,939,51,648,13,6.69,661,27.31,0.49,0.53
15,939,51,648,13,6.69,661,27.31,0.49,0.53
15,939,51,648,13,6.69,661,27.31,0.49,0.53
15,939,51,648,13,6.69,661,27.31,0.49,0.53
15,939,51,648,13,6.69,661,27.31,0.49,0.53
5,809,74,678,5,2.68,683,13.77,0.53,0.55
5,809,74,678,5,2.68,683,13.77,0.53,0.55
5,809,74,678,5,2.68,683,13.77,0.53,0.55
5,809,74,678,5,2.68,683,13.77,0.53,0.55
5,809,74,678,5,2.68,683,13.77,0.53,0.55
5,809,74,678,5,2.68,683,13.77,0.53,0.55
7,852,2,819,16,7.98,835,32.01,0.48,0.52
7,852,2,819,16,7.98,835,32.01,0.48,0.52
7,852,2,819,16,7.98,835,32.01,0.48,0.52
7,852,2,819,16,7.98,835,32.01,0.48,0.52
7,852,2,819,16,7.98,835,32.01,0.48,0.52
7,852,2,819,16,7.98,835,32.01,0.48,0.52
14,916,92,877,1,0.51,878,6.7,0.55,0.55
14,916,92,877,1,0.51,878,6.7,0.55,0.55
14,916,92,877,1,0.51,878,6.7,0.55,0.55
14,916,92,877,1,0.51,878,6.7,0.55,0.55
14,916,92,877,1,0.51,878,6.7,0.55,0.55
14,916,92,877,1,0.51,878,6.7,0.55,0.55
8,758,48,925,17,8.67,942,34.04,0.48,0.52
8,758,48,925,17,8.67,942,34.04,0.48,0.52
8,758,48,925,17,8.67,942,34.04,0.48,0.52
8,758,48,925,17,8.67,942,34.04,0.48,0.52
8,758,48,925,17,8.67,942,34.04,0.48,0.52
8,758,48,925,17,8.67,942,34.04,0.48,0.52
9,790,39,991,13,6.47,1004,26.92,0.5,0.53
9,790,39,991,13,6.47,1004,26.92,0.5,0.53
9,790,39,991,13,6.47,1004,26.92,0.5,0.53
9,790,39,991,13,6.47,1004,26.92,0.5,0.53
9,790,39,991,13,6.47,1004,26.92,0.5,0.53
9,790,39,991,13,6.47,1004,26.92,0.5,0.53
13,318,54,1065,8,4.16,1073,18.8,0.52,0.54
13,318,54,1065,8,4.16,1073,18.8,0.52,0.54
13,318,54,1065,8,4.16,1073,18.8,0.52,0.54
13,318,54,1065,8,4.16,1073,18.8,0.52,0.54
13,318,54,1065,8,4.16,1073,18.8,0.52,0.54
13,318,54,1065,8,4.16,1073,18.8,0.52,0.54
13,388,54,1099,3,1.59,1102,10.23,0.54,0.55
13,388,54,1099,3,1.59,1102,10.23,0.54,0.55
13,388,54,1099,3,1.59,1102,10.23,0.54,0.55
13,388,54,1099,3,1.59,1102,10.23,0.54,0.55
13,388,54,1099,3,1.59,1102,10.23,0.54,0.55
13,388,54,1099,3,1.59,1102,10.23,0.54,0.55
8,251,48,1139,9,4.31,1148,19.86,0.51,0.54
8,251,48,1139,9,4.31,1148,19.86,0.51,0.54
8,251,48,1139,9,4.31,1148,19.86,0.51,0.54
8,251,48,1139,9,4.31,1148,19.86,0.51,0.54
8,251,48,1139,9,4.31,1148,19.86,0.51,0.54
8,251,48,1139,9,4.31,1148,19.86,0.51,0.54
13,269,54,1134,9,4.68,1143,20.54,0.51,0.54
13,269,54,1134,9,4.68,1143,20.54,0.51,0.54
13,269,54,1134,9,4.68,1143,20.54,0.51,0.54
13,269,54,1134,9,4.68,1143,20.54,0.51,0.54
13,269,54,1134,9,4.68,1143,20.54,0.51,0.54
13,269,54,1134,9,4.68,1143,20.54,0.51,0.54
4,294,86,1168,14,6.98,1182,28.62,0.49,0.53
4,294,86,1168,14,6.98,1182,28.62,0.49,0.53
4,294,86,1168,14,6.98,1182,28.62,0.49,0.53
4,294,86,1168,14,6.98,1182,28.62,0.49,0.53
4,294,86,1168,14,6.98,1182,28.62,0.49,0.53
4,294,86,1168,14,6.98,1182,28.62,0.49,0.53
5,358,59,1144,9,4.55,1153,20.3,0.51,0.54
5,358,59,1144,9,4.55,1153,20.3,0.51,0.54
5,358,59,1144,9,4.55,1153,20.3,0.51,0.54
5,358,59,1144,9,4.55,1153,20.3,0.51,0.54
5,358,59,1144,9,4.55,1153,20.3,0.51,0.54
5,358,59,1144,9,4.55,1153,20.3,0.51,0.54
13,820,54,1146,4,2.06,1150,11.86,0.53,0.55
13,820,54,1146,4,2.06,1150,11.86,0.53,0.55
13,820,54,1146,4,2.06,1150,11.86,0.53,0.55
13,820,54,1146,4,2.06,1150,11.86,0.53,0.55
13,820,54,1146,4,2.06,1150,11.86,0.53,0.55
13,820,54,1146,4,2.06,1150,11.86,0.53,0.55
8,296,48,1186,15,7.59,1201,30.51,0.49,0.52
8,296,48,1186,15,7.59,1201,30.51,0.49,0.52
8,296,48,1186,15,7.59,1201,30.51,0.49,0.52
8,296,48,1186,15,7.59,1201,30.51,0.49,0.52
8,296,48,1186,15,7.59,1201,30.51,0.49,0.52
8,296,48,1186,15,7.59,1201,30.51,0.49,0.52
13,842,54,1171,6,2.86,1177,14.89,0.53,0.54
13,842,54,1171,6,2.86,1177,14.89,0.53,0.54
13,842,54,1171,6,2.86,1177,14.89,0.53,0.54
13,842,54,1171,6,2.86,1177,14.89,0.53,0.54
13,842,54,1171,6,2.86,1177,14.89,0.53,0.54
13,842,54,1171,6,2.86,1177,14.89,0.53,0.54
4,536,86,1252,8,4.11,1260,18.73,0.52,0.54
4,536,86,1252,8,4.11,1260,18.73,0.52,0.54
4,536,86,1252,8,4.11,1260,18.73,0.52,0.54
4,536,86,1252,8,4.11,1260,18.73,0.52,0.54
4,536,86,1252,8,4.11,1260,18.73,0.52,0.54
4,536,86,1252,8,4.11,1260,18.73,0.52,0.54
13,723,54,1251,7,3.74,1258,17.27,0.52,0.54
13,723,54,1251,7,3.74,1258,17.27,0.52,0.54
13,723,54,1251,7,3.74,1258,17.27,0.52,0.54
13,723,54,1251,7,3.74,1258,17.27,0.52,0.54
13,723,54,1251,7,3.74,1258,17.27,0.52,0.54
13,723,54,1251,7,3.74,1258,17.27,0.52,0.54
14,783,92,1370,13,6.44,1383,26.85,0.5,0.53
14,783,92,1370,13,6.44,1383,26.85,0.5,0.53
14,783,92,1370,13,6.44,1383,26.85,0.5,0.53
14,783,92,1370,13,6.44,1383,26.85,0.5,0.53
14,783,92,1370,13,6.44,1383,26.85,0.5,0.53
14,783,92,1370,13,6.44,1383,26.85,0.5,0.53
15,790,0,92,12,5.87,104,25.04,0.5,0.53
15,790,0,92,12,5.87,104,25.04,0.5,0.53
15,790,0,92,12,5.87,104,25.04,0.5,0.53
15,790,0,92,12,5.87,104,25.04,0.5,0.53
15,790,0,92,12,5.87,104,25.04,0.5,0.53
15,790,0,92,12,5.87,104,25.04,0.5,0.53
15,790,0,92,12,5.87,104,25.04,0.5,0.53
10,773,39,147,1,0.63,148,6.93,0.55,0.55
10,773,39,147,1,0.63,148,6.93,0.55,0.55
10,773,39,147,1,0.63,148,6.93,0.55,0.55
10,773,39,147,1,0.63,148,6.93,0.55,0.55
10,773,39,147,1,0.63,148,6.93,0.55,0.55
10,773,39,147,1,0.63,148,6.93,0.55,0.55
10,773,39,147,1,0.63,148,6.93,0.55,0.55
8,775,41,213,3,1.35,216,9.8,0.54,0.55
8,775,41,213,3,1.35,216,9.8,0.54,0.55
8,775,41,213,3,1.35,216,9.8,0.54,0.55
8,775,41,213,3,1.35,216,9.8,0.54,0.55
8,775,41,213,3,1.35,216,9.8,0.54,0.55
8,775,41,213,3,1.35,216,9.8,0.54,0.55
8,775,41,213,3,1.35,216,9.8,0.54,0.55
4,839,43,252,12,5.8,264,24.92,0.5,0.53
4,839,43,252,12,5.8,264,24.92,0.5,0.53
4,839,43,252,12,5.8,264,24.92,0.5,0.53
4,839,43,252,12,5.8,264,24.92,0.5,0.53
4,839,43,252,12,5.8,264,24.92,0.5,0.53
4,839,43,252,12,5.8,264,24.92,0.5,0.53
4,839,43,252,12,5.8,264,24.92,0.5,0.53
0,910,10,364,6,2.93,370,15.01,0.52,0.54
0,910,10,364,6,2.93,370,15.01,0.52,0.54
0,910,10,364,6,2.93,370,15.01,0.52,0.54
0,910,10,364,6,2.93,370,15.01,0.52,0.54
0,910,10,364,6,2.93,370,15.01,0.52,0.54
0,910,10,364,6,2.93,370,15.01,0.52,0.54
0,910,10,364,6,2.93,370,15.01,0.52,0.54
4,144,43,410,10,4.87,420,21.66,0.51,0.54
4,144,43,410,10,4.87,420,21.66,0.51,0.54
4,144,43,410,10,4.87,420,21.66,0.51,0.54
4,144,43,410,10,4.87,420,21.66,0.51,0.54
4,144,43,410,10,4.87,420,21.66,0.51,0.54
4,144,43,410,10,4.87,420,21.66,0.51,0.54
4,144,43,410,10,4.87,420,21.66,0.51,0.54
8,90,41,418,19,9.47,437,37.06,0.47000000000000003,0.52
8,90,41,418,19,9.47,437,37.06,0.47000000000000003,0.52
8,90,41,418,19,9.47,437,37.06,0.47000000000000003,0.52
8,90,41,418,19,9.47,437,37.06,0.47000000000000003,0.52
8,90,41,418,19,9.47,437,37.06,0.47000000000000003,0.52
8,90,41,418,19,9.47,437,37.06,0.47000000000000003,0.52
8,90,41,418,19,9.47,437,37.06,0.47000000000000003,0.52
15,0,0,391,16,8.09,407,32.2,0.48,0.52
15,0,0,391,16,8.09,407,32.2,0.48,0.52
15,0,0,391,16,8.09,407,32.2,0.48,0.52
15,0,0,391,16,8.09,407,32.2,0.48,0.52
15,0,0,391,16,8.09,407,32.2,0.48,0.52
15,0,0,391,16,8.09,407,32.2,0.48,0.52
15,0,0,391,16,8.09,407,32.2,0.48,0.52
4,106,43,445,22,11.06,467,42.28,0.46,0.51
4,106,43,445,22,11.06,467,42.28,0.46,0.51
4,106,43,445,22,11.06,467,42.28,0.46,0.51
4,106,43,445,22,11.06,467,42.28,0.46,0.51
4,106,43,445,22,11.06,467,42.28,0.46,0.51
4,106,43,445,22,11.06,467,42.28,0.46,0.51
4,106,43,445,22,11.06,467,42.28,0.46,0.51
8,158,41,448,18,9.22,466,35.82,0.47000000000000003,0.52
8,158,41,448,18,9.22,466,35.82,0.47000000000000003,0.52
8,158,41,448,18,9.22,466,35.82,0.47000000000000003,0.52
8,158,41,448,18,9.22,466,35.82,0.47000000000000003,0.52
8,158,41,448,18,9.22,466,35.82,0.47000000000000003,0.52
8,158,41,448,18,9.22,466,35.82,0.47000000000000003,0.52
8,158,41,448,18,9.22,466,35.82,0.47000000000000003,0.52
14,175,44,446,5,2.48,451,13.41,0.53,0.55
14,175,44,446,5,2.48,451,13.41,0.53,0.55
14,175,44,446,5,2.48,451,13.41,0.53,0.55
14,175,44,446,5,2.48,451,13.41,0.53,0.55
14,175,44,446,5,2.48,451,13.41,0.53,0.55
14,175,44,446,5,2.48,451,13.41,0.53,0.55
14,175,44,446,5,2.48,451,13.41,0.53,0.55
7,69,26,461,14,6.78,475,28.25,0.49,0.53
7,69,26,461,14,6.78,475,28.25,0.49,0.53
7,69,26,461,14,6.78,475,28.25,0.49,0.53
7,69,26,461,14,6.78,475,28.25,0.49,0.53
7,69,26,461,14,6.78,475,28.25,0.49,0.53
7,69,26,461,14,6.78,475,28.25,0.49,0.53
7,69,26,461,14,6.78,475,28.25,0.49,0.53
12,158,59,452,3,1.7,455,10.44,0.54,0.55
12,158,59,452,3,1.7,455,10.44,0.54,0.55
12,158,59,452,3,1.7,455,10.44,0.54,0.55
12,158,59,452,3,1.7,455,10.44,0.54,0.55
12,158,59,452,3,1.7,455,10.44,0.54,0.55
12,158,59,452,3,1.7,455,10.44,0.54,0.55
12,158,59,452,3,1.7,455,10.44,0.54,0.55
14,237,44,469,14,7.05,483,28.75,0.49,0.53
14,237,44,469,14,7.05,483,28.75,0.49,0.53
14,237,44,469,14,7.05,483,28.75,0.49,0.53
14,237,44,469,14,7.05,483,28.75,0.49,0.53
14,237,44,469,14,7.05,483,28.75,0.49,0.53
14,237,44,469,14,7.05,483,28.75,0.49,0.53
14,237,44,469,14,7.05,483,28.75,0.49,0.53
4,21,43,484,3,1.46,487,10.01,0.54,0.55
4,21,43,484,3,1.46,487,10.01,0.54,0.55
4,21,43,484,3,1.46,487,10.01,0.54,0.55
4,21,43,484,3,1.46,487,10.01,0.54,0.55
4,21,43,484,3,1.46,487,10.01,0.54,0.55
4,21,43,484,3,1.46,487,10.01,0.54,0.55
4,21,43,484,3,1.46,487,10.01,0.54,0.55
7,125,26,480,11,5.45,491,23.5,0.5,0.53
7,125,26,480,11,5.45,491,23.5,0.5,0.53
7,125,26,480,11,5.45,491,23.5,0.5,0.53
7,125,26,480,11,5.45,491,23.5,0.5,0.53
7,125,26,480,11,5.45,491,23.5,0.5,0.53
7,125,26,480,11,5.45,491,23.5,0.5,0.53
7,125,26,480,11,5.45,491,23.5,0.5,0.53
8,38,41,483,9,4.43,492,20.08,0.51,0.54
8,38,41,483,9,4.43,492,20.08,0.51,0.54
8,38,41,483,9,4.43,492,20.08,0.51,0.54
8,38,41,483,9,4.43,492,20.08,0.51,0.54
8,38,41,483,9,4.43,492,20.08,0.51,0.54
8,38,41,483,9,4.43,492,20.08,0.51,0.54
8,38,41,483,9,4.43,492,20.08,0.51,0.54
10,46,72,487,11,5.32,498,23.26,0.5,0.53
10,46,72,487,11,5.32,498,23.26,0.5,0.53
10,46,72,487,11,5.32,498,23.26,0.5,0.53
10,46,72,487,11,5.32,498,23.26,0.5,0.53
10,46,72,487,11,5.32,498,23.26,0.5,0.53
10,46,72,487,11,5.32,498,23.26,0.5,0.53
10,46,72,487,11,5.32,498,23.26,0.5,0.53
12,158,59,486,14,6.84,500,28.37,0.49,0.53
12,158,59,486,14,6.84,500,28.37,0.49,0.53
12,158,59,486,14,6.84,500,28.37,0.49,0.53
12,158,59,486,14,6.84,500,28.37,0.49,0.53
12,158,59,486,14,6.84,500,28.37,0.49,0.53
12,158,59,486,14,6.84,500,28.37,0.49,0.53
12,158,59,486,14,6.84,500,28.37,0.49,0.53
2,5,89,514,2,0.84,516,8.09,0.54,0.55
2,5,89,514,2,0.84,516,8.09,0.54,0.55
2,5,89,514,2,0.84,516,8.09,0.54,0.55
2,5,89,514,2,0.84,516,8.09,0.54,0.55
2,5,89,514,2,0.84,516,8.09,0.54,0.55
2,5,89,514,2,0.84,516,8.09,0.54,0.55
2,5,89,514,2,0.84,516,8.09,0.54,0.55
7,5,26,511,19,9.71,530,37.49,0.47000000000000003,0.52
7,5,26,511,19,9.71,530,37.49,0.47000000000000003,0.52
7,5,26,511,19,9.71,530,37.49,0.47000000000000003,0.52
7,5,26,511,19,9.71,530,37.49,0.47000000000000003,0.52
7,5,26,511,19,9.71,530,37.49,0.47000000000000003,0.52
7,5,26,511,19,9.71,530,37.49,0.47000000000000003,0.52
7,5,26,511,19,9.71,530,37.49,0.47000000000000003,0.52
11,221,82,527,8,4.24,535,18.96,0.52,0.54
11,221,82,527,8,4.24,535,18.96,0.52,0.54
11,221,82,527,8,4.24,535,18.96,0.52,0.54
11,221,82,527,8,4.24,535,18.96,0.52,0.54
11,221,82,527,8,4.24,535,18.96,0.52,0.54
11,221,82,527,8,4.24,535,18.96,0.52,0.54
11,221,82,527,8,4.24,535,18.96,0.52,0.54
2,50,89,540,2,0.87,542,8.15,0.54,0.55
2,50,89,540,2,0.87,542,8.15,0.54,0.55
2,50,89,540,2,0.87,542,8.15,0.54,0.55
2,50,89,540,2,0.87,542,8.15,0.54,0.55
2,50,89,540,2,0.87,542,8.15,0.54,0.55
2,50,89,540,2,0.87,542,8.15,0.54,0.55
2,50,89,540,2,0.87,542,8.15,0.54,0.55
7,136,26,565,10,4.97,575,21.84,0.51,0.54
7,136,26,565,10,4.97,575,21.84,0.51,0.54
7,136,26,565,10,4.97,575,21.84,0.51,0.54
7,136,26,565,10,4.97,575,21.84,0.51,0.54
7,136,26,565,10,4.97,575,21.84,0.51,0.54
7,136,26,565,10,4.97,575,21.84,0.51,0.54
7,136,26,565,10,4.97,575,21.84,0.51,0.54
1,808,91,641,6,2.9,647,14.96,0.53,0.54
1,808,91,641,6,2.9,647,14.96,0.53,0.54
1,808,91,641,6,2.9,647,14.96,0.53,0.54
1,808,91,641,6,2.9,647,14.96,0.53,0.54
1,808,91,641,6,2.9,647,14.96,0.53,0.54
1,808,91,641,6,2.9,647,14.96,0.53,0.54
1,808,91,641,6,2.9,647,14.96,0.53,0.54
13,318,46,1028,5,2.69,1033,13.79,0.53,0.55
13,318,46,1028,5,2.69,1033,13.79,0.53,0.55
13,318,46,1028,5,2.69,1033,13.79,0.53,0.55
13,318,46,1028,5,2.69,1033,13.79,0.53,0.55
13,318,46,1028,5,2.69,1033,13.79,0.53,0.55
13,318,46,1028,5,2.69,1033,13.79,0.53,0.55
13,318,46,1028,5,2.69,1033,13.79,0.53,0.55
1,300,35,1103,10,4.79,1113,21.52,0.51,0.54
1,300,35,1103,10,4.79,1113,21.52,0.51,0.54
1,300,35,1103,10,4.79,1113,21.52,0.51,0.54
1,300,35,1103,10,4.79,1113,21.52,0.51,0.54
1,300,35,1103,10,4.79,1113,21.52,0.51,0.54
1,300,35,1103,10,4.79,1113,21.52,0.51,0.54
1,300,35,1103,10,4.79,1113,21.52,0.51,0.54
1,404,35,1137,15,7.66,1152,30.64,0.49,0.52
1,404,35,1137,15,7.66,1152,30.64,0.49,0.52
1,404,35,1137,15,7.66,1152,30.64,0.49,0.52
1,404,35,1137,15,7.66,1152,30.64,0.49,0.52
1,404,35,1137,15,7.66,1152,30.64,0.49,0.52
1,404,35,1137,15,7.66,1152,30.64,0.49,0.52
1,404,35,1137,15,7.66,1152,30.64,0.49,0.52
6,354,71,1219,12,5.76,1231,24.85,0.5,0.53
6,354,71,1219,12,5.76,1231,24.85,0.5,0.53
6,354,71,1219,12,5.76,1231,24.85,0.5,0.53
6,354,71,1219,12,5.76,1231,24.85,0.5,0.53
6,354,71,1219,12,5.76,1231,24.85,0.5,0.53
6,354,71,1219,12,5.76,1231,24.85,0.5,0.53
6,354,71,1219,12,5.76,1231,24.85,0.5,0.53
6,578,71,1234,11,5.61,1245,23.79,0.5,0.53
6,578,71,1234,11,5.61,1245,23.79,0.5,0.53
6,578,71,1234,11,5.61,1245,23.79,0.5,0.53
6,578,71,1234,11,5.61,1245,23.79,0.5,0.53
6,578,71,1234,11,5.61,1245,23.79,0.5,0.53
6,578,71,1234,11,5.61,1245,23.79,0.5,0.53
6,578,71,1234,11,5.61,1245,23.79,0.5,0.53
6,626,71,1296,14,7.23,1310,29.09,0.49,0.53
6,626,71,1296,14,7.23,1310,29.09,0.49,0.53
6,626,71,1296,14,7.23,1310,29.09,0.49,0.53
6,626,71,1296,14,7.23,1310,29.09,0.49,0.53
6,626,71,1296,14,7.23,1310,29.09,0.49,0.53
6,626,71,1296,14,7.23,1310,29.09,0.49,0.53
6,626,71,1296,14,7.23,1310,29.09,0.49,0.53
6,519,71,1325,6,3.13,1331,15.38,0.52,0.54
6,519,71,1325,6,3.13,1331,15.38,0.52,0.54
6,519,71,1325,6,3.13,1331,15.38,0.52,0.54
6,519,71,1325,6,3.13,1331,15.38,0.52,0.54
6,519,71,1325,6,3.13,1331,15.38,0.52,0.54
6,519,71,1325,6,3.13,1331,15.38,0.52,0.54
6,519,71,1325,6,3.13,1331,15.38,0.52,0.54
6,632,71,1363,3,1.32,1366,9.75,0.54,0.55
6,632,71,1363,3,1.32,1366,9.75,0.54,0.55
6,632,71,1363,3,1.32,1366,9.75,0.54,0.55
6,632,71,1363,3,1.32,1366,9.75,0.54,0.55
6,632,71,1363,3,1.32,1366,9.75,0.54,0.55
6,632,71,1363,3,1.32,1366,9.75,0.54,0.55
6,632,71,1363,3,1.32,1366,9.75,0.54,0.55
